--------------------------------------------------------------------------------------------------------------------------------------------------------------------------------------------------------
--------------------------------------------------------------------------------------------------------------------------------------------------------------------------------------------------------
--------------------------------------------------------------------------------------------------------------------------------------------------------------------------------------------------------
--------------------------------------------------------------------------------------------------------------------------------------------------------------------------------------------------------
--------------------------------------------------------------------------------------------------------------------------------------------------------------------------------------------------------
--------------------------------------------------------------------------------------------------------------------------------------------------------------------------------------------------------
--------------------------------------------------------------------------------------------------------------------------------------------------------------------------------------------------------
--------------------------------------------------------------------------------------------------------------------------------------------------------------------------------------------------------
--------------------------------------------------------------------------------------------------------------------------------------------------------------------------------------------------------
--------------------------------------------------------------------------------------------------------------------------------------------------------------------------------------------------------
--------------------------------------------------------------------------------------------------------------------------------------------------------------------------------------------------------
--------------------------------------------------------------------------------------------------------------------------------------------------------------------------------------------------------
-----------------------------------------------------------------------------------------------------------------------------------------------------------oSoSSooo-------------------------------------
-----------------------------------------------------------------------------------------------------------------------------------oooo--------------------------------ooo-------oooo-----ooooo---------
---------------------------------------------------------------oooo------------------------------------------------------------------------------------------ooooo--------------------------------------
--------------------ooo--------------SSSoS---------------------------ooSSooSo------------ooSSoooo----------oooo-----------------ooooooo------SSoS---ooooo----------------oo-------oooooo----------------
----------XXXX-------g-------XXXXXX------------ooo---------XXXXXXXXX-------------XX-------------------XXXX------------------------------------------------XXXXXXXXXXX-------XX-------g--------------XXXX
----------XXXX---XXXXXXX-----XXXXXX-oooooo---------XXX-----XXXXXXXXX--ooooo------XX------oooooooo-XXXXXXXXXXXXXXXXXXX--XXXXXXXXXXXXXXXXXX------oo---ooo---XXXXXXXXXXXXXXXXXXXXXXXXXXXXXXXXXXXXXXXXXXXXXX
XXXXXXXXXXXXXXXXXXXXXXXXXXXXXXXXXXX----g-----XXXXXXXXXXXXXXXXXXXXXXX----------XXXXX---------------XXXXXXXXXXXXXXXXXXX--XXXXXXXXXXXXXXXXXXXX---------------XXXXXXXXXXXXXXXXXXXXXXXXXXXXXXXXXXXXXXXXXXXXXX
XXXXXXXXXXXXXXXXXXXXXXXXXXXXXXXXXXXXXXXXXXXXXXXXXXXXXXXXXXXXXXXXXXXXXXXXXXXXXXXXXXXXXXXXXXXXXXXXXXXXXXXXXXXXXXXXXXXXXXXXXXXXXXXXXXXXXXXXXXXXXXXXXXXXXXXXXXXXXXXXXXXXXXXXXXXXXXXXXXXXXXXXXXXXXXXXXXXXXXXX

