--------------------------------------------------------------------------------------------------------------------------------------------------------------------------------------------------------
--------------------------------------------------------------------------------------------------------------------------------------------------------------------------------------------------------
--------------------------------------------------------------------------------------------------------------------------------------------------------------------------------------------------------
--------------------------------------------------------------------------------------------------------------------------------------------------------------------------------------------------------
--------------------------------------------------------------------------------------------------------------------------------------------------------------------------------------------------------
--------------------------------------------------------------------------------------------------------------------------------------------------------------------------------------------------------
--------------------------------------------------------------------------------------------------------------------------------------------------------------------------------------------------------
--------------------------------------------------------------------------------------------------------------------------------------------------------------------------------------------------------
--------------------------------------------------------------------------------------------------------------------------------------------------------------------------------------------------------
--------------------------------------------------------------------------------------------------------------------------------------------------------------------------------------------------------
--------------------------------------------------------------------------------------------------------------------------------------------------------------------------------------------------------
--------------------------------------------------------------------------------------------------------------------------------------------------------------------------------------------------------
--------------------------------------------------------------------------------------------------ooooo--oSSo---------------------SSSoo-----------------------------------------------------------------
-------------------oooooSo----ooooSoo--------ooooS--------------------------oSoooo--oooSoo-------------------------Soo----------------------------------------------------------------------------SoSo--
-------------------------------------------------------ooSSS------------------------------------ooooo----ooooo---------------------ooo-------oo------------oSo-----SSoo------------oooo-----------------
--------------------oooooo---ooooo-------------oooo---------------oooo-------ooo-------oooo-------------------------------------------------------------------------------------------------------oo----
-----------------------------------------------------ooooooooo--------------------------------XXXXXXXXXXXXXXXXX------------XXXXXXXXXXXXXXXXXXXXX----------oooooo----ooooo--XXXXX--XXXXXX----------------
-------------XX--XXXXXXXXXXXXXXXXXXXXX------XXXXXXXX--------------oooo----XXXXXXXXXXXXXXXXXXXXXXXXXXXXXXXXXXXXXXXXXXXXX----XXXXXXXXXXXXXXXXXXXXX----------g----------------XXXXX--XXXXXXXXXXXXXXXXXXXXXX
XXXXXXXXXXXXXXX--XXXXXXXXXXXXXXXXXXXXXXX----XXXXXXXXXXXXXXXXXXX-----------XXXXXXXXXXXXXXXXXXXXXXXXXXXXXXXXXXXXXXXXXXXXX----XXXXXXXXXXXXXXXXXXXXX-----XXXXXXXXXXXXXXXXXXXXXXXXXXXXXXXXXXXXXXXXXXXXXXXXXXX
XXXXXXXXXXXXXXXXXXXXXXXXXXXXXXXXXXXXXXXXXXXXXXXXXXXXXXXXXXXXXXXXXXXXXXXXXXXXXXXXXXXXXXXXXXXXXXXXXXXXXXXXXXXXXXXXXXXXXXXXXXXXXXXXXXXXXXXXXXXXXXXXXXXXXXXXXXXXXXXXXXXXXXXXXXXXXXXXXXXXXXXXXXXXXXXXXXXXXXXX

