--------------------------------------------------------------------------------------------------------------------------------------------------------------------------------------------------------
--------------------------------------------------------------------------------------------------------------------------------------------------------------------------------------------------------
--------------------------------------------------------------------------------------------------------------------------------------------------------------------------------------------------------
--------------------------------------------------------------------------------------------------------------------------------------------------------------------------------------------------------
--------------------------------------------------------------------------------------------------------------------------------------------------------------------------------------------------------
--------------------------------------------------------------------------------------------------------------------------------------------------------------------------------------------------------
--------------------------------------------------------------------------------------------------------------------------------------------------------------------------------------------------------
--------------------------------------------------------------------------------------------------------------------------------------------------------------------------------------------------------
--------------------------------------------------------------------------------------------------------------------------------------------------------------------------------------------------------
--------------------------------------------------------------------------------------------------------------------------------------------------------------------------------------------------------
--------------------------------------------------------------------------------------------------------------------------------------------------------------------------------------------------------
--------------------------------------------------------------------------------------------------------------------------------------------------------------------------------------------------------
--------------------------------------------------------------------------------------------oSo----------------ooSoooo----------------------------------------------------------------------------------
---------------------------------------------------ooSooSS----------------------------------------------------------------------------------------------------------------------------------------------
---------------------------oSo--------------------------------------------oSS--------------oooooo------ooSo------oooo-----------------------------------------------------------------------------------
-------------------------------------SoS-----ooo-----oooooo--------------------------------------g----------------------ooooSS-----------------ooooo----------oooo----------oSSSoS----------------------
--------------oooo------XX--------------------------------------------------ooo-----------XXXXXXXXX----ooo----XXXXXXXXX---------------------------------------------XXXXXXX------------oo---------------
------------------------XX---------oooooooo-XXXXXXXXXXXXXXXXX-------------------XXXXXX----XXXXXXXXX-----------XXXXXXXXX---ooooo------oo---------oooooo-------XXXXXXXXXXXXXX----ooo-------------XXXXXXXX-
XXXXXXXXXXXXXXXXXXXX----XXXXXXXXX-----------XXXXXXXXXXXXXXXXX--XXX-----g-XXXXXXXXXXXXXXXXXXXXXXXXXXXXXXXXXXXXXXXXXXXXXX-------------------XXX----------XXXXXXXXXXXXXXXXXXXX----------XXXXXXXXXXXXXXXXXXX
XXXXXXXXXXXXXXXXXXXXXXXXXXXXXXXXXXXXXXXXXXXXXXXXXXXXXXXXXXXXXXXXXXXXXXXXXXXXXXXXXXXXXXXXXXXXXXXXXXXXXXXXXXXXXXXXXXXXXXXXXXXXXXXXXXXXXXXXXXXXXXXXXXXXXXXXXXXXXXXXXXXXXXXXXXXXXXXXXXXXXXXXXXXXXXXXXXXXXXXX

