--------------------------------------------------------------------------------------------------------------------------------------------------------------------------------------------------------
--------------------------------------------------------------------------------------------------------------------------------------------------------------------------------------------------------
--------------------------------------------------------------------------------------------------------------------------------------------------------------------------------------------------------
--------------------------------------------------------------------------------------------------------------------------------------------------------------------------------------------------------
--------------------------------------------------------------------------------------------------------------------------------------------------------------------------------------------------------
--------------------------------------------------------------------------------------------------------------------------------------------------------------------------------------------------------
--------------------------------------------------------------------------------------------------------------------------------------------------------------------------------------------------------
--------------------------------------------------------------------------------------------------------------------------------------------------------------------------------------------------------
--------------------------------------------------------------------------------------------------------------------------------------------------------------------------------------------------------
--------------------------------------------------------------------------------------------------------------------------------------------------------------------------------------------------------
--------------------------------------------------------------------------------------------------------------------------------------------------------------------------------------------------------
--------------------------------------------------------------------------------------------------------------------------------------------------------------------------------------------------------
--------------------oSSoSooo-----------------------------------------------oSo-------oooSSo-----------------oSoo---ooSoooo------------------------------------------------------------------------------
------------------------------------------------oSSSoo------------------------------------------------------------------------------------------------------ooooooo-------------------------------------
---------------------ooooooo------------------------------------ooo--------ooo--------oooooo--oo-------------------ooooooo----------------------------oo--------------oo--------------ooo---------------
------------------------------------------------ooooooo---------------------------------------g-------------------------g-------------SoSo--oooooo-----------oooooo------------ooo-----g----------------
XXXXXXXXXXXX-------XXXXXXXXXXXXXXXXXXX------------------------XXXXXXXX----XXXXXXXXXXXXXXXXXXXXXXXXXX--oo---XXXXXXXXXXXXXXXXX-ooo-----------------g--XXXXXX----------XXXXXXXX--------XXXXXXX--------XXXXX
XXXXXXXXXXXX--oooo-XXXXXXXXXXXXXXXXXXX------XXXXXXXXXXXXX---XXXXXXXXXX----XXXXXXXXXXXXXXXXXXXXXXXXXX-------XXXXXXXXXXXXXXXXX----g----oooo--XXXXXXXXXXXXXXXXXXXXXXXXXXXXXXXXX--------XXXXXXX----oo--XXXXX
XXXXXXXXXXXX-------XXXXXXXXXXXXXXXXXXX-g----XXXXXXXXXXXXX---XXXXXXXXXXXXXXXXXXXXXXXXXXXXXXXXXXXXXXXXXXXXXXXXXXXXXXXXXXXXXXXXXXXXXXX--------XXXXXXXXXXXXXXXXXXXXXXXXXXXXXXXXX--------XXXXXXXXX------XXXXX
XXXXXXXXXXXXXXXXXXXXXXXXXXXXXXXXXXXXXXXXXXXXXXXXXXXXXXXXXXXXXXXXXXXXXXXXXXXXXXXXXXXXXXXXXXXXXXXXXXXXXXXXXXXXXXXXXXXXXXXXXXXXXXXXXXXXXXXXXXXXXXXXXXXXXXXXXXXXXXXXXXXXXXXXXXXXXXXXXXXXXXXXXXXXXXXXXXXXXXXX

