--------------------------------------------------------------------------------------------------------------------------------------------------------------------------------------------------------
--------------------------------------------------------------------------------------------------------------------------------------------------------------------------------------------------------
--------------------------------------------------------------------------------------------------------------------------------------------------------------------------------------------------------
--------------------------------------------------------------------------------------------------------------------------------------------------------------------------------------------------------
--------------------------------------------------------------------------------------------------------------------------------------------------------------------------------------------------------
--------------------------------------------------------------------------------------------------------------------------------------------------------------------------------------------------------
--------------------------------------------------------------------------------------------------------------------------------------------------------------------------------------------------------
--------------------------------------------------------------------------------------------------------------------------------------------------------------------------------------------------------
--------------------------------------------------------------------------------------------------------------------------------------------------------------------------------------------------------
--------------------------------------------------------------------------------------------------------------------------------------------------------------------------------------------------------
--------------------------------------------------------------------------------------------------------------------------------------------------------------------------------------------------------
--------------------------------------------------------------------------------------------------------------------------------------------------------------------------------------------------------
-------------------------------Sooo---------------------------------------------------------------oooooSo---------------------------------------------------------------------------oooo----------------
---------------------oSoSo----------------------------------------------------oSoooS---------------------------------------------------------------------------------------------------------ooSSSoo----
-----------------------------oooo-------------------------------------------------------SooSS-----ooooo----oooo----SoSSoooo---ooo----------------------------------oSo-------------oooooo---------------
----------------------ooo-------------ooS----oooSoo-----------------------------oooo------------------------------------------------------------oooooo------ooSSo-----------------------------ooo-------
-----------------------g---XXXXXXXXX-----------------------XXXXXXXXXXXXX-----------g---ooooooo---XXXXXXXXXXXXXXXX---ooooooo--oooo--------XXX------------------------oooo---------XXXXXXXXXXX---------XX-
---------------ooo-XXXXXXXXXXXXXXXXX-----------oo----------XXXXXXXXXXXXXXXXXXXXXXXXXXX-----------XXXXXXXXXXXXXXXX-----g-----------XXXXXXXXXX----oooooo------oo--------------XX---XXXXXXXXXXXXXXXXXXXXXX-
-------------------XXXXXXXXXXXXXXXXX-----------------------XXXXXXXXXXXXXXXXXXXXXXXXXXXXXXXXXXXXXXXXXXXXXXXXXXXXXXXXXXXXXXXXXXXXXXXXXXXXXXXXXXXX----g-------g------XXXXXXXX--XXXXXXXXXXXXXXXXXXXXXXXXXXXX
XXXXXXXXXXXXXXXXXXXXXXXXXXXXXXXXXXXXXXXXXXXXXXXXXXXXXXXXXXXXXXXXXXXXXXXXXXXXXXXXXXXXXXXXXXXXXXXXXXXXXXXXXXXXXXXXXXXXXXXXXXXXXXXXXXXXXXXXXXXXXXXXXXXXXXXXXXXXXXXXXXXXXXXXXXXXXXXXXXXXXXXXXXXXXXXXXXXXXXXX

