--------------------------------------------------------------------------------------------------------------------------------------------------------------------------------------------------------
--------------------------------------------------------------------------------------------------------------------------------------------------------------------------------------------------------
--------------------------------------------------------------------------------------------------------------------------------------------------------------------------------------------------------
--------------------------------------------------------------------------------------------------------------------------------------------------------------------------------------------------------
--------------------------------------------------------------------------------------------------------------------------------------------------------------------------------------------------------
--------------------------------------------------------------------------------------------------------------------------------------------------------------------------------------------------------
--------------------------------------------------------------------------------------------------------------------------------------------------------------------------------------------------------
--------------------------------------------------------------------------------------------------------------------------------------------------------------------------------------------------------
--------------------------------------------------------------------------------------------------------------------------------------------------------------------------------------------------------
--------------------------------------------------------------------------------------------------------------------------------------------------------------------------------------------------------
--------------------------------------------------------------------------------------------------------------------------------------------------------------------------------------------------------
--------------------------------------------------------------------------------------------------------------------------------------------------------------------------------------------------------
-----------------------------------------------------------------------------------------------------------Soooo-----------------------------------------oSo--------------------------------------------
----------------------------------ooSoSo-----------------------------------------------------------------------------oSSo-------------------------------------------------------------------------------
------------oSoooSoo---------------------------------oooo---------------------------------oooo-------------ooo-------------ooo-------Sooo-------ooSo------------------------------------oooSoSo----SSo--
------------------------------------ooo-------------------------------------------ooo-----g--------------------------------------------------------------g---------oooo---------------------------------
------------ooooooo-----------XXX----------XXXXXXXXXXXXXXX---------XXXXXXXXXXXXXX-g----XXXXXXXX--------XXXXXXXXXX---------XXXXXXXX------------ooooooo--XXXXXXXXX-------------------------oooo-----------
--------------------------XXXXXXXXXXXXXXXXXXXXXXXXXXXXXXXXXXX---oo-XXXXXXXXXXXXXXXXXXXXXXXXXXXX--oooo--XXXXXXXXXXXXXXXXXXXXXXXXXXX---------------------XXXXXXXXX--XXXXXXXXXX---XXX---------------------X
----------XXXXXXXXXXX-----XXXXXXXXXXXXXXXXXXXXXXXXXXXXXXXXXXX------XXXXXXXXXXXXXXXXXXXXXXXXXXXX--------XXXXXXXXXXXXXXXXXXXXXXXXXXXXXXXXXXXXXXXXXXXXXXXXXXXXXXXXX--XXXXXXXXXX---XXXXXXXXXXXXXXXXXXXXXXXXX
XXXXXXXXXXXXXXXXXXXXXXXXXXXXXXXXXXXXXXXXXXXXXXXXXXXXXXXXXXXXXXXXXXXXXXXXXXXXXXXXXXXXXXXXXXXXXXXXXXXXXXXXXXXXXXXXXXXXXXXXXXXXXXXXXXXXXXXXXXXXXXXXXXXXXXXXXXXXXXXXXXXXXXXXXXXXXXXXXXXXXXXXXXXXXXXXXXXXXXXX

