--------------------------------------------------------------------------------------------------------------------------------------------------------------------------------------------------------
--------------------------------------------------------------------------------------------------------------------------------------------------------------------------------------------------------
--------------------------------------------------------------------------------------------------------------------------------------------------------------------------------------------------------
--------------------------------------------------------------------------------------------------------------------------------------------------------------------------------------------------------
--------------------------------------------------------------------------------------------------------------------------------------------------------------------------------------------------------
--------------------------------------------------------------------------------------------------------------------------------------------------------------------------------------------------------
--------------------------------------------------------------------------------------------------------------------------------------------------------------------------------------------------------
--------------------------------------------------------------------------------------------------------------------------------------------------------------------------------------------------------
--------------------------------------------------------------------------------------------------------------------------------------------------------------------------------------------------------
--------------------------------------------------------------------------------------------------------------------------------------------------------------------------------------------------------
--------------------------------------------------------------------------------------------------------------------------------------------------------------------------------------------------------
--------------------------------------------------------------------------------------------------------------------------------------------------------------------------------------------------------
--------------------------------------------------------SSo--------------------------------------------------------------------------SoSo-------------------------------------------------oSooS---------
--------------oooo--------------------------------------------------------SooS----oSoSoo-----------------------------------------------------Soooo------------------oooSoo---ooooSo---------------------
------------------------------oSoooo-------------------ooooo-------------------------------------ooSSSoS---------------------------oooo-----------------------------------------------------------------
------------oooooooo---------------------------oooo-----------ooSSSo------ooooo------oo---------------------oooSSo---oooS---ooSoo------g-----oooo-------------------ooooo------oo---------g-----g-------
XXXXXXXXXXX--------g-------------ooo-XXX------------XXXXXXXXX------------g-----------g-------------oooo---------------------------XXXXXXXX------------XXXX------------------------g------XXXXXXXXX------
XXXXXXXXXXXXXXXXXXXXX--g-------------XXXXXXXXXXXXXXXXXXXXXXXX---ooo---XXXXXXXXXXXXXXXXXXX---------------------oo-------oo------oo-XXXXXXXXXXXXXXXXXX--XXXX---------XXXXXXXXXXXXXXXXXX----XXXXXXXXXXXXXX-
XXXXXXXXXXXXXXXXXXXXXXXXXXXXXXXXXXXXXXXXXXXXXXXXXXXXXXXXXXXXX---------XXXXXXXXXXXXXXXXXXX-------XXXXXXXXXXX-----------------------XXXXXXXXXXXXXXXXXX--XXXX------XXXXXXXXXXXXXXXXXXXXX----XXXXXXXXXXXXXX-
XXXXXXXXXXXXXXXXXXXXXXXXXXXXXXXXXXXXXXXXXXXXXXXXXXXXXXXXXXXXXXXXXXXXXXXXXXXXXXXXXXXXXXXXXXXXXXXXXXXXXXXXXXXXXXXXXXXXXXXXXXXXXXXXXXXXXXXXXXXXXXXXXXXXXXXXXXXXXXXXXXXXXXXXXXXXXXXXXXXXXXXXXXXXXXXXXXXXXXXX

