--------------------------------------------------------------------------------------------------------------------------------------------------------------------------------------------------------
--------------------------------------------------------------------------------------------------------------------------------------------------------------------------------------------------------
--------------------------------------------------------------------------------------------------------------------------------------------------------------------------------------------------------
--------------------------------------------------------------------------------------------------------------------------------------------------------------------------------------------------------
--------------------------------------------------------------------------------------------------------------------------------------------------------------------------------------------------------
--------------------------------------------------------------------------------------------------------------------------------------------------------------------------------------------------------
--------------------------------------------------------------------------------------------------------------------------------------------------------------------------------------------------------
--------------------------------------------------------------------------------------------------------------------------------------------------------------------------------------------------------
--------------------------------------------------------------------------------------------------------------------------------------------------------------------------------------------------------
--------------------------------------------------------------------------------------------------------------------------------------------------------------------------------------------------------
--------------------------------------------------------------------------------------------------------------------------------------------------------------------------------------------------------
--------------------------------------------------------------------------------------------------------------------------------------------------------------------------------------------------------
--------------------------------------------------------------------------------------------------------------------------------------------------------------------------------------------------------
------------------------------------------------------------------------------------ooooSo--ooooooo-----------------------------------------------------------------------------------------------------
--------------------------------------------Soooooo---------------------------ooSo-------------------------------------------------------------------------------------------------------------ooo------
------------------------------------------------------------SSSo---------------------ooooo----ooo--------------------------------oooSooo---Soooo-----------oSo--------------oo--------------------------
-------------oooooo---------------oo--XXXX----oooooo-------------XXXX-------------------------------XXXXXX-------------XXXXXXX-------------------------------------XXXXX-----------------------oooo-----
----------------------XXXXX-----------XXXX-----------------ooooo-XXXX------------g-XXXXXXXXXXXXXXXXXXXXXXX-------ooooo-XXXXXXX----ooooo----ooooo-----oooo----------XXXXXXXXXXXXXX-ooo--XXX--------------
------------XXXXXXXXXXXXXXXXXXXXXXXXXXXXXXXXXXXXXXXXX------------XXXXXXX-----XXXXXXXXXXXXXXXXXXXXXXXXXXXXXXXXXX--------XXXXXXX-------------------------------------XXXXXXXXXXXXXX------XXXXXXXXXXXXXXXXX
XXXXXXXXXXXXXXXXXXXXXXXXXXXXXXXXXXXXXXXXXXXXXXXXXXXXXXXXXXXXXXXXXXXXXXXXXXXXXXXXXXXXXXXXXXXXXXXXXXXXXXXXXXXXXXXXXXXXXXXXXXXXXXXXXXXXXXXXXXXXXXXXXXXXXXXXXXXXXXXXXXXXXXXXXXXXXXXXXXXXXXXXXXXXXXXXXXXXXXXX

