--------------------------------------------------------------------------------------------------------------------------------------------------------------------------------------------------------
--------------------------------------------------------------------------------------------------------------------------------------------------------------------------------------------------------
--------------------------------------------------------------------------------------------------------------------------------------------------------------------------------------------------------
--------------------------------------------------------------------------------------------------------------------------------------------------------------------------------------------------------
--------------------------------------------------------------------------------------------------------------------------------------------------------------------------------------------------------
--------------------------------------------------------------------------------------------------------------------------------------------------------------------------------------------------------
--------------------------------------------------------------------------------------------------------------------------------------------------------------------------------------------------------
--------------------------------------------------------------------------------------------------------------------------------------------------------------------------------------------------------
--------------------------------------------------------------------------------------------------------------------------------------------------------------------------------------------------------
--------------------------------------------------------------------------------------------------------------------------------------------------------------------------------------------------------
--------------------------------------------------------------------------------------------------------------------------------------------------------------------------------------------------------
--------------------------------------------------------------------------------------------------------------------------------------------------------------------------------------------------------
------------oooo---ooSoo-----------------------------SSSooo----------------------------------------------------------------------------------------------------------------------oSoSo------------------
----------------------------oSSooSo---------------------------------------ooooo-------------------------------------------------------------------------------------------------------------------------
------------------ooooooo---------------------------oooooo-----oooooo--------------ooooo----------oSSo---------oSoo-------------------------------------------------------------ooooo-------------oooo--
-------------------------------oooo--------------------g-----------------oooooo-------------ooo--------------------------------------------------------------oooSoo----------------g--------------------
-----------XXXXXXXXXXXXXXXX-g----------------------XXXXXXXXXXX-oooo---------------oooo-------------ooo----XXXX-ooooooo--------XXXXXXXX---------------XXXX---------------oooo-XXXXXXXXXX----------XXXXXXX
XXXXXXXXXXXXXXXXXXXXXXXXXXXXXXXXXXXXXXXXXX--ooooo--XXXXXXXXXXX--------XXXXXXXXXX----g--g-XXXXXXXX---------XXXX----------------XXXXXXXX---------oooo--XXXX-------oooooo-------XXXXXXXXXXXXXXX-----XXXXXXX
XXXXXXXXXXXXXXXXXXXXXXXXXXXXXXXXXXXXXXXXXX---------XXXXXXXXXXXXXXXXXXXXXXXXXXXXXXXXXXXXXXXXXXXXXXXXXXXXXXXXXXXXXXXXXXXX-------XXXXXXXXXXXXXXX--------XXXX--------------XXXXXXXXXXXXXXXXXXXXX-----XXXXXXX
XXXXXXXXXXXXXXXXXXXXXXXXXXXXXXXXXXXXXXXXXXXXXXXXXXXXXXXXXXXXXXXXXXXXXXXXXXXXXXXXXXXXXXXXXXXXXXXXXXXXXXXXXXXXXXXXXXXXXXXXXXXXXXXXXXXXXXXXXXXXXXXXXXXXXXXXXXXXXXXXXXXXXXXXXXXXXXXXXXXXXXXXXXXXXXXXXXXXXXXX

