--------------------------------------------------------------------------------------------------------------------------------------------------------------------------------------------------------
--------------------------------------------------------------------------------------------------------------------------------------------------------------------------------------------------------
--------------------------------------------------------------------------------------------------------------------------------------------------------------------------------------------------------
--------------------------------------------------------------------------------------------------------------------------------------------------------------------------------------------------------
--------------------------------------------------------------------------------------------------------------------------------------------------------------------------------------------------------
--------------------------------------------------------------------------------------------------------------------------------------------------------------------------------------------------------
--------------------------------------------------------------------------------------------------------------------------------------------------------------------------------------------------------
--------------------------------------------------------------------------------------------------------------------------------------------------------------------------------------------------------
--------------------------------------------------------------------------------------------------------------------------------------------------------------------------------------------------------
--------------------------------------------------------------------------------------------------------------------------------------------------------------------------------------------------------
--------------------------------------------------------------------------------------------------------------------------------------------------------------------------------------------------------
--------------------------------------------------------------------------------------------------------------------------------------------------------------------------------------------------------
---------------------ooo---------------------------------------------------------------------------------------ooSo------------------------------------oSSo-----------------------------ooSSoo----------
-----------------------------------------------------------------------------------------------------SoSSooo----------------oooooo----------------------------------------------------------------------
--------------oo--------------------------------oooooS-------------------------ooSooSo---------ooo------------ooo---------------------------------------oooooo----------oooo--------------ooooo---------
------------------------------Soo-------ooS---------------------------oSS----------------------------ooooo--------------------ooo----------ooSooS----g------g--------------------ooo--------------------
----------XXXXXXX--XXXXXXXX-------------------ooooooo---------XXX---------------oooo---------XXXXXX----------XXXXXXX--------------------------------XXXXXXXXXXX--------XXXXXXX---------XXXXXXXXX-----XXX
----------XXXXXXX--XXXXXXXX----oo----oooooo-----------------XXXXXXXXX-------------------XXXXXXXXXXXXXXXXXXXXXXXXXXXXXXX----XXXXXXXXX--------oooooo--XXXXXXXXXXX--------XXXXXXXXXXXXXXXXXXXXXXXXX-----XXX
XXXXXXXXXXXXXXXXXXXXXXXXXXX--g---------------XXXXXXXXXXXXXXXXXXXXXXXX---------XXXXXXXXXXXXXXXXXXXXXXXXXXXXXXXXXXXXXXXXXXXXXXXXXXXXXXXXXXXX----gg----XXXXXXXXXXXXXXXXXXXXXXXXXXXXXXXXXXXXXXXXXXXXXXXXXXXX
XXXXXXXXXXXXXXXXXXXXXXXXXXXXXXXXXXXXXXXXXXXXXXXXXXXXXXXXXXXXXXXXXXXXXXXXXXXXXXXXXXXXXXXXXXXXXXXXXXXXXXXXXXXXXXXXXXXXXXXXXXXXXXXXXXXXXXXXXXXXXXXXXXXXXXXXXXXXXXXXXXXXXXXXXXXXXXXXXXXXXXXXXXXXXXXXXXXXXXXX

