--------------------------------------------------------------------------------------------------------------------------------------------------------------------------------------------------------
--------------------------------------------------------------------------------------------------------------------------------------------------------------------------------------------------------
--------------------------------------------------------------------------------------------------------------------------------------------------------------------------------------------------------
--------------------------------------------------------------------------------------------------------------------------------------------------------------------------------------------------------
--------------------------------------------------------------------------------------------------------------------------------------------------------------------------------------------------------
--------------------------------------------------------------------------------------------------------------------------------------------------------------------------------------------------------
--------------------------------------------------------------------------------------------------------------------------------------------------------------------------------------------------------
--------------------------------------------------------------------------------------------------------------------------------------------------------------------------------------------------------
--------------------------------------------------------------------------------------------------------------------------------------------------------------------------------------------------------
--------------------------------------------------------------------------------------------------------------------------------------------------------------------------------------------------------
--------------------------------------------------------------------------------------------------------------------------------------------------------------------------------------------------------
--------------------------------------------------------------------------------------------------------------------------------------------------------------------------------------------------------
-----------------------------------ooo--------------------------------------------------------------------------------------------------------oooooo----------------------------------------------------
-----------------------------------------------------------ooo--------------oSoooooo----------------------------------------------------------------------------------SSS-----------ooSoooSo------------
---------------oSSo---ooo-----------------oooo------------------------------------------------------------ooooSSoSo---------------------------oooooo---ooSoSo-------------------------------------------
------------------------------ooo--------g------------oo---oo-------SoS--------ooo-------------------------------------------------ooooSoSSo--------------------------oooo---------ooooooooo---oo-------
----------------------------------XXXXXXXXXXXXXX----------------------------------------------------oo----ooooooooo--oooo--------------------XXXXXXXXX---oo--------------------------------g----------XX
XXXXXXXXXXXXXX-------g----XXXXXXXXXXXXXXXXXXXXXXXXXXXXXXXXXXXXXX---oooo----XXXXXXXXXX--------ooooo-------------g---------------------ooooo---XXXXXXXXX------------XXXXXXXXXXXXX---XXXXXXXXXXXXXXXXXX--XX
XXXXXXXXXXXXXXXXXXXXXXXXXXXXXXXXXXXXXXXXXXXXXXXXXXXXXXXXXXXXXXXX-----------XXXXXXXXXXXXXXXX--------XXXXXXXXXXXXXXXXXXXXXXXXXXXXXXX-----------XXXXXXXXXXXXXXXXXXXXXXXXXXXXXXXXXXXXXXXXXXXXXXXXXXXXXXX--XX
XXXXXXXXXXXXXXXXXXXXXXXXXXXXXXXXXXXXXXXXXXXXXXXXXXXXXXXXXXXXXXXXXXXXXXXXXXXXXXXXXXXXXXXXXXXXXXXXXXXXXXXXXXXXXXXXXXXXXXXXXXXXXXXXXXXXXXXXXXXXXXXXXXXXXXXXXXXXXXXXXXXXXXXXXXXXXXXXXXXXXXXXXXXXXXXXXXXXXXXX

