--------------------------------------------------------------------------------------------------------------------------------------------------------------------------------------------------------
--------------------------------------------------------------------------------------------------------------------------------------------------------------------------------------------------------
--------------------------------------------------------------------------------------------------------------------------------------------------------------------------------------------------------
--------------------------------------------------------------------------------------------------------------------------------------------------------------------------------------------------------
--------------------------------------------------------------------------------------------------------------------------------------------------------------------------------------------------------
--------------------------------------------------------------------------------------------------------------------------------------------------------------------------------------------------------
--------------------------------------------------------------------------------------------------------------------------------------------------------------------------------------------------------
--------------------------------------------------------------------------------------------------------------------------------------------------------------------------------------------------------
--------------------------------------------------------------------------------------------------------------------------------------------------------------------------------------------------------
--------------------------------------------------------------------------------------------------------------------------------------------------------------------------------------------------------
--------------------------------------------------------------------------------------------------------------------------------------------------------------------------------------------------------
--------------------------------------------------------------------------------------------------------------------------------------------------------------------------------------------------------
--------------------------------------------------------------------------------------------------------------------------------------------oSSSoSS-----------------------------------------------------
--------------------------------------------------------------oSooo--------------------------ooSooo----------------------------------------------------------oSSSo----------oooo------------------------
----------------------oSSSS----------------oo----------oooo---------------------------------------------------------------------------------ooooooo-----------------oSSo------------------------oSoSSo--
--------------------------------------------------------------ooooo-------------oSoSooo--------ooooo----------ooo----------ooSooSS-------------------------ooooooo----------ooooooo---------------------
XXXXXXXXXXXXX--ooo-----ooooo-----------XXXXXXX--------ooooo----------------oo----------------------------------------XXXXX-----------------XXXXXXXXXXXXXXX--g---------oo------g--------XXXXXXXX---ooooo-
XXXXXXXXXXXXX------------------XX-ooo--XXXXXXX--------------XXXXXXXXXXX----------ooo----XXXXXXXXXXXXXXXXX--XXXXXXXXXXXXXXX--ooooooo--XXXXXXXXXXXXXXXXXXXXXXXXXXXXXX-------XXXXXXXXXX---XXXXXXXX---------
XXXXXXXXXXXXXXXXXXXXXXXXXXXXXXXXX------XXXXXXX------XXXXXXXXXXXXXXXXXXXXXXXXXXX---------XXXXXXXXXXXXXXXXXXXXXXXXXXXXXXXXXX-----------XXXXXXXXXXXXXXXXXXXXXXXXXXXXXXXXXXXXXXXXXXXXXXX---XXXXXXXXXXXXXXXXX
XXXXXXXXXXXXXXXXXXXXXXXXXXXXXXXXXXXXXXXXXXXXXXXXXXXXXXXXXXXXXXXXXXXXXXXXXXXXXXXXXXXXXXXXXXXXXXXXXXXXXXXXXXXXXXXXXXXXXXXXXXXXXXXXXXXXXXXXXXXXXXXXXXXXXXXXXXXXXXXXXXXXXXXXXXXXXXXXXXXXXXXXXXXXXXXXXXXXXXXX

