--------------------------------------------------------------------------------------------------------------------------------------------------------------------------------------------------------
--------------------------------------------------------------------------------------------------------------------------------------------------------------------------------------------------------
--------------------------------------------------------------------------------------------------------------------------------------------------------------------------------------------------------
--------------------------------------------------------------------------------------------------------------------------------------------------------------------------------------------------------
--------------------------------------------------------------------------------------------------------------------------------------------------------------------------------------------------------
--------------------------------------------------------------------------------------------------------------------------------------------------------------------------------------------------------
--------------------------------------------------------------------------------------------------------------------------------------------------------------------------------------------------------
--------------------------------------------------------------------------------------------------------------------------------------------------------------------------------------------------------
--------------------------------------------------------------------------------------------------------------------------------------------------------------------------------------------------------
--------------------------------------------------------------------------------------------------------------------------------------------------------------------------------------------------------
--------------------------------------------------------------------------------------------------------------------------------------------------------------------------------------------------------
--------------------------------------------------------------------------------------------------------------------------------------------------------------------------------------------------------
-------------ooo-----------------------------------------------------------------------------------------------------------------------------------------oSo--------------------------------------------
-----------------------ooo-----ooSSSSo--------------------------------ooooo-----------------------------------------------------------------------------------------------------------------------------
---------------oooo-------------------------------------------------------------------------oo-------------------------------------------ooSSoo---------------------------------------------------------
---------------------oooooooo-----oooo-------SoS---------------------ooooooo--oooo---------------ooo---------ooSo------ooS--------------------------------------oooSSo----------SSSooo------------------
XXXXXXXXXXXXXXXXXXXX-------------------------------------XXXX------------g-----------XXXXXXXXXXX-g----XXXXXX----------------------------oooooo--XXXX----XXXXXXX-----------------------------------------
XXXXXXXXXXXXXXXXXXXXXXXXXXXXXXXXXXXXXXXXXXX--------XXXXXXXXXXXXXXXXXXXXXXXXXX--ooo---XXXXXXXXXXXXXXXXXXXXXXX---ooo-----oooooo-----oo------------XXXX----XXXXXXX----oooo----------ooo----------------oo-X
XXXXXXXXXXXXXXXXXXXXXXXXXXXXXXXXXXXXXXXXXXX--------XXXXXXXXXXXXXXXXXXXXXXXXXX--------XXXXXXXXXXXXXXXXXXXXXXX--------------------------XXXXXXXXXXXXXXXXXXXXXXXXX---g------------------------------------X
XXXXXXXXXXXXXXXXXXXXXXXXXXXXXXXXXXXXXXXXXXXXXXXXXXXXXXXXXXXXXXXXXXXXXXXXXXXXXXXXXXXXXXXXXXXXXXXXXXXXXXXXXXXXXXXXXXXXXXXXXXXXXXXXXXXXXXXXXXXXXXXXXXXXXXXXXXXXXXXXXXXXXXXXXXXXXXXXXXXXXXXXXXXXXXXXXXXXXXXX

