--------------------------------------------------------------------------------------------------------------------------------------------------------------------------------------------------------
--------------------------------------------------------------------------------------------------------------------------------------------------------------------------------------------------------
--------------------------------------------------------------------------------------------------------------------------------------------------------------------------------------------------------
--------------------------------------------------------------------------------------------------------------------------------------------------------------------------------------------------------
--------------------------------------------------------------------------------------------------------------------------------------------------------------------------------------------------------
--------------------------------------------------------------------------------------------------------------------------------------------------------------------------------------------------------
--------------------------------------------------------------------------------------------------------------------------------------------------------------------------------------------------------
--------------------------------------------------------------------------------------------------------------------------------------------------------------------------------------------------------
--------------------------------------------------------------------------------------------------------------------------------------------------------------------------------------------------------
--------------------------------------------------------------------------------------------------------------------------------------------------------------------------------------------------------
--------------------------------------------------------------------------------------------------------------------------------------------------------------------------------------------------------
--------------------------------------------------------------------------------------------------------------------------------------------------------------------------------------------------------
------------------------------------------------------oooo-----------------ooooSoo---------------------------------------------------------------------------oooooSS------------------------oSooSoo-----
------------ooSoo-------------------------------------------------oooooSo-------------------SooSo-------------------------------------ooo------------------------------------------Soooo----------------
-----------------------oo-----------------------------ooo------------------oooo---------------------------------oSoo--------ooSoSo------------------------------ooo------------------------ooooooooo----
-------------------------------------------------------------------ooo----------------------oooo--------oSSS--------------------------oooo---------------------------------------ooooooo--------g-------
-------------g------XXXXXX-----------------------XXXXXXXXXX---------------XXXXXXXXX-------------------------------oooo----ooooo-----------------------------XXXXXXXXXX--oooo--------------XXXXXXXXXXX---
-----------XXXXXXX--XXXXXX-----------XXXXXX--XXXXXXXXXXXXXX-oo---XXXXXXXXXXXXXXXXXXXXXXXXXXXXXXXXXX------oo------------------------XXXXXXXXXX-------ooooooo-XXXXXXXXXX---------XXXXXXXXXXXXXXXXXXXXXX---
XXXXXXXXXXXXXXXXXX--XXXXXX-----------XXXXXX--XXXXXXXXXXXXXX------XXXXXXXXXXXXXXXXXXXXXXXXXXXXXXXXXXXX----------XXXXXXXXXXXXXXXXXXXXXXXXXXXXXX---------------XXXXXXXXXXXXXXXXXXXXXXXXXXXXXXXXXXXXXXXXXXXX
XXXXXXXXXXXXXXXXXXXXXXXXXXXXXXXXXXXXXXXXXXXXXXXXXXXXXXXXXXXXXXXXXXXXXXXXXXXXXXXXXXXXXXXXXXXXXXXXXXXXXXXXXXXXXXXXXXXXXXXXXXXXXXXXXXXXXXXXXXXXXXXXXXXXXXXXXXXXXXXXXXXXXXXXXXXXXXXXXXXXXXXXXXXXXXXXXXXXXXXX

