--------------------------------------------------------------------------------------------------------------------------------------------------------------------------------------------------------
--------------------------------------------------------------------------------------------------------------------------------------------------------------------------------------------------------
--------------------------------------------------------------------------------------------------------------------------------------------------------------------------------------------------------
--------------------------------------------------------------------------------------------------------------------------------------------------------------------------------------------------------
--------------------------------------------------------------------------------------------------------------------------------------------------------------------------------------------------------
--------------------------------------------------------------------------------------------------------------------------------------------------------------------------------------------------------
--------------------------------------------------------------------------------------------------------------------------------------------------------------------------------------------------------
--------------------------------------------------------------------------------------------------------------------------------------------------------------------------------------------------------
--------------------------------------------------------------------------------------------------------------------------------------------------------------------------------------------------------
--------------------------------------------------------------------------------------------------------------------------------------------------------------------------------------------------------
--------------------------------------------------------------------------------------------------------------------------------------------------------------------------------------------------------
--------------------------------------------------------------------------------------------------------------------------------------------------------------------------------------------------------
--------------------------------------------------------------------------------------------------------------------ooooooo-----------------------------------------------------------------------------
-------------------------------ooo------oSoSo---------------------oSooooo------------------ooSoo-----ooSoS----------------------------------------------------------------------------------------------
-----------------oSS---------------------------------------------------------------oooo------------------------------ooooo---------------SooooS-------------Soo-----------oo----------------------------
-------------oo-----------------ooo---ooooo----------------------ooooooo--------------------ooo--------oooo------------------------------------------------------------------------------------oooSoo---
--------------------ooo----------------------g------------------------------oo---XXXXXXX--------------------XXXXXXXXXXXXXXXX---XX-------oooooooo------oo--oooooooo-------%%%%-------XX------------------
XXXXXXXXXXXXXXXX--------------XXXXXXXXXXXXXXXXX-----oooooo------XXXXXXXXXX-------XXXXXXXXXXXXXXXXX--XXXXXXXXXXXXXXXXXXXXXXXX---XX---oo-----------------------------------||||-------XX---------oooooo---
XXXXXXXXXXXXXXXXXXXXXXXX------XXXXXXXXXXXXXXXXXXXX---------XX---XXXXXXXXXXXXXXXXXXXXXXXXXXXXXXXXXXXXXXXXXXXXXXXXXXXXXXXXXXXX---XX------XXXXXXXXXXXXXXXXXXXXXXXXXXXX------||||-------XX---XXXXX----------
XXXXXXXXXXXXXXXXXXXXXXXXXXXXXXXXXXXXXXXXXXXXXXXXXXXXXXXXXXXXXXXXXXXXXXXXXXXXXXXXXXXXXXXXXXXXXXXXXXXXXXXXXXXXXXXXXXXXXXXXXXXXXXXXXXXXXXXXXXXXXXXXXXXXXXXXXXXXXXXXXXXXXXXXXXXXXXXXXXXXXXXXXXXXXXXXXXXXXXXX

