--------------------------------------------------------------------------------------------------------------------------------------------------------------------------------------------------------
--------------------------------------------------------------------------------------------------------------------------------------------------------------------------------------------------------
--------------------------------------------------------------------------------------------------------------------------------------------------------------------------------------------------------
--------------------------------------------------------------------------------------------------------------------------------------------------------------------------------------------------------
--------------------------------------------------------------------------------------------------------------------------------------------------------------------------------------------------------
--------------------------------------------------------------------------------------------------------------------------------------------------------------------------------------------------------
--------------------------------------------------------------------------------------------------------------------------------------------------------------------------------------------------------
--------------------------------------------------------------------------------------------------------------------------------------------------------------------------------------------------------
--------------------------------------------------------------------------------------------------------------------------------------------------------------------------------------------------------
--------------------------------------------------------------------------------------------------------------------------------------------------------------------------------------------------------
--------------------------------------------------------------------------------------------------------------------------------------------------------------------------------------------------------
--------------------------------------------------------------------------------------------------------------------------------------------------------------------------------------------------------
----------------------------------------------oSo-------------------------------------------------------------------------------------------------------------------------------------------------------
---------------------------oooSoS------------------------------------------------------------------------------------------------------------oSooo--------------------------------------------ooooooSo--
------------------SooS-----------------oo--oooooo--------Soo---------------------------------------------ooo--------------------------ooo-----------------------------oSSoSSS---------------------------
-------------------------ooooooooo------------g------------------------------Soooo-----------ooooSoo------------ooo------oooSSS--------------ooooooo--------oSSoS------------------------ooo--oooooooo--
------------------ooooo------------XXXXXXXXXXXXXXXXXX--ooo--------XXXX--------------XXXXXXX-------------oooo-----------------------ooo-----------------------------------ooo----XX----------------------
------------------------XXXXXXXXXXXXXXXXXXXXXXXXXXXXX---g----XXXXXXXXX-------ooo----XXXXXXX---ooo---------------oo-------oooooo-----------XXXXXXXXXXX--------ooooo--------------XXXXXXXXXXXXXXXXXXXXXXXX
--------------XXXXXXXXXXXXXXXXXXXXXXXXXXXXXXXXXXXXXXXXXXXXXXXXXXXXXXXXXXXX----------XXXXXXX----------XXXXXXXX---g-----XX----------XXXXXXXXXXXXXXXXXXXXXXXX-----------XXXXXXXXXXXXXXXXXXXXXXXXXXXXXXXXXXX
XXXXXXXXXXXXXXXXXXXXXXXXXXXXXXXXXXXXXXXXXXXXXXXXXXXXXXXXXXXXXXXXXXXXXXXXXXXXXXXXXXXXXXXXXXXXXXXXXXXXXXXXXXXXXXXXXXXXXXXXXXXXXXXXXXXXXXXXXXXXXXXXXXXXXXXXXXXXXXXXXXXXXXXXXXXXXXXXXXXXXXXXXXXXXXXXXXXXXXXX

