--------------------------------------------------------------------------------------------------------------------------------------------------------------------------------------------------------
--------------------------------------------------------------------------------------------------------------------------------------------------------------------------------------------------------
--------------------------------------------------------------------------------------------------------------------------------------------------------------------------------------------------------
--------------------------------------------------------------------------------------------------------------------------------------------------------------------------------------------------------
--------------------------------------------------------------------------------------------------------------------------------------------------------------------------------------------------------
--------------------------------------------------------------------------------------------------------------------------------------------------------------------------------------------------------
--------------------------------------------------------------------------------------------------------------------------------------------------------------------------------------------------------
--------------------------------------------------------------------------------------------------------------------------------------------------------------------------------------------------------
--------------------------------------------------------------------------------------------------------------------------------------------------------------------------------------------------------
--------------------------------------------------------------------------------------------------------------------------------------------------------------------------------------------------------
--------------------------------------------------------------------------------------------------------------------------------------------------------------------------------------------------------
--------------------------------------------------------------------------------------------------------------------------------------------------------------------------------------------------------
----------------------------------------------------------ooSo------------------------------------------------------------------------------------------------------------------------------------------
---------------ooSoooo----SooSoo----------------ooSoSo--------------------------------------------------------------------------------------------------------------------------------------------------
----------------------------------------------------------oo--------------------------------oooo--------------------------------------------SSSSoo------------------------oSSSoo------------------------
----------------ooo--------ooo--------------------oooo----------ooo-----------------ooSoo---------------------------oSoo------SSSo---------------------SoSo---------------------------------------------
------------------------g------g--XXXXXXXXX--------------XXXXXX--------oooo------------------ooooo----------------------------------ooo------ooooo---------------------------oo-------------------------
XXXXXXXXXXXXXXXXXXXXXXXXXXXXXXXXXXXXXXXXXXX---XXXXXXXXXXXXXXXXXXXXXXXX-------------oooo-----------------------------ooooo----oooo---g----------------ooooo--------oooo---------gg---------XXXXXX----ooo-
XXXXXXXXXXXXXXXXXXXXXXXXXXXXXXXXXXXXXXXXXXX---XXXXXXXXXXXXXXXXXXXXXXXXXXXXXXXX----------g--XXXXXXXXXXXXXXX-------------------------XXXXXXXXXXXXXXXX----------------------XXXXXXXXXXXXXXXXXXXXXXX------g-
XXXXXXXXXXXXXXXXXXXXXXXXXXXXXXXXXXXXXXXXXXXXXXXXXXXXXXXXXXXXXXXXXXXXXXXXXXXXXXXXXXXXXXXXXXXXXXXXXXXXXXXXXXXXXXXXXXXXXXXXXXXXXXXXXXXXXXXXXXXXXXXXXXXXXXXXXXXXXXXXXXXXXXXXXXXXXXXXXXXXXXXXXXXXXXXXXXXXXXXX

