--------------------------------------------------------------------------------------------------------------------------------------------------------------------------------------------------------
--------------------------------------------------------------------------------------------------------------------------------------------------------------------------------------------------------
--------------------------------------------------------------------------------------------------------------------------------------------------------------------------------------------------------
--------------------------------------------------------------------------------------------------------------------------------------------------------------------------------------------------------
--------------------------------------------------------------------------------------------------------------------------------------------------------------------------------------------------------
--------------------------------------------------------------------------------------------------------------------------------------------------------------------------------------------------------
--------------------------------------------------------------------------------------------------------------------------------------------------------------------------------------------------------
--------------------------------------------------------------------------------------------------------------------------------------------------------------------------------------------------------
--------------------------------------------------------------------------------------------------------------------------------------------------------------------------------------------------------
--------------------------------------------------------------------------------------------------------------------------------------------------------------------------------------------------------
--------------------------------------------------------------------------------------------------------------------------------------------------------------------------------------------------------
--------------------------------------------------------------------------------------------------------------------------------------------------------------------------------------------------------
-----------------------------------------ooSo------------oooSSoS----------------------------------------------------------------------------------------------------------------------------------------
---------------------------------------------------------------------------------------------------------ooSoS------------------------------------------------------------------------------------------
--------------------------------------oooooo----------------ooooo---------------------------------------------------------------------------------------------------------------------------------------
--------------oo----ooSoo----oooSooo---------------------------------------------------------------------ooooo-----------------SooSo-------oooSooSo--------------oooSoo------ooooo-------------g--------
-------------------------------------XXXXXXXXX----------XXXXXXXXXXX---oo------------------------------------------------------------------------------oooo--------------XXXX----------XXXXXXXXXXXXXX----
----------XXXXXXXXX--ooo----oooooo---XXXXXXXXXXXXXXXXXXXXXXXXXXXXXX---------XXXXXXXXXXXXXX---------XXXXXXXXXXXXXX-----XX--------ooooo-XXXX---oooo----------XXXX----oooo-XXXX-ooooooo--XXXXXXXXXXXXXX---X
----------XXXXXXXXX---------g--------XXXXXXXXXXXXXXXXXXXXXXXXXXXXXXXXXXXXXXXXXXXXXXXXXXXXX------g--XXXXXXXXXXXXXX-----XX--------------XXXX-----------XXXXXXXXXX---------XXXX--------g-XXXXXXXXXXXXXX---X
XXXXXXXXXXXXXXXXXXXXXXXXXXXXXXXXXXXXXXXXXXXXXXXXXXXXXXXXXXXXXXXXXXXXXXXXXXXXXXXXXXXXXXXXXXXXXXXXXXXXXXXXXXXXXXXXXXXXXXXXXXXXXXXXXXXXXXXXXXXXXXXXXXXXXXXXXXXXXXXXXXXXXXXXXXXXXXXXXXXXXXXXXXXXXXXXXXXXXXXX

