--------------------------------------------------------------------------------------------------------------------------------------------------------------------------------------------------------
--------------------------------------------------------------------------------------------------------------------------------------------------------------------------------------------------------
--------------------------------------------------------------------------------------------------------------------------------------------------------------------------------------------------------
--------------------------------------------------------------------------------------------------------------------------------------------------------------------------------------------------------
--------------------------------------------------------------------------------------------------------------------------------------------------------------------------------------------------------
--------------------------------------------------------------------------------------------------------------------------------------------------------------------------------------------------------
--------------------------------------------------------------------------------------------------------------------------------------------------------------------------------------------------------
--------------------------------------------------------------------------------------------------------------------------------------------------------------------------------------------------------
--------------------------------------------------------------------------------------------------------------------------------------------------------------------------------------------------------
--------------------------------------------------------------------------------------------------------------------------------------------------------------------------------------------------------
--------------------------------------------------------------------------------------------------------------------------------------------------------------------------------------------------------
--------------------------------------------------------------------------------------------------------------------------------------------------------------------------------------------------------
------------------ooooS----------------oSSS-----oSo-------------------------------------------------------------------------oooS--------------------------------------oooo------------------------------
-----------------------------------------------------------------------------------oooo-----------------------------------------------------------------------------------------------------------------
-------------------ooo------------------ooooo---------oSooSSSoo-----------------------------------------------------------oooo--------------------oooooo------------ooooo-------------------------------
--------------------------------g----------g------------------------------------------------------------------oooSoo--------g----------------------------------------g---------------ooSoo--------------
-----------------XXXXXXXX------XXXXXXXXXXXXXXXXXXXXXX--ooooooo----------------------------------XX--------------------XXXXXXXXXXXX-g--------------oooo-------------XXXXXXXXX---------------------XXXXXXX
XXXXXXXXXXXXXXXXXXXXXXXXX-oo---XXXXXXXXXXXXXXXXXXXXXX-----g-----XXXXXXXX----------XXXXXXXXXXXXXXXX------------oooooo--XXXXXXXXXXXXXXXXXXX-oooooo---------XXXX------XXXXXXXXX---------ooo---------XXXXXXX
XXXXXXXXXXXXXXXXXXXXXXXXX------XXXXXXXXXXXXXXXXXXXXXXXXXXXXXXXXXXXXXXXXX----------XXXXXXXXXXXXXXXX-------XX-----------XXXXXXXXXXXXXXXXXXX--------XXXXXXXXXXXX------XXXXXXXXXXXXXX----------------XXXXXXX
XXXXXXXXXXXXXXXXXXXXXXXXXXXXXXXXXXXXXXXXXXXXXXXXXXXXXXXXXXXXXXXXXXXXXXXXXXXXXXXXXXXXXXXXXXXXXXXXXXXXXXXXXXXXXXXXXXXXXXXXXXXXXXXXXXXXXXXXXXXXXXXXXXXXXXXXXXXXXXXXXXXXXXXXXXXXXXXXXXXXXXXXXXXXXXXXXXXXXXXX

