--------------------------------------------------------------------------------------------------------------------------------------------------------------------------------------------------------
--------------------------------------------------------------------------------------------------------------------------------------------------------------------------------------------------------
--------------------------------------------------------------------------------------------------------------------------------------------------------------------------------------------------------
--------------------------------------------------------------------------------------------------------------------------------------------------------------------------------------------------------
--------------------------------------------------------------------------------------------------------------------------------------------------------------------------------------------------------
--------------------------------------------------------------------------------------------------------------------------------------------------------------------------------------------------------
--------------------------------------------------------------------------------------------------------------------------------------------------------------------------------------------------------
--------------------------------------------------------------------------------------------------------------------------------------------------------------------------------------------------------
--------------------------------------------------------------------------------------------------------------------------------------------------------------------------------------------------------
--------------------------------------------------------------------------------------------------------------------------------------------------------------------------------------------------------
--------------------------------------------------------------------------------------------------------------------------------------------------------------------------------------------------------
--------------------------------------------------------------------------------------------------------------------------------------------------------------------------------------------------------
--------------------------------------------------------------------------------------------oooSoo--------------------ooooooo----oSooSo-----------------------------------------------------------------
-------------------------------------------------------------------------------------------------------------------------------------------SooSo---------------------------SSoooSo----------------------
-----------------------------------------------------------oooS-------------------------------ooooo---------------------ooooo------ooo---------------------ooSoo---oo-----------------------------------
-------------------------------------ooo------------------------------------------------------------------oooooS---------------------------ooo---------------------------ooooooooo--------------oSooS---
---------------XXX--oo----XXXX-----------XX----------------oooo----XX-----------XXXX------XXXXXXXXXXX----------------XXXXXXXXXXXXXXXXXXX-------g-XXXX------oooo---XXXXXX--------------------XXX---------
---------------XXX--------XXXX-----XXXXXXXXXXXXXXXXXX--------------XX----ooo----XXXX------XXXXXXXXXXX------ooo-------XXXXXXXXXXXXXXXXXXXXXXXXXXXXXXXX---------g---XXXXXXXXXXXXXXXXXXXXXX----XXX----oo---
XXXXXXXXXXXX---XXXXXXXXXXXXXXX-----XXXXXXXXXXXXXXXXXXXXXXXXXXXXXXXXXXXXX-g------XXXXXXXXXXXXXXXXXXXXXXX-----------XXXXXXXXXXXXXXXXXXXXXXXXXXXXXXXXXXX-----XXXXXXXXXXXXXXXXXXXXXXXXXXXXXX----XXX---------
XXXXXXXXXXXXXXXXXXXXXXXXXXXXXXXXXXXXXXXXXXXXXXXXXXXXXXXXXXXXXXXXXXXXXXXXXXXXXXXXXXXXXXXXXXXXXXXXXXXXXXXXXXXXXXXXXXXXXXXXXXXXXXXXXXXXXXXXXXXXXXXXXXXXXXXXXXXXXXXXXXXXXXXXXXXXXXXXXXXXXXXXXXXXXXXXXXXXXXXX

