--------------------------------------------------------------------------------------------------------------------------------------------------------------------------------------------------------
--------------------------------------------------------------------------------------------------------------------------------------------------------------------------------------------------------
--------------------------------------------------------------------------------------------------------------------------------------------------------------------------------------------------------
--------------------------------------------------------------------------------------------------------------------------------------------------------------------------------------------------------
--------------------------------------------------------------------------------------------------------------------------------------------------------------------------------------------------------
--------------------------------------------------------------------------------------------------------------------------------------------------------------------------------------------------------
--------------------------------------------------------------------------------------------------------------------------------------------------------------------------------------------------------
--------------------------------------------------------------------------------------------------------------------------------------------------------------------------------------------------------
--------------------------------------------------------------------------------------------------------------------------------------------------------------------------------------------------------
--------------------------------------------------------------------------------------------------------------------------------------------------------------------------------------------------------
--------------------------------------------------------------------------------------------------------------------------------------------------------------------------------------------------------
--------------------------------------------------------------------------------------------------------------------------------------------------------------------------------------------------------
--------------------------------------oSo-------------------------------------------------ooooSo--------------oooooo------------------------------------------------------------------oSooSo------------
--------------------------------------------------------------------------------------------------------------------------------------------------------------------------------------------------------
-------------oSS-------------------ooo-------ooooSo-----------------------------oSoo------ooooo----oSSoSoooo----oo---------------oSoS-------------------------------------------------oooo--------------
-------------------------oSoooooo-------------------------------------------------------------------------------------oSooSoSS----------------------------ooo--------------ooSooo--------g-----oooSo----
---------------ooo----------------XXXXXXXX----ooooo------------------------------------XXXXXXXXXXX---ooooooo-XXXXXXXX------------oooooo----------------------------------------------XXXXXXXX---------XX
---------------------------ooo----XXXXXXXX-----g------ooooo------XXXXXXXXXXX-----------XXXXXXXXXXX-----------XXXXXXXX---oooooo---------------XXXXXXXX----XXXXXX--------XXX--oooo-----XXXXXXXX--ooooo--XX
XXXXXXXXXXXXXXXXXXX---------------XXXXXXXXXXXXXXXXXXX-------XXXXXXXXXXXXXXXX--XXXXXXXXXXXXXXXXXXXXXXXXXXXXXXXXXXXXXXX---------g-XXXXXXXXXXXXXXXXXXXXXXXXXXXXXXXXXXX----XXX---------XXXXXXXXXX---------XX
XXXXXXXXXXXXXXXXXXXXXXXXXXXXXXXXXXXXXXXXXXXXXXXXXXXXXXXXXXXXXXXXXXXXXXXXXXXXXXXXXXXXXXXXXXXXXXXXXXXXXXXXXXXXXXXXXXXXXXXXXXXXXXXXXXXXXXXXXXXXXXXXXXXXXXXXXXXXXXXXXXXXXXXXXXXXXXXXXXXXXXXXXXXXXXXXXXXXXXXX

