--------------------------------------------------------------------------------------------------------------------------------------------------------------------------------------------------------
--------------------------------------------------------------------------------------------------------------------------------------------------------------------------------------------------------
--------------------------------------------------------------------------------------------------------------------------------------------------------------------------------------------------------
--------------------------------------------------------------------------------------------------------------------------------------------------------------------------------------------------------
--------------------------------------------------------------------------------------------------------------------------------------------------------------------------------------------------------
--------------------------------------------------------------------------------------------------------------------------------------------------------------------------------------------------------
--------------------------------------------------------------------------------------------------------------------------------------------------------------------------------------------------------
--------------------------------------------------------------------------------------------------------------------------------------------------------------------------------------------------------
--------------------------------------------------------------------------------------------------------------------------------------------------------------------------------------------------------
--------------------------------------------------------------------------------------------------------------------------------------------------------------------------------------------------------
--------------------------------------------------------------------------------------------------------------------------------------------------------------------------------------------------------
--------------------------------------------------------------------------------------------------------------------------------------------------------------------------------------------------------
----------------------oSo-------------------------------------------------------------------------------------------ooooo-------------------------------------------------------------------------------
-----------oSS-------------------------------------------------------------------------------------------------------------------------------------------------------------------------------oooo-------
----------------------oooo----------------oSoo--------------ooooo-----------------------------------------------------ooo-------ooooo-------------------------------------oooSS-------------------------
-----------ooo---------g------------------------------------------------------------------------------ooo---------------------------------------------------------oSSo-----------------------oooo-------
------------------XXXXXXXXXXXXXXXX---------oo-------------XXXXXXXX---------------------------XXX-------------------XXXXXXX-----XXXXXXX--oooo------------------------------oooooo-----XXXX------g--------
XXXXXXXXXXXXXXXXXXXXXXXXXXXXXXXXXXXXXXXX------------------XXXXXXXX-----oooooo----------XXXXXXXXX--------ooo----ooo-XXXXXXXXXXXXXXXXXXX--------XXX--XXXXX-----------ooooo-------------XXXXXXXXXXXXXXX----
XXXXXXXXXXXXXXXXXXXXXXXXXXXXXXXXXXXXXXXXXXXXXXXXXXXXXX----XXXXXXXX------------XXXX---XXXXXXXXXXX----------------g--XXXXXXXXXXXXXXXXXXXXXXXXXXXXXXXXXXXXXXX---------------XXXXXXXX----XXXXXXXXXXXXXXXXXXX
XXXXXXXXXXXXXXXXXXXXXXXXXXXXXXXXXXXXXXXXXXXXXXXXXXXXXXXXXXXXXXXXXXXXXXXXXXXXXXXXXXXXXXXXXXXXXXXXXXXXXXXXXXXXXXXXXXXXXXXXXXXXXXXXXXXXXXXXXXXXXXXXXXXXXXXXXXXXXXXXXXXXXXXXXXXXXXXXXXXXXXXXXXXXXXXXXXXXXXXX

