--------------------------------------------------------------------------------------------------------------------------------------------------------------------------------------------------------
--------------------------------------------------------------------------------------------------------------------------------------------------------------------------------------------------------
--------------------------------------------------------------------------------------------------------------------------------------------------------------------------------------------------------
--------------------------------------------------------------------------------------------------------------------------------------------------------------------------------------------------------
--------------------------------------------------------------------------------------------------------------------------------------------------------------------------------------------------------
--------------------------------------------------------------------------------------------------------------------------------------------------------------------------------------------------------
--------------------------------------------------------------------------------------------------------------------------------------------------------------------------------------------------------
--------------------------------------------------------------------------------------------------------------------------------------------------------------------------------------------------------
--------------------------------------------------------------------------------------------------------------------------------------------------------------------------------------------------------
--------------------------------------------------------------------------------------------------------------------------------------------------------------------------------------------------------
--------------------------------------------------------------------------------------------------------------------------------------------------------------------------------------------------------
--------------------------------------------------------------------------------------------------------------------------------------------------------------------------------------------------------
--------------------------------------------------------------ooooSo----------------------------------------------------------------oSooooo-------------------------------------------------------------
------------------------------------------------------------------------------------------------ooSoo---------------------------------------------ooooooo-----------------------------------------------
---------------------------------SSoS----------oo-------------ooooo---------------------oSSo----------------------------------------ooooo---------------------Soo----------------------oSooooo----------
--------------oooo-----oSoo------------------------------------------------------oo-----------ooooo------oSoo-----------------Soo-------------------ooooo-------------oooSo-----------------------------
--------------------------------oooo---XXXXXXXXXXX---------XXXXXXXXXXXXXXXXXXXX----------------------------------------------------XXXXXXXXX----------------ooooo-------------------------ooo----ooooo--
--------------ooooo-------ooo------g---XXXXXXXXXXX---------XXXXXXXXXXXXXXXXXXXXXXXXXXXX------XXXXXXXXX---oooo----------------ooo---XXXXXXXXXXXXXXXXXXXXXXXX----g-------oo------XXX----------------------
XXXXXXXXXXXX------------------XXXXXXXXXXXXXXXXXXXX-------XXXXXXXXXXXXXXXXXXXXXXXXXXXXXXXXXXXXXXXXXXXXX-----------------------------XXXXXXXXXXXXXXXXXXXXXXXXXXXXXXXX----------XXXXX----XXXXXXXXXXXXXXXXXX
XXXXXXXXXXXXXXXXXXXXXXXXXXXXXXXXXXXXXXXXXXXXXXXXXXXXXXXXXXXXXXXXXXXXXXXXXXXXXXXXXXXXXXXXXXXXXXXXXXXXXXXXXXXXXXXXXXXXXXXXXXXXXXXXXXXXXXXXXXXXXXXXXXXXXXXXXXXXXXXXXXXXXXXXXXXXXXXXXXXXXXXXXXXXXXXXXXXXXXXX

