--------------------------------------------------------------------------------------------------------------------------------------------------------------------------------------------------------
--------------------------------------------------------------------------------------------------------------------------------------------------------------------------------------------------------
--------------------------------------------------------------------------------------------------------------------------------------------------------------------------------------------------------
--------------------------------------------------------------------------------------------------------------------------------------------------------------------------------------------------------
--------------------------------------------------------------------------------------------------------------------------------------------------------------------------------------------------------
--------------------------------------------------------------------------------------------------------------------------------------------------------------------------------------------------------
--------------------------------------------------------------------------------------------------------------------------------------------------------------------------------------------------------
--------------------------------------------------------------------------------------------------------------------------------------------------------------------------------------------------------
--------------------------------------------------------------------------------------------------------------------------------------------------------------------------------------------------------
--------------------------------------------------------------------------------------------------------------------------------------------------------------------------------------------------------
--------------------------------------------------------------------------------------------------------------------------------------------------------------------------------------------------------
--------------------------------------------------------------------------------------------------------------------------------------------------------------------------------------------------------
-----------------------------------------oooSSo-------------------------------------------------------------------------oooSo---------------------------------------------------------------------------
------------------------------------------------------------------------------------------------------------------------------------------------Soo-----------------------------------------------------
------------------------------oooSS----oooooo-----------------------------------oooo-------------oooo------------------oooooo----------------------------------------ooSSoo--------------oSoooSSo-------
-----------------------ooooo----------g-----------ooo-----oo-----------------------------Soo---------g---------------------------ooooSo--------ooo------------------------------------------------------
---------------ooooo----------oooo---XXXXXXXXXXX-------g-------------ooo------XXXXXXXX----------XXXXXXXXXXXXXXXXXXX--XXXXXXXXX------------------------XXX-ooo---------oooo-------oo------oooooo---------
XXXXXXXXXXXX----------XXXXXXX--------XXXXXXXXXXX------XXXXXXX-----------------XXXXXXXX---ooooo--XXXXXXXXXXXXXXXXXXX--XXXXXXXXXXX--ooo---------XXXXXXXXXXX-------XXXX------------g------------------oooo-
XXXXXXXXXXXXXXXXXXXXXXXXXXXXXXXXXXXXXXXXXXXXXXXX------XXXXXXXXXXXXXXXXXXXXXXXXXXXXXXXX----------XXXXXXXXXXXXXXXXXXX--XXXXXXXXXXX--------------XXXXXXXXXXXXXXXXXXXXXXXXXXXXXXXXXXXXXXXXXXXXXXXXXXXX------
XXXXXXXXXXXXXXXXXXXXXXXXXXXXXXXXXXXXXXXXXXXXXXXXXXXXXXXXXXXXXXXXXXXXXXXXXXXXXXXXXXXXXXXXXXXXXXXXXXXXXXXXXXXXXXXXXXXXXXXXXXXXXXXXXXXXXXXXXXXXXXXXXXXXXXXXXXXXXXXXXXXXXXXXXXXXXXXXXXXXXXXXXXXXXXXXXXXXXXXX

