--------------------------------------------------------------------------------------------------------------------------------------------------------------------------------------------------------
--------------------------------------------------------------------------------------------------------------------------------------------------------------------------------------------------------
--------------------------------------------------------------------------------------------------------------------------------------------------------------------------------------------------------
--------------------------------------------------------------------------------------------------------------------------------------------------------------------------------------------------------
--------------------------------------------------------------------------------------------------------------------------------------------------------------------------------------------------------
--------------------------------------------------------------------------------------------------------------------------------------------------------------------------------------------------------
--------------------------------------------------------------------------------------------------------------------------------------------------------------------------------------------------------
--------------------------------------------------------------------------------------------------------------------------------------------------------------------------------------------------------
--------------------------------------------------------------------------------------------------------------------------------------------------------------------------------------------------------
--------------------------------------------------------------------------------------------------------------------------------------------------------------------------------------------------------
--------------------------------------------------------------------------------------------------------------------------------------------------------------------------------------------------------
--------------------------------------------------------------------------------------------------------------------------------------------------------------------------------------------------------
-------------------------------------------------------------------------------------------------oooSSo-------------------------------------------------------------------------------------------------
---------------------------------------------------oSoooo--------------------------------SoSoS----------------------------------------------------------------------------------------------------------
-----------------oooo---------------SoSoo------------------------------------SSoo----------------oooo-----oSooooSo----------------------oSooo-----------------------------------------------------------
------------------------------------------------------oo----------------------------------ooooo----------------------------------ooo--------------ooo------oooo---------oSo----oooooo----------oo-------
---------------ooooooo---XXXXXXXXX-ooooo-------------------------------------oooo---XXX---------XXXXXXXXX---oooo----------------------------------------------g-------------------------XXXXX-g---------
-------------------------XXXXXXXXX----------XXXXXXXXXXXXXXXX------XXXXXXX-----------XXXXXXXXXXXXXXXXXXXXX--------------XXXXX---XXXXXX----------ooooooo-XXXXXXXXXXXXX--ooooo-----oooooo--XXXXXXXXXXXXXXXX
XXXXXXXXXXXXXXXXXXXXXXXXXXXXXXXXXXXXXXXXXXXXXXXXXXXXXXXXXXXX----g-XXXXXXXXXXXXXXXXXXXXXXXXXXXXXXXXXXXXXXXXXXXXXXXXXXXXXXXXXXXXXXXXXXXXXXXXXXXX---------XXXXXXXXXXXXX--------------------XXXXXXXXXXXXXXXX
XXXXXXXXXXXXXXXXXXXXXXXXXXXXXXXXXXXXXXXXXXXXXXXXXXXXXXXXXXXXXXXXXXXXXXXXXXXXXXXXXXXXXXXXXXXXXXXXXXXXXXXXXXXXXXXXXXXXXXXXXXXXXXXXXXXXXXXXXXXXXXXXXXXXXXXXXXXXXXXXXXXXXXXXXXXXXXXXXXXXXXXXXXXXXXXXXXXXXXXX

