--------------------------------------------------------------------------------------------------------------------------------------------------------------------------------------------------------
--------------------------------------------------------------------------------------------------------------------------------------------------------------------------------------------------------
--------------------------------------------------------------------------------------------------------------------------------------------------------------------------------------------------------
--------------------------------------------------------------------------------------------------------------------------------------------------------------------------------------------------------
--------------------------------------------------------------------------------------------------------------------------------------------------------------------------------------------------------
--------------------------------------------------------------------------------------------------------------------------------------------------------------------------------------------------------
--------------------------------------------------------------------------------------------------------------------------------------------------------------------------------------------------------
--------------------------------------------------------------------------------------------------------------------------------------------------------------------------------------------------------
--------------------------------------------------------------------------------------------------------------------------------------------------------------------------------------------------------
--------------------------------------------------------------------------------------------------------------------------------------------------------------------------------------------------------
--------------------------------------------------------------------------------------------------------------------------------------------------------------------------------------------------------
--------------------------------------------------------------------------------------------------------------------------------------------------------------------------------------------------------
------------------------------------ooo------------------Soo----------------------------------------------------------------------------------------------oooo------------------------------------------
--------------------------------------------------------------------------------------------------------------------------SoS---------------------------------------------------------ooSoSSo-----------
-----------------------------------oo------------------ooooo------------------------------------------------ooooSSo-------------oSSS-----------------------ooooo------Sooo------------------------------
-------------------------------------------oSoooo----------g-------oooo----------SSSS---------------ooSoo--------------oooo---------------------oooooSo-------g----------------oSS-----oooo-------------
-----------------------------XXXXXXXXXXXXX-----------XXXXXXXXXX----------------------------------------------ooooooo------------ooooo--------------------XXXXXXXXX----oo-----------------g--------------
XXXXXXXXXXXX-------ooo-------XXXXXXXXXXXXX----oooo---XXXXXXXXXX------oooo--XXX--oooooo-------------ooooooo------------XXXXXXXXX-----g-----XXXXX-oooooooo-XXXXXXXXX----------ooooo----XXXXXXXXXX---------
XXXXXXXXXXXX-------------XXXXXXXXXXXXXXXXX--------gg-XXXXXXXXXXXXX-----g---XXX--------------XXXXX----------XXXXXXXXXXXXXXXXXXXXXXXXXXXXXXXXXXXX----------XXXXXXXXXXXXXXXXXX----------XXXXXXXXXX----XX---
XXXXXXXXXXXXXXXXXXXXXXXXXXXXXXXXXXXXXXXXXXXXXXXXXXXXXXXXXXXXXXXXXXXXXXXXXXXXXXXXXXXXXXXXXXXXXXXXXXXXXXXXXXXXXXXXXXXXXXXXXXXXXXXXXXXXXXXXXXXXXXXXXXXXXXXXXXXXXXXXXXXXXXXXXXXXXXXXXXXXXXXXXXXXXXXXXXXXXXXX

