--------------------------------------------------------------------------------------------------------------------------------------------------------------------------------------------------------
--------------------------------------------------------------------------------------------------------------------------------------------------------------------------------------------------------
--------------------------------------------------------------------------------------------------------------------------------------------------------------------------------------------------------
--------------------------------------------------------------------------------------------------------------------------------------------------------------------------------------------------------
--------------------------------------------------------------------------------------------------------------------------------------------------------------------------------------------------------
--------------------------------------------------------------------------------------------------------------------------------------------------------------------------------------------------------
--------------------------------------------------------------------------------------------------------------------------------------------------------------------------------------------------------
--------------------------------------------------------------------------------------------------------------------------------------------------------------------------------------------------------
--------------------------------------------------------------------------------------------------------------------------------------------------------------------------------------------------------
--------------------------------------------------------------------------------------------------------------------------------------------------------------------------------------------------------
--------------------------------------------------------------------------------------------------------------------------------------------------------------------------------------------------------
--------------------------------------------------------------------------------------------------------------------------------------------------------------------------------------------------------
------------Soo-----------------------------------------------------oSooSoo-----------------------------------------------------------------------------------------------------------------------------
---------------------oSoo----------------------------------------------------------------------oSSoSo----------ooS---oSoo------------------------------------ooSoSoo----------------------------oSoSo---
-------------oooo----------------------------------------ooooSoSo-----ooooooo--oooooo-------------------ooooo----------------------oooSo-----------ooo--------------------------------------------------
---------------------ooooo-------oo-----------------------------------------------------------oooo--------------------ooo-------------------------------------oooo------------------------------ooooo---
----------XXXXXXXX-----------XXX-----g-XXX--------XXX----ooooooo---XXXXXXXXXXXXXXXXXXXXXXXXX----------XXXXXXXX---------------XX----ooooo----ooo---ooo--XXX------------XXXXX--------------oo-------------
----------XXXXXXXXXXXXXXXXXXXXXXXXXXXXXXXXXX------XXXXXX-----------XXXXXXXXXXXXXXXXXXXXXXXXXXXXXXXXXXXXXXXXXXXXXXXXXXXXXXXXXXXX------------------------XXX--XXXXXXXXXXXXXXXXXX-------g--------XXXXXXXX--
XXXXXXXXXXXXXXXXXXXXXXXXXXXXXXXXXXXXXXXXXXXXXXXXXXXXXXXXXXXXXXXXXXXXXXXXXXXXXXXXXXXXXXXXXXXXXXXXXXXXXXXXXXXXXXXXXXXXXXXXXXXXXXXXXXXXXXXXXXXXXXXXXXXXXXXXXX--XXXXXXXXXXXXXXXXXXXXXXXXXXXXXXXXXXXXXXXXXX--
XXXXXXXXXXXXXXXXXXXXXXXXXXXXXXXXXXXXXXXXXXXXXXXXXXXXXXXXXXXXXXXXXXXXXXXXXXXXXXXXXXXXXXXXXXXXXXXXXXXXXXXXXXXXXXXXXXXXXXXXXXXXXXXXXXXXXXXXXXXXXXXXXXXXXXXXXXXXXXXXXXXXXXXXXXXXXXXXXXXXXXXXXXXXXXXXXXXXXXXX

