--------------------------------------------------------------------------------------------------------------------------------------------------------------------------------------------------------
--------------------------------------------------------------------------------------------------------------------------------------------------------------------------------------------------------
--------------------------------------------------------------------------------------------------------------------------------------------------------------------------------------------------------
--------------------------------------------------------------------------------------------------------------------------------------------------------------------------------------------------------
--------------------------------------------------------------------------------------------------------------------------------------------------------------------------------------------------------
--------------------------------------------------------------------------------------------------------------------------------------------------------------------------------------------------------
--------------------------------------------------------------------------------------------------------------------------------------------------------------------------------------------------------
--------------------------------------------------------------------------------------------------------------------------------------------------------------------------------------------------------
--------------------------------------------------------------------------------------------------------------------------------------------------------------------------------------------------------
--------------------------------------------------------------------------------------------------------------------------------------------------------------------------------------------------------
--------------------------------------------------------------------------------------------------------------------------------------------------------------------------------------------------------
--------------------------------------------------------------------------------------------------------------------------------------------------------------------------------------------------------
-------------------------------------------------------------------------------------------------------------------------------oSo----------------------------------------------------------------------
-------------------oooo----------oSooooS-----------------ooooo---------------------------------oSooSS----------------------------------------------------------oSS--------------------------------------
------------------------------------------------------------------------------------------------------------------oSS-------oooo--------------------oSooo---------------------------ooo-----------------
------------oooS---ooooooo---------oooooo-------oSoo----ooooo------ooooSoo-------------------oooooo-----oooooo-----------------------------------------------ooooo--------------------------------------
----------------------------------------------------------------------------------XXXXX------------------------------------XXXXXXXX----------oooo--ooooo----------------------XX-oooooo----XXX----------
--------------oo--XXXXXXXXX----XXXXXXXXXXX----oooooooo-XXXXXXXXXX--oooooooo-------XXXXX-----XXXXXXXXXXXXXXXXXXXXX--------XXXXXXXXXX--ooo--------------------XXXXXXXXXX--------XX------g----XXXXXXX------
XXXXXXXXXX--------XXXXXXXXXXXXXXXXXXXXXXXXXXX----------XXXXXXXXXX------------g----XXXXX-----XXXXXXXXXXXXXXXXXXXXXXXXXXXXXXXXXXXXXXX-----g-XXXXXXXXXXXXXXXXXXXXXXXXXXXXXXXXXXXXXXXXXXXXXXXXXXXXXXXX------
XXXXXXXXXXXXXXXXXXXXXXXXXXXXXXXXXXXXXXXXXXXXXXXXXXXXXXXXXXXXXXXXXXXXXXXXXXXXXXXXXXXXXXXXXXXXXXXXXXXXXXXXXXXXXXXXXXXXXXXXXXXXXXXXXXXXXXXXXXXXXXXXXXXXXXXXXXXXXXXXXXXXXXXXXXXXXXXXXXXXXXXXXXXXXXXXXXXXXXXX

