--------------------------------------------------------------------------------------------------------------------------------------------------------------------------------------------------------
--------------------------------------------------------------------------------------------------------------------------------------------------------------------------------------------------------
--------------------------------------------------------------------------------------------------------------------------------------------------------------------------------------------------------
--------------------------------------------------------------------------------------------------------------------------------------------------------------------------------------------------------
--------------------------------------------------------------------------------------------------------------------------------------------------------------------------------------------------------
--------------------------------------------------------------------------------------------------------------------------------------------------------------------------------------------------------
--------------------------------------------------------------------------------------------------------------------------------------------------------------------------------------------------------
--------------------------------------------------------------------------------------------------------------------------------------------------------------------------------------------------------
--------------------------------------------------------------------------------------------------------------------------------------------------------------------------------------------------------
--------------------------------------------------------------------------------------------------------------------------------------------------------------------------------------------------------
--------------------------------------------------------------------------------------------------------------------------------------------------------------------------------------------------------
--------------------------------------------------------------------------------------------------------------------------------------------------------------------------------------------------------
----------------------------------------------------------------------------oSo------------------------------------SooSoo---------------------------SSooSo-------------oooooo----ooooSSo----------------
--------------------------------------------------------------------------------------------------ooSoo-------------------------------------------------------------------------------------------------
-----------------oSoSo-----------------------------------------------------oooo--------ooooSSo---------------------oooooo-------------oooo-----------ooo-----oooSoS----ooooooo------oo------------------
-------------------------------------------Soo------oooo-------------ooo--------------------------oooo-------------g------------------g-----------------------------------------------------------------
---------------ooooooooo-----ooo--ooo--------------------g-----XXXXX------XXXXXXXXX------ooooo-------------------XXXXXXXXXXXXXXX-----XXXXXX-------XXXXXXXXX-ooooooo--XXXXXXXXXXXXXXXXXXXXX-------XXXXXXX
----------------------------g--------------ooo----XXXXXXXXXXXXXXXXXX------XXXXXXXXXXX----------XXXXXXXXXXX-------XXXXXXXXXXXXXXXXXXXXXXXXXX-------XXXXXXXXX----------XXXXXXXXXXXXXXXXXXXXX-------XXXXXXX
--------------XXXXXXXXXXXXXXXXXXXXXXXXX--------XXXXXXXXXXXXXXXXXXXXX------XXXXXXXXXXXXXXXXXXXXXXXXXXXXXXXX-------XXXXXXXXXXXXXXXXXXXXXXXXXX----XXXXXXXXXXXXXXXXXXXXXXXXXXXXXXXXXXXXXXXXXXXXXXXXXXXXXXXXX
XXXXXXXXXXXXXXXXXXXXXXXXXXXXXXXXXXXXXXXXXXXXXXXXXXXXXXXXXXXXXXXXXXXXXXXXXXXXXXXXXXXXXXXXXXXXXXXXXXXXXXXXXXXXXXXXXXXXXXXXXXXXXXXXXXXXXXXXXXXXXXXXXXXXXXXXXXXXXXXXXXXXXXXXXXXXXXXXXXXXXXXXXXXXXXXXXXXXXXXX

