--------------------------------------------------------------------------------------------------------------------------------------------------------------------------------------------------------
--------------------------------------------------------------------------------------------------------------------------------------------------------------------------------------------------------
--------------------------------------------------------------------------------------------------------------------------------------------------------------------------------------------------------
--------------------------------------------------------------------------------------------------------------------------------------------------------------------------------------------------------
--------------------------------------------------------------------------------------------------------------------------------------------------------------------------------------------------------
--------------------------------------------------------------------------------------------------------------------------------------------------------------------------------------------------------
--------------------------------------------------------------------------------------------------------------------------------------------------------------------------------------------------------
--------------------------------------------------------------------------------------------------------------------------------------------------------------------------------------------------------
--------------------------------------------------------------------------------------------------------------------------------------------------------------------------------------------------------
--------------------------------------------------------------------------------------------------------------------------------------------------------------------------------------------------------
--------------------------------------------------------------------------------------------------------------------------------------------------------------------------------------------------------
--------------------------------------------------------------------------------------------------------------------------------------------------------------------------------------------------------
-----------------------SSo------------------oooSSo-----------------------oooSoooo---ooooSoo-------------------------------------------------------------------------------------------------------------
-----------------------------oooSSo---------------------------------------------------------------------------------------------------------------------------------------------------------------------
---------------ooo-----oooo-------------------oo---------------------------oooooo--oooooooo--oSooSo----------------------------------------------------------ooo------oSooo--------------Soo------------
-------------------------------ooo------------------------------------------------------------------------------ooo---------------------------------oSooo-----------------------------------------------
--------------XXXXXXXXXXXXXX---------------XXXXXXXX--------------------XXXXXXXXXXXXXXXXXXXXX----ooo---------------------XXXXXXXXX----------------------------oo-------ooo--------------ooo----XXXXXX----
XXXXXXXXXXXXXXXXXXXXXXXXXXXXXXXXXXXX--XXXXXXXXXXXXX--------------------XXXXXXXXXXXXXXXXXXXXX-----------------oooooo--XXXXXXXXXXXXXXX------XXXXX-------oo-------------g------XXXXXXXX----------XXXXXX----
XXXXXXXXXXXXXXXXXXXXXXXXXXXXXXXXXXXXXXXXXXXXXXXXXXX-----XXXXXXXXXX-----XXXXXXXXXXXXXXXXXXXXXXXXXXXXXXXX--------------XXXXXXXXXXXXXXX--g---XXXXXXXXX---------XXXXXXXXXXXXXXXXXXXXXXXXXXXXXXXXXXXXXXXX----
XXXXXXXXXXXXXXXXXXXXXXXXXXXXXXXXXXXXXXXXXXXXXXXXXXXXXXXXXXXXXXXXXXXXXXXXXXXXXXXXXXXXXXXXXXXXXXXXXXXXXXXXXXXXXXXXXXXXXXXXXXXXXXXXXXXXXXXXXXXXXXXXXXXXXXXXXXXXXXXXXXXXXXXXXXXXXXXXXXXXXXXXXXXXXXXXXXXXXXXX

