--------------------------------------------------------------------------------------------------------------------------------------------------------------------------------------------------------
--------------------------------------------------------------------------------------------------------------------------------------------------------------------------------------------------------
--------------------------------------------------------------------------------------------------------------------------------------------------------------------------------------------------------
--------------------------------------------------------------------------------------------------------------------------------------------------------------------------------------------------------
--------------------------------------------------------------------------------------------------------------------------------------------------------------------------------------------------------
--------------------------------------------------------------------------------------------------------------------------------------------------------------------------------------------------------
--------------------------------------------------------------------------------------------------------------------------------------------------------------------------------------------------------
--------------------------------------------------------------------------------------------------------------------------------------------------------------------------------------------------------
--------------------------------------------------------------------------------------------------------------------------------------------------------------------------------------------------------
--------------------------------------------------------------------------------------------------------------------------------------------------------------------------------------------------------
--------------------------------------------------------------------------------------------------------------------------------------------------------------------------------------------------------
--------------------------------------------------------------------------------------------------------------------------------------------------------------------------------------------------------
--------------------oSoo--------oSoSo-----------------------------------------------------------------------------oooooS--------------oSoS--------------------------------------------------------------
-----------------------------------------------------ooSSo----------------------------------ooSooo---------------------------------------------------oSoo-----------------------------------------------
-------------------oo-------------oo---ooo-------------------------------oooo-----------------------------SoSoSo----ooooo---------------ooooo--oSo------------------------------------ooSooo------oSooo-
------------------------------------------------------------------------------------oooooo---oooooo-------------------------oSoSSS----------------------------------------------------------------------
XXXXXXXXXXXXXXXXXXXXXXXXX-----XXXXXXXXXXXXXX-----------------ooooo----XX----ooo-------------------------ooooo----XXXXXXXXX-----------XXXXXXXXX-oooo-------------------ooo----------------ooo-----ooooo--
XXXXXXXXXXXXXXXXXXXXXXXXXXXXXXXXXXXXXXXXXXXXXXXX--XXXXXXXXX-----------XX------------oooo---XXXXXXXXXXX-----------XXXXXXXXX---oooo----XXXXXXXXX------XXXXXXX----------------XXXXX------------------------
XXXXXXXXXXXXXXXXXXXXXXXXXXXXXXXXXXXXXXXXXXXXXXXX--XXXXXXXXXXXXXXXXXXXXXXXXXXXXXXXXX---g----XXXXXXXXXXXXXXXXXXXXXXXXXXXXXXX-----------XXXXXXXXXXXXXXXXXXXXXX-----XXXXXXXXXXXXXXXX-----XXXXXXXXXXXXXXXXXXX
XXXXXXXXXXXXXXXXXXXXXXXXXXXXXXXXXXXXXXXXXXXXXXXXXXXXXXXXXXXXXXXXXXXXXXXXXXXXXXXXXXXXXXXXXXXXXXXXXXXXXXXXXXXXXXXXXXXXXXXXXXXXXXXXXXXXXXXXXXXXXXXXXXXXXXXXXXXXXXXXXXXXXXXXXXXXXXXXXXXXXXXXXXXXXXXXXXXXXXXX

