--------------------------------------------------------------------------------------------------------------------------------------------------------------------------------------------------------
--------------------------------------------------------------------------------------------------------------------------------------------------------------------------------------------------------
--------------------------------------------------------------------------------------------------------------------------------------------------------------------------------------------------------
--------------------------------------------------------------------------------------------------------------------------------------------------------------------------------------------------------
--------------------------------------------------------------------------------------------------------------------------------------------------------------------------------------------------------
--------------------------------------------------------------------------------------------------------------------------------------------------------------------------------------------------------
--------------------------------------------------------------------------------------------------------------------------------------------------------------------------------------------------------
--------------------------------------------------------------------------------------------------------------------------------------------------------------------------------------------------------
--------------------------------------------------------------------------------------------------------------------------------------------------------------------------------------------------------
--------------------------------------------------------------------------------------------------------------------------------------------------------------------------------------------------------
--------------------------------------------------------------------------------------------------------------------------------------------------------------------------------------------------------
--------------------------------------------------------------------------------------------------------------------------------------------------------------------------------------------------------
----------------------oooS--------------------------------------------SoSo------------------------------------------------------------------oooooSoo-------------------ooSooo---------------------------
----------------------------------------------------------ooooooooo-------------------------------------------------------------------------------------------------------------------------------------
-----------------------ooooo---oSo-----------------------------------oooooo-------------oo----------------------------------------------------ooooo----oooSo-------------oooooo------------------oSSo---
----------------------------------------Sooo--g-----oSo-----oooooo-------------oo-----------------Sooo---ooSoSo----------------------oSoo---------------------------------------------------------------
---------------------XXXXXXXXX---------------XXXXXX--------------g--XXXXXXXXXX---------XXXXXXX-------------------XXXX---------------------XXXXXXXXXXX---oo------------XXXXXXXXXX---oooo--------oooooooo-
--------------XXX----XXXXXXXXX-----------ooo-XXXXXX-oooo-XXXXXXXXXXXXXXXXXXXXXXXXXXXX--XXXXXXX--oooo--------oo---XXXX---oooo--XXXXX-------XXXXXXXXXXX-----------XXXXXXXXXXXXXXXX----------XXX-----g-----
XXXXXXXXXXXXXXXXXXX--XXXXXXXXXXXXXXXX--------XXXXXX------XXXXXXXXXXXXXXXXXXXXXXXXXXXXXXXXXXXXX------g------------XXXX---------XXXXX-gg----XXXXXXXXXXXXXXXXXXXX--XXXXXXXXXXXXXXXXXXXXXXXXXXXXXXXXXXXXXXXX
XXXXXXXXXXXXXXXXXXXXXXXXXXXXXXXXXXXXXXXXXXXXXXXXXXXXXXXXXXXXXXXXXXXXXXXXXXXXXXXXXXXXXXXXXXXXXXXXXXXXXXXXXXXXXXXXXXXXXXXXXXXXXXXXXXXXXXXXXXXXXXXXXXXXXXXXXXXXXXXXXXXXXXXXXXXXXXXXXXXXXXXXXXXXXXXXXXXXXXXX

