--------------------------------------------------------------------------------------------------------------------------------------------------------------------------------------------------------
--------------------------------------------------------------------------------------------------------------------------------------------------------------------------------------------------------
--------------------------------------------------------------------------------------------------------------------------------------------------------------------------------------------------------
--------------------------------------------------------------------------------------------------------------------------------------------------------------------------------------------------------
--------------------------------------------------------------------------------------------------------------------------------------------------------------------------------------------------------
--------------------------------------------------------------------------------------------------------------------------------------------------------------------------------------------------------
--------------------------------------------------------------------------------------------------------------------------------------------------------------------------------------------------------
--------------------------------------------------------------------------------------------------------------------------------------------------------------------------------------------------------
--------------------------------------------------------------------------------------------------------------------------------------------------------------------------------------------------------
--------------------------------------------------------------------------------------------------------------------------------------------------------------------------------------------------------
--------------------------------------------------------------------------------------------------------------------------------------------------------------------------------------------------------
--------------------------------------------------------------------------------------------------------------------------------------------------------------------------------------------------------
-------------------------oooooo----------oSoooo---------------------------------------------------------------------ooS-------------------------oooSoo--------------------------------------------------
-----------------------------------------------------------------------------------------oooo---------------oSo--------------ooo------------------------------------------------------------------------
--------------------------ooooo-----------ooooooo---oSoooo---------------------oooo-------------------------------ooooooo-------------oSoSooS-----ooo---------------------------------------------------
------------------ooS---------------------g-g------------------------------------------ooooooo---------------oo-------------ooo-------------------------------------------------------------------------
-----------XXX----------XXXXXXXXXX----XXXXXXXXXXXXX----oo---------------XXXXXXXXXXXXXX---g--g----XXXXXXXX-------XXXXXXXXXX---------------ooooo-XXXXXXXX----------------------------------------XXXXXXXXX
-----------XXX----ooooo-XXXXXXXXXXXXXXXXXXXXXXXXXXX---g---------XXXXXX--XXXXXXXXXXXXXXXXXXXXXXX--XXXXXXXXXXXXXXXXXXXXXXXXXXXXXXXXX-------------XXXXXXXX---------ooo-----ooo-------------oooo---XXXXXXXXX
-----------XXX----------XXXXXXXXXXXXXXXXXXXXXXXXXXXXXXXXXXXXXXXXXXXXXX--XXXXXXXXXXXXXXXXXXXXXXXXXXXXXXXXXXXXXXXXXXXXXXXXXXXXXXXXXX---XXXXXXXXXXXXXXXXXX--------------------------XXXXXX--------XXXXXXXXX
XXXXXXXXXXXXXXXXXXXXXXXXXXXXXXXXXXXXXXXXXXXXXXXXXXXXXXXXXXXXXXXXXXXXXXXXXXXXXXXXXXXXXXXXXXXXXXXXXXXXXXXXXXXXXXXXXXXXXXXXXXXXXXXXXXXXXXXXXXXXXXXXXXXXXXXXXXXXXXXXXXXXXXXXXXXXXXXXXXXXXXXXXXXXXXXXXXXXXXXX

