--------------------------------------------------------------------------------------------------------------------------------------------------------------------------------------------------------
--------------------------------------------------------------------------------------------------------------------------------------------------------------------------------------------------------
--------------------------------------------------------------------------------------------------------------------------------------------------------------------------------------------------------
--------------------------------------------------------------------------------------------------------------------------------------------------------------------------------------------------------
--------------------------------------------------------------------------------------------------------------------------------------------------------------------------------------------------------
--------------------------------------------------------------------------------------------------------------------------------------------------------------------------------------------------------
--------------------------------------------------------------------------------------------------------------------------------------------------------------------------------------------------------
--------------------------------------------------------------------------------------------------------------------------------------------------------------------------------------------------------
--------------------------------------------------------------------------------------------------------------------------------------------------------------------------------------------------------
--------------------------------------------------------------------------------------------------------------------------------------------------------------------------------------------------------
--------------------------------------------------------------------------------------------------------------------------------------------------------------------------------------------------------
--------------------------------------------------------------------------------------------------------------------------------------------------------------------------------------------------------
---------------------------------------------------------------------oSooooSoo----------------ooSooo-------------oSSoooo----------------------------------------------ooooSo----------------------------
------------oSooSoo------------oSoS-----------Soo-------------------------------------------------------------------------------------------oSooooo-----------------------------------------------------
---------------------------------------------------------------------ooooooo--------------------oooo--------------ooo--------------------------------------------------ooo------------------------------
-----------ooooooooo------------oo---------ooo----------ooo---------------------ooSo-----------------------------------g------------oSSSoo---oooo----oooooo---------------------------------------------
XXXXXXXXXX----------------------------------------------------------XXXXXXXXXXX--------------XXXXXXXXXXXXXX---XXXXXXXXXXX-------------------g-----------------------XXXXXXXXX---------------------------
XXXXXXXXXXXXXXXXXXXXX-----XXXXXXXXXXXX----XXXXXXXXXX---oooooo-------XXXXXXXXXXX----oo--------XXXXXXXXXXXXXX---XXXXXXXXXXXXXXXX-----oooooo--XXXXXXXXXXXXXXXXX--------XXXXXXXXXXXXXXX--ooo-XXXXXX---------
XXXXXXXXXXXXXXXXXXXXX-----XXXXXXXXXXXXXXXXXXXXXXXXXX----------XXXX--XXXXXXXXXXX--------------XXXXXXXXXXXXXXXXXXXXXXXXXXXXXXXXXXXXX-----g---XXXXXXXXXXXXXXXXXXXXXX---XXXXXXXXXXXXXXX------XXXXXX----g----
XXXXXXXXXXXXXXXXXXXXXXXXXXXXXXXXXXXXXXXXXXXXXXXXXXXXXXXXXXXXXXXXXXXXXXXXXXXXXXXXXXXXXXXXXXXXXXXXXXXXXXXXXXXXXXXXXXXXXXXXXXXXXXXXXXXXXXXXXXXXXXXXXXXXXXXXXXXXXXXXXXXXXXXXXXXXXXXXXXXXXXXXXXXXXXXXXXXXXXXX

