--------------------------------------------------------------------------------------------------------------------------------------------------------------------------------------------------------
--------------------------------------------------------------------------------------------------------------------------------------------------------------------------------------------------------
--------------------------------------------------------------------------------------------------------------------------------------------------------------------------------------------------------
--------------------------------------------------------------------------------------------------------------------------------------------------------------------------------------------------------
--------------------------------------------------------------------------------------------------------------------------------------------------------------------------------------------------------
--------------------------------------------------------------------------------------------------------------------------------------------------------------------------------------------------------
--------------------------------------------------------------------------------------------------------------------------------------------------------------------------------------------------------
--------------------------------------------------------------------------------------------------------------------------------------------------------------------------------------------------------
--------------------------------------------------------------------------------------------------------------------------------------------------------------------------------------------------------
--------------------------------------------------------------------------------------------------------------------------------------------------------------------------------------------------------
--------------------------------------------------------------------------------------------------------------------------------------------------------------------------------------------------------
--------------------------------------------------------------------------------------------------------------------------------------------------------------------------------------------------------
---------------------Soo-----------------------------------------------------oSSoSoo------------------------------------------------------oSo-----------oSooSS-----------------oooSoSo------------------
--------------------------------------------------ooSSoSS----oSoooSS---------------------------------------------------------------------------------------------------------------------SSo------------
---------------------oooo-------ooooo------------------------------------------ooo---------------------------------------------------------ooo--ooooo----oooooo---------------ooooooo-------------------
--------------------------------------------------ooooooo-----oooooo--------------------------Soooo------------------oooo-------ooooo------------------g--------------------------------ooo------oSo----
XXXXXXXXXXXXXX-----XXXXXXXXX------oo-----XX--------------------------------XXXXXXXXXX-------------------------------------XXXX-----------XXXXXX-------XXXXXXXXXXX-------XXXXXXXXXXXXXXX-----------------
XXXXXXXXXXXXXXXX---XXXXXXXXX-----------XXXX------XXXXXXXXXXXXXXXXXXXXX-----XXXXXXXXXXXXXXX------oo----XXXXXXXXXXX--ooooo--XXXX--oooooooo-XXXXXX-------XXXXXXXXXXX-------XXXXXXXXXXXXXXXXXXXXXXX----ooo--
XXXXXXXXXXXXXXXX---XXXXXXXXXXXXXXXXXXXXXXXXXXXXXXXXXXXXXXXXXXXXXXXXXXXXXXXXXXXXXXXXXXXXXXXXX---g------XXXXXXXXXXX---------XXXX-----------XXXXXXXXXXXXXXXXXXXXXXXXXXXXXXXXXXXXXXXXXXXXXXXXXXXXXX---------
XXXXXXXXXXXXXXXXXXXXXXXXXXXXXXXXXXXXXXXXXXXXXXXXXXXXXXXXXXXXXXXXXXXXXXXXXXXXXXXXXXXXXXXXXXXXXXXXXXXXXXXXXXXXXXXXXXXXXXXXXXXXXXXXXXXXXXXXXXXXXXXXXXXXXXXXXXXXXXXXXXXXXXXXXXXXXXXXXXXXXXXXXXXXXXXXXXXXXXXX

