--------------------------------------------------------------------------------------------------------------------------------------------------------------------------------------------------------
--------------------------------------------------------------------------------------------------------------------------------------------------------------------------------------------------------
--------------------------------------------------------------------------------------------------------------------------------------------------------------------------------------------------------
--------------------------------------------------------------------------------------------------------------------------------------------------------------------------------------------------------
--------------------------------------------------------------------------------------------------------------------------------------------------------------------------------------------------------
--------------------------------------------------------------------------------------------------------------------------------------------------------------------------------------------------------
--------------------------------------------------------------------------------------------------------------------------------------------------------------------------------------------------------
--------------------------------------------------------------------------------------------------------------------------------------------------------------------------------------------------------
--------------------------------------------------------------------------------------------------------------------------------------------------------------------------------------------------------
--------------------------------------------------------------------------------------------------------------------------------------------------------------------------------------------------------
--------------------------------------------------------------------------------------------------------------------------------------------------------------------------------------------------------
--------------------------------------------------------------------------------------------------------------------------------------------------------------------------------------------------------
------------------------------------------------------ooo----------------------------ooSooo-----------------------------------------------------------------------------oooooooo------------------------
---------------------------------------------------------------------------------------------oSo---------------------------------------SSo--------------------------------------------------SoooSoo-----
--------------------oooooSSo----------------oooo------ooooo-----------------oSo------oooo-------------------------------------------------------ooo----oSoo--------------ooooo--------------------------
-------------oSo---------------------------------------------------------------------------------------------------------------------ooo------------------------------------------------------ooooo-----
XXXXXXXXXX-------------oooo----------------oooo---XXXXXXXXXXXXXXXXXX-oo------ooo--XXXXXXXXXX-g------------------------------XXXXXXX-----------XXXXXX--oooo-------oo----XXXXXXXXXXX----------------------
XXXXXXXXXX----ooo-------------XX----ooo---------g-XXXXXXXXXXXXXXXXXX--------------XXXXXXXXXXXXXXXX----XXXX--------ooo-------XXXXXXXXXXXXXXX---XXXXXX--g----g-----------XXXXXXXXXXX---XXXXXXXXXXXXXXXX---
XXXXXXXXXX---------XXXXXXXXXXXXX--------XXXXXXXXXXXXXXXXXXXXXXXXXXXXXXXXXXXXXXXXXXXXXXXXXXXXXXXXXX----XXXX-------------XXXXXXXXXXXXXXXXXXXXXXXXXXXXXXXXXXXXXXXXXXXXXXXXXXXXXXXXXXX---XXXXXXXXXXXXXXXX---
XXXXXXXXXXXXXXXXXXXXXXXXXXXXXXXXXXXXXXXXXXXXXXXXXXXXXXXXXXXXXXXXXXXXXXXXXXXXXXXXXXXXXXXXXXXXXXXXXXXXXXXXXXXXXXXXXXXXXXXXXXXXXXXXXXXXXXXXXXXXXXXXXXXXXXXXXXXXXXXXXXXXXXXXXXXXXXXXXXXXXXXXXXXXXXXXXXXXXXXX

