--------------------------------------------------------------------------------------------------------------------------------------------------------------------------------------------------------
--------------------------------------------------------------------------------------------------------------------------------------------------------------------------------------------------------
--------------------------------------------------------------------------------------------------------------------------------------------------------------------------------------------------------
--------------------------------------------------------------------------------------------------------------------------------------------------------------------------------------------------------
--------------------------------------------------------------------------------------------------------------------------------------------------------------------------------------------------------
--------------------------------------------------------------------------------------------------------------------------------------------------------------------------------------------------------
--------------------------------------------------------------------------------------------------------------------------------------------------------------------------------------------------------
--------------------------------------------------------------------------------------------------------------------------------------------------------------------------------------------------------
--------------------------------------------------------------------------------------------------------------------------------------------------------------------------------------------------------
--------------------------------------------------------------------------------------------------------------------------------------------------------------------------------------------------------
--------------------------------------------------------------------------------------------------------------------------------------------------------------------------------------------------------
--------------------------------------------------------------------------------------------------------------------------------------------------------------------------------------------------------
----------------------------------------ooooo----------------------------------------------------------------------------------------------------------------ooSS--------ooooSoo------------------------
-----------------------oSooSSo-----------------oSSoSoo--------------------------------------------------------------------oooSo---------------------------------------------------------------oSSoS-----
-------------SSo--------------------------oo------------------------------------------oooooo------------------ooooo--------------------------------------------oo--------ooooo--------------------------
-------------------------ooo-------------------ooooooo----------oo----------------------------------ooooSo----------------oooo--------------------------------------------------------SSo-------oooooo--
-----------------XXXX-------g---------XXXXXXXX-----------------------------XXXXX-----oooo----XXXXXX----------XXXXXXXXX--------------------------------------XXXXXXXX----XXXXXXXXXX----------------------
XXXXXXXXXX-------XXXXXXXXXXXXXXXXX----XXXXXXXXXXXXXXXXXXXXX----XXXXXX------XXXXX-------------XXXXXX--ooooooo-XXXXXXXXXXXXXXXXXXX---------g---XX-------------XXXXXXXX----XXXXXXXXXXXX--------XXXXXXXXXXX-
XXXXXXXXXXXXXXXXXXXXXXXXXXXXXXXXXX----XXXXXXXXXXXXXXXXXXXXX----XXXXXX------XXXXX----XXXXXXXXXXXXXXX----------XXXXXXXXXXXXXXXXXXXXXXXXXXXXXXXXXXXXXX------XXXXXXXXXXX----XXXXXXXXXXXX--------XXXXXXXXXXX-
XXXXXXXXXXXXXXXXXXXXXXXXXXXXXXXXXXXXXXXXXXXXXXXXXXXXXXXXXXXXXXXXXXXXXXXXXXXXXXXXXXXXXXXXXXXXXXXXXXXXXXXXXXXXXXXXXXXXXXXXXXXXXXXXXXXXXXXXXXXXXXXXXXXXXXXXXXXXXXXXXXXXXXXXXXXXXXXXXXXXXXXXXXXXXXXXXXXXXXXX

