--------------------------------------------------------------------------------------------------------------------------------------------------------------------------------------------------------
--------------------------------------------------------------------------------------------------------------------------------------------------------------------------------------------------------
--------------------------------------------------------------------------------------------------------------------------------------------------------------------------------------------------------
--------------------------------------------------------------------------------------------------------------------------------------------------------------------------------------------------------
--------------------------------------------------------------------------------------------------------------------------------------------------------------------------------------------------------
--------------------------------------------------------------------------------------------------------------------------------------------------------------------------------------------------------
--------------------------------------------------------------------------------------------------------------------------------------------------------------------------------------------------------
--------------------------------------------------------------------------------------------------------------------------------------------------------------------------------------------------------
--------------------------------------------------------------------------------------------------------------------------------------------------------------------------------------------------------
--------------------------------------------------------------------------------------------------------------------------------------------------------------------------------------------------------
--------------------------------------------------------------------------------------------------------------------------------------------------------------------------------------------------------
--------------------------------------------------------------------------------------------------------------------------------------------------------------------------------------------------------
------------------------------------SoS--------------------------------------------------------------ooSSo----------------------------oooSo----------------------------------------------oooo-----------
------------------------oooooooo------------oSSo------------ooSoSo------------------oooo------ooo-------------------oSo---------------------------------------------------------------------------------
--------------------------------------ooo-------------oSo------------------------------------------oooo---------------------------------oooo------------------------------------------oooo--------------
------------------------oooooo--------------ooo--------------oooo---------------------oo-----oooo------------------oooo--------------g-------g-----oSSooo---oSSooooo------------------------------------
XXXXXXXXXXXXXXXX---------g--------XXXXXXXX--g-----------------------------------------g-----------XXXXXXXXX---------------XXX-------XXXXXXXXXXX----------------------------XXXXXX----XXXXXXXXXXXXX------
XXXXXXXXXXXXXXXX-------XXXXXXXXXXXXXXXXXXXXXXXXXXXX-------XXXXXXXXXX---ooo---ooo--XXXXXXXXXXXXXXXXXXXXXXXXX-------XXXXXXXXXXX-------XXXXXXXXXXXXXX---ooo----ooooooo--XXXXXXXXXXXX----XXXXXXXXXXXXX------
XXXXXXXXXXXXXXXXXXXXX--XXXXXXXXXXXXXXXXXXXXXXXXXXXXXXXXXXXXXXXXXXXXX--------------XXXXXXXXXXXXXXXXXXXXXXXXXXXXXXXXXXXXXXXXXXX-------XXXXXXXXXXXXXX-------------------XXXXXXXXXXXX----XXXXXXXXXXXXX--g---
XXXXXXXXXXXXXXXXXXXXXXXXXXXXXXXXXXXXXXXXXXXXXXXXXXXXXXXXXXXXXXXXXXXXXXXXXXXXXXXXXXXXXXXXXXXXXXXXXXXXXXXXXXXXXXXXXXXXXXXXXXXXXXXXXXXXXXXXXXXXXXXXXXXXXXXXXXXXXXXXXXXXXXXXXXXXXXXXXXXXXXXXXXXXXXXXXXXXXXXX

