--------------------------------------------------------------------------------------------------------------------------------------------------------------------------------------------------------
--------------------------------------------------------------------------------------------------------------------------------------------------------------------------------------------------------
--------------------------------------------------------------------------------------------------------------------------------------------------------------------------------------------------------
--------------------------------------------------------------------------------------------------------------------------------------------------------------------------------------------------------
--------------------------------------------------------------------------------------------------------------------------------------------------------------------------------------------------------
--------------------------------------------------------------------------------------------------------------------------------------------------------------------------------------------------------
--------------------------------------------------------------------------------------------------------------------------------------------------------------------------------------------------------
--------------------------------------------------------------------------------------------------------------------------------------------------------------------------------------------------------
--------------------------------------------------------------------------------------------------------------------------------------------------------------------------------------------------------
--------------------------------------------------------------------------------------------------------------------------------------------------------------------------------------------------------
--------------------------------------------------------------------------------------------------------------------------------------------------------------------------------------------------------
--------------------------------------------------------------------------------------------------------------------------------------------------------------------------------------------------------
-------------------------------------------------------------------------ooSSooo-------------------------------------------------------------------------------ooSooSo----------------------------------
---------------------------------------------------Sooo---------------------------------------------------------------%%%-------------------------------------------------------------------------------
-------------------------------------------------------------oooS--------oooooooo-------------------------------------|||----------------SooSS--------------------oo------------------------------------
---------------------------------------ooooooo--oooooo----------------------------------------------------------------|||-------------------------------ooSoo-------------------------------------------
---------------oo--------XXX-------------------------------oooo--------XXXXXXXXXXX------------XXXXX--oo-------ooooo---|||--------------oooooo----XXXXX--------XXXXXXXXXX--------------------------------
XXXXXXXXXXXXXX-----------XXX------XX--XXXXXXXXXXXXXXXXXXX--------------XXXXXXXXXXXXXXXX-------XXXXX-----------------XXXXXXXXXXXXXXXXXX---------g-XXXXX---oooo-XXXXXXXXXX--ooo-XXXX-----XXXXX-------XXX--
XXXXXXXXXXXXXXXXXXXXXXXXXXXXXXXXXXXXXXXXXXXXXXXXXXXXXXXXXXXXXXXXXXXXXXXXXXXXXXXXXXXXXXX-------XXXXXXXXXXXX---XXXXXXXXXXXXXXXXXXXXXXXXXXXXXXXXXXXXXXXXX--------XXXXXXXXXX------XXXXXXXXXXXXXX-------XXXXX
XXXXXXXXXXXXXXXXXXXXXXXXXXXXXXXXXXXXXXXXXXXXXXXXXXXXXXXXXXXXXXXXXXXXXXXXXXXXXXXXXXXXXXXXXXXXXXXXXXXXXXXXXXXXXXXXXXXXXXXXXXXXXXXXXXXXXXXXXXXXXXXXXXXXXXXXXXXXXXXXXXXXXXXXXXXXXXXXXXXXXXXXXXXXXXXXXXXXXXXX

