--------------------------------------------------------------------------------------------------------------------------------------------------------------------------------------------------------
--------------------------------------------------------------------------------------------------------------------------------------------------------------------------------------------------------
--------------------------------------------------------------------------------------------------------------------------------------------------------------------------------------------------------
--------------------------------------------------------------------------------------------------------------------------------------------------------------------------------------------------------
--------------------------------------------------------------------------------------------------------------------------------------------------------------------------------------------------------
--------------------------------------------------------------------------------------------------------------------------------------------------------------------------------------------------------
--------------------------------------------------------------------------------------------------------------------------------------------------------------------------------------------------------
--------------------------------------------------------------------------------------------------------------------------------------------------------------------------------------------------------
--------------------------------------------------------------------------------------------------------------------------------------------------------------------------------------------------------
--------------------------------------------------------------------------------------------------------------------------------------------------------------------------------------------------------
--------------------------------------------------------------------------------------------------------------------------------------------------------------------------------------------------------
--------------------------------------------------------------------------------------------------------------------------------------------------------------------------------------------------------
------------------oooo--------------------------oSSS------------------------------------------oSooo-------------------------------------------------------------------------------oooSS-----------------
-----------------------------------------------------------------------------------Soo------------------------Soo-------------oSo----------------------------------------------------------ooSoooooo----
----------------------------------------------oooo-------------------------oSo-----------------oooo----------------------------------------oSoS--------ooooSSSSo-------------------oooo-----------------
-------------------------------------------------------------oooo-------------------------------------------ooooooo--------g--oooo--------------------------------oo--------------------------ooo-------
---------------XXXXXXXXXX----XXX------------XXXXXXXXXX-------------XXX-----ooo--------------XXXXXXXX-------------------XXXXXX-----g--XXXX-oooooo---XXX----oooooo---------oooo--XXXXXXXXXXX--------------
XXXXXXXXXXX----XXXXXXXXXXXXXXXXX------oooo--XXXXXXXXXX-----XXXXXXXXXXX---------XXXXXXXX-----XXXXXXXXXXXXXXXXXXXXXXXX---XXXXXXXXXXXXXXXXXX----------XXX-----------XXXXXXX-------XXXXXXXXXXXXXXXXXXXXXX---
XXXXXXXXXXX----XXXXXXXXXXXXXXXXXXXXXX-------XXXXXXXXXX-----XXXXXXXXXXX---XXXXXXXXXXXXXXXXXXXXXXXXXXXXXXXXXXXXXXXXXXX---XXXXXXXXXXXXXXXXXXXXXXXXXXXXXXXXXXXXXXXXXXXXXXXXXXXXXXXXXXXXXXXXXXXXXXXXXXXXXX---
XXXXXXXXXXXXXXXXXXXXXXXXXXXXXXXXXXXXXXXXXXXXXXXXXXXXXXXXXXXXXXXXXXXXXXXXXXXXXXXXXXXXXXXXXXXXXXXXXXXXXXXXXXXXXXXXXXXXXXXXXXXXXXXXXXXXXXXXXXXXXXXXXXXXXXXXXXXXXXXXXXXXXXXXXXXXXXXXXXXXXXXXXXXXXXXXXXXXXXXX

