--------------------------------------------------------------------------------------------------------------------------------------------------------------------------------------------------------
--------------------------------------------------------------------------------------------------------------------------------------------------------------------------------------------------------
--------------------------------------------------------------------------------------------------------------------------------------------------------------------------------------------------------
--------------------------------------------------------------------------------------------------------------------------------------------------------------------------------------------------------
--------------------------------------------------------------------------------------------------------------------------------------------------------------------------------------------------------
--------------------------------------------------------------------------------------------------------------------------------------------------------------------------------------------------------
--------------------------------------------------------------------------------------------------------------------------------------------------------------------------------------------------------
--------------------------------------------------------------------------------------------------------------------------------------------------------------------------------------------------------
--------------------------------------------------------------------------------------------------------------------------------------------------------------------------------------------------------
--------------------------------------------------------------------------------------------------------------------------------------------------------------------------------------------------------
--------------------------------------------------------------------------------------------------------------------------------------------------------------------------------------------------------
--------------------------------------------------------------------------------------------------------------------------------------------------------------------------------------------------------
----------------------------------------------------------------------------------------------------------------------------ooo-------------------------------------------------------------------------
--------------------------------------------------------------------------------------------------------------------------------------------------oooooSo-----------------------------------------------
------------------------------------------ooo-----------------------------------------------------------oSooo-----------------------------ooSSSo-------------oooooo-------------------------------------
-------------oSo---------oSoSS------Soo------------SoSo-----------------------oooSS-------------SoooS------------------------------------------------oooo-----------------------oooo--------------------
------------------------------------------ooo-------------XXXX---------------------------oo---------------ooooo--XXXX----XXXXXXXXXXXXXXX-oooo-------g--g----XXXXXXXX-----------------XXX----------------
-------------oooo--------ooooo-------------------oooooooo-XXXX------------XX---ooooo-----------ooooooo-----------XXXX----XXXXXXXXXXXXXXX---------XXXXXXXXXXXXXXXXXXXXXXXXXX------oo--XXXXXXXXXXXX-------
XXXXXXXXXXX---------XX------------------XXXXXXXX----------XXXXXXXXXXXXXXXXXX-----------XXXXXX----------XXXXXXXXXXXXXXXXXXXXXXXXXXXXXXXXXXXXXXXXXXXXXXXXXXXXXXXXXXXXXXXXXXXXXXXX------XXXXXXXXXXXXXXXXXXX
XXXXXXXXXXXXXXXXXXXXXXXXXXXXXXXXXXXXXXXXXXXXXXXXXXXXXXXXXXXXXXXXXXXXXXXXXXXXXXXXXXXXXXXXXXXXXXXXXXXXXXXXXXXXXXXXXXXXXXXXXXXXXXXXXXXXXXXXXXXXXXXXXXXXXXXXXXXXXXXXXXXXXXXXXXXXXXXXXXXXXXXXXXXXXXXXXXXXXXXX

