--------------------------------------------------------------------------------------------------------------------------------------------------------------------------------------------------------
--------------------------------------------------------------------------------------------------------------------------------------------------------------------------------------------------------
--------------------------------------------------------------------------------------------------------------------------------------------------------------------------------------------------------
--------------------------------------------------------------------------------------------------------------------------------------------------------------------------------------------------------
--------------------------------------------------------------------------------------------------------------------------------------------------------------------------------------------------------
--------------------------------------------------------------------------------------------------------------------------------------------------------------------------------------------------------
--------------------------------------------------------------------------------------------------------------------------------------------------------------------------------------------------------
--------------------------------------------------------------------------------------------------------------------------------------------------------------------------------------------------------
--------------------------------------------------------------------------------------------------------------------------------------------------------------------------------------------------------
--------------------------------------------------------------------------------------------------------------------------------------------------------------------------------------------------------
--------------------------------------------------------------------------------------------------------------------------------------------------------------------------------------------------------
--------------------------------------------------------------------------------------------------------------------------------------------------------------------------------------------------------
---------------------------------------SoSo------------------------------------------------------------------------------------------------------------SoS--------------------------------oSoSoooo------
------------------------------------------------------------------------------------------------------------------Sooooo-----ooSoSo---------------------------------------------------------------------
------------------ooooooo--------------oo-----------oSoooS-------------------------------------------------------------------------------------------ooooooo----ooSo--ooSS-----------------oooooo-------
----------------------------------------g--------------------------------------------------Soo--------------------ooooo------ooooo-------------------------------------------------oooo-----------------
----------------XXXXXXXXXX----------XXXXXXXXX--------oooooo-XXXXX------------------------------------XXXX----------------------------XXX------------XXXXXXXXX------------ooo-------------XXXXXXXXXXX----
XXXXXXXXXXXXXXXXXXXXXXXXXX----------XXXXXXXXXXXXXXX----g----XXXXX-------------------XXXX---ooo-------XXXX----XXXXXXXXXXXX--XXXXXXXXXXXXX--------oo--XXXXXXXXX----------g----------XXXXXXXXXXXXXXXXXXXXXX
XXXXXXXXXXXXXXXXXXXXXXXXXX--------g-XXXXXXXXXXXXXXXXXXXXXXXXXXXXX---XXXXXXXXXXXXX---XXXX-------------XXXX----XXXXXXXXXXXX--XXXXXXXXXXXXX-g------g---XXXXXXXXXXXXXXXXXXXXXXXXX-----XXXXXXXXXXXXXXXXXXXXXX
XXXXXXXXXXXXXXXXXXXXXXXXXXXXXXXXXXXXXXXXXXXXXXXXXXXXXXXXXXXXXXXXXXXXXXXXXXXXXXXXXXXXXXXXXXXXXXXXXXXXXXXXXXXXXXXXXXXXXXXXXXXXXXXXXXXXXXXXXXXXXXXXXXXXXXXXXXXXXXXXXXXXXXXXXXXXXXXXXXXXXXXXXXXXXXXXXXXXXXXX

