--------------------------------------------------------------------------------------------------------------------------------------------------------------------------------------------------------
--------------------------------------------------------------------------------------------------------------------------------------------------------------------------------------------------------
--------------------------------------------------------------------------------------------------------------------------------------------------------------------------------------------------------
--------------------------------------------------------------------------------------------------------------------------------------------------------------------------------------------------------
--------------------------------------------------------------------------------------------------------------------------------------------------------------------------------------------------------
--------------------------------------------------------------------------------------------------------------------------------------------------------------------------------------------------------
--------------------------------------------------------------------------------------------------------------------------------------------------------------------------------------------------------
--------------------------------------------------------------------------------------------------------------------------------------------------------------------------------------------------------
--------------------------------------------------------------------------------------------------------------------------------------------------------------------------------------------------------
--------------------------------------------------------------------------------------------------------------------------------------------------------------------------------------------------------
--------------------------------------------------------------------------------------------------------------------------------------------------------------------------------------------------------
--------------------------------------------------------------------------------------------------------------------------------------------------------------------------------------------------------
--------------oSoooo----------ooSSo----------------------------------------------------------------------------------------------oSooo------------------------------ooSoSo------------------------------
--------------------------------------------------------------------oSSoooo----------------------------------------------ooS-----------------Soo------------------------------------oooooooo------------
------------ooooo-------------ooo---------------------------------------------------------------------------------------------------oooo----------------------------------------------------------------
-------------------g------------------------------------------------oooo-----%%%%%%----------------oo--------------------ooooo---g---g-----ooooooo-----------SoSS--------------------oooooooo-----ooo---
-----------XXXXXXXXXX------XXXXXXXXXXXXXXXXX-----------g-------ooo-----------||||||-----XXX----------------ooo-XX-------g-------XXXXXXXXX----------XX--------------XXXXXXXX---------------------------XX
-----------XXXXXXXXXXXXXXXXXXXXXXXXXXXXXXXXX---oo--XXXXXXX---------XXXXXXXXX-||||||-----XXXXXXX--XXXXXX--------XXXXXXXXXXXXXXXXXXXXXXXXXXXXXXXXXXXXXX-----ooooo----XXXXXXXXXXXX----XXXXXXXXXXX----oo--XX
-----------XXXXXXXXXXXXXXXXXXXXXXXXXXXXXXXXX-------XXXXXXX--XXXXXXXXXXXXXXXXXXXXXXXXXXXXXXXXXXX--XXXXXXXXXXXXXXXXXXXXXXXXXXXXXXXXXXXXXXXXXXXXXXXXXXXXXX------------XXXXXXXXXXXXXXXXXXXXXXXXXXX--------XX
XXXXXXXXXXXXXXXXXXXXXXXXXXXXXXXXXXXXXXXXXXXXXXXXXXXXXXXXXXXXXXXXXXXXXXXXXXXXXXXXXXXXXXXXXXXXXXXXXXXXXXXXXXXXXXXXXXXXXXXXXXXXXXXXXXXXXXXXXXXXXXXXXXXXXXXXXXXXXXXXXXXXXXXXXXXXXXXXXXXXXXXXXXXXXXXXXXXXXXXX

