--------------------------------------------------------------------------------------------------------------------------------------------------------------------------------------------------------
--------------------------------------------------------------------------------------------------------------------------------------------------------------------------------------------------------
--------------------------------------------------------------------------------------------------------------------------------------------------------------------------------------------------------
--------------------------------------------------------------------------------------------------------------------------------------------------------------------------------------------------------
--------------------------------------------------------------------------------------------------------------------------------------------------------------------------------------------------------
--------------------------------------------------------------------------------------------------------------------------------------------------------------------------------------------------------
--------------------------------------------------------------------------------------------------------------------------------------------------------------------------------------------------------
--------------------------------------------------------------------------------------------------------------------------------------------------------------------------------------------------------
--------------------------------------------------------------------------------------------------------------------------------------------------------------------------------------------------------
--------------------------------------------------------------------------------------------------------------------------------------------------------------------------------------------------------
--------------------------------------------------------------------------------------------------------------------------------------------------------------------------------------------------------
--------------------------------------------------------------------------------------------------------------------------------------------------------------------------------------------------------
----------------------------------------------------------------------------------------------------------------------------------------oSooooo---------------------------------------------------------
-------------------------------------------------------------------------------------------------------oSSo------------------------------------------------------Sooooooo-------------------------------
-----------------------------------------------------------------------------------------------------------------------------oSSo--------oooooo---------------------------------ooooo-------------------
----------------------------------SoSo---ooo-----------------------------------------ooo---ooSSooSS---oo----------oooo---------------------------------------------oooooo---------------oooooo----------
-----------------XXXX---XXXX---------------------------XXXXXXX-----XXX----ooo---XXX------------------------------------------oo---XXXXXXXXXXXXXX--ooo------------g--------------oo----------------------
-------------XXXXXXXX---XXXXXXXX-oooo--XXXXXX-----XXXXXXXXXXXX-----XXXXX--g---g-XXXXXXXXXX-oooooooo--XXXXXXX------ooo-------------XXXXXXXXXXXXXX--------XXX----XXXXXXXXXXXXX------------oooooo------XXXX
-------------XXXXXXXXXXXXXXXXXXX-------XXXXXXXXXXXXXXXXXXXXXXX-----XXXXXXXXXXXXXXXXXXXXXXX-----------XXXXXXX---------------XXXXXXXXXXXXXXXXXXXXXXXXXXXXXXXXXXXXXXXXXXXXXXXXXXXXXXXXXXX---------XXXXXXXXX
XXXXXXXXXXXXXXXXXXXXXXXXXXXXXXXXXXXXXXXXXXXXXXXXXXXXXXXXXXXXXXXXXXXXXXXXXXXXXXXXXXXXXXXXXXXXXXXXXXXXXXXXXXXXXXXXXXXXXXXXXXXXXXXXXXXXXXXXXXXXXXXXXXXXXXXXXXXXXXXXXXXXXXXXXXXXXXXXXXXXXXXXXXXXXXXXXXXXXXXX

