--------------------------------------------------------------------------------------------------------------------------------------------------------------------------------------------------------
--------------------------------------------------------------------------------------------------------------------------------------------------------------------------------------------------------
--------------------------------------------------------------------------------------------------------------------------------------------------------------------------------------------------------
--------------------------------------------------------------------------------------------------------------------------------------------------------------------------------------------------------
--------------------------------------------------------------------------------------------------------------------------------------------------------------------------------------------------------
--------------------------------------------------------------------------------------------------------------------------------------------------------------------------------------------------------
--------------------------------------------------------------------------------------------------------------------------------------------------------------------------------------------------------
--------------------------------------------------------------------------------------------------------------------------------------------------------------------------------------------------------
--------------------------------------------------------------------------------------------------------------------------------------------------------------------------------------------------------
--------------------------------------------------------------------------------------------------------------------------------------------------------------------------------------------------------
--------------------------------------------------------------------------------------------------------------------------------------------------------------------------------------------------------
--------------------------------------------------------------------------------------------------------------------------------------------------------------------------------------------------------
-----------------------------------------------------------------------------oSSSoSo-------------------------------------------------------------------------SoS--------------------------------Soo-----
----------------------------------ooo------------------------------oSoooo------------------------------------------------------------------------------------------------------------oooSoo-------------
-------------SSoSSo-------oo---------------------------------------------------ooooo--------oooo-----------------oSoSooo-------------------------------------ooo----------------------------------oo----
----------------------------------oooo-------------------------------oooooo----g---------------------------------------------------oSSoooSo-------SSSS------------------------------oooooo--------------
------------ooooo----XXXXXXXX------------------ooo--------------------------XXXXXXXXXXX----XXXXXXX---XX-------------ooo-----------------------------------XXXXXXXXX-----XXXXXXXXXXX-----------XXXXXXXXXX
---------------------XXXXXXXX--XXXXXXXXX----------------------XX--XXXXXXXXXXXXXXXXXXXXX----XXXXXXX---XXXXXXXXXXX--------------------ooooooo-XXX--oooooooo-XXXXXXXXX-----XXXXXXXXXXXXXXXXXXXXXXXXXXXXXXXX
-----------XXXXXXXXXXXXXXXXXX--XXXXXXXXXXXXXXXXXXXXXXXXX------XX--XXXXXXXXXXXXXXXXXXXXX----XXXXXXXXXXXXXXXXXXXXXXXXXXXXXXXXXX---------------XXX-------g---XXXXXXXXXXXXXXXXXXXXXXXXXXXXXXXXXXXXXXXXXXXXXX
XXXXXXXXXXXXXXXXXXXXXXXXXXXXXXXXXXXXXXXXXXXXXXXXXXXXXXXXXXXXXXXXXXXXXXXXXXXXXXXXXXXXXXXXXXXXXXXXXXXXXXXXXXXXXXXXXXXXXXXXXXXXXXXXXXXXXXXXXXXXXXXXXXXXXXXXXXXXXXXXXXXXXXXXXXXXXXXXXXXXXXXXXXXXXXXXXXXXXXXX

