--------------------------------------------------------------------------------------------------------------------------------------------------------------------------------------------------------
--------------------------------------------------------------------------------------------------------------------------------------------------------------------------------------------------------
--------------------------------------------------------------------------------------------------------------------------------------------------------------------------------------------------------
--------------------------------------------------------------------------------------------------------------------------------------------------------------------------------------------------------
--------------------------------------------------------------------------------------------------------------------------------------------------------------------------------------------------------
--------------------------------------------------------------------------------------------------------------------------------------------------------------------------------------------------------
--------------------------------------------------------------------------------------------------------------------------------------------------------------------------------------------------------
--------------------------------------------------------------------------------------------------------------------------------------------------------------------------------------------------------
--------------------------------------------------------------------------------------------------------------------------------------------------------------------------------------------------------
--------------------------------------------------------------------------------------------------------------------------------------------------------------------------------------------------------
--------------------------------------------------------------------------------------------------------------------------------------------------------------------------------------------------------
--------------------------------------------------------------------------------------------------------------------------------------------------------------------------------------------------------
----------------------------------------------------oooSSSoo-------------------------------------oSoo---------------------------------------------------------------------------------------------------
--------------ooooooo----------------------------------------------------ooo----------ooooooo--------------------------------------------------------------SoooSo---------------------------------------
-------------------------------------------------------oooo---oooo---------------------------------ooo--------------Soooooo-----------------------------------------------------------------------------
----------------ooooooo----------------oo------------------------------ooooo-------------ooooo--------------------------------------------------------------ooooooo--oSoSoSo-------ooSooo------Soo------
-----------XX--------------------------------------XXXXXXXXXXXXXXXXXX----------XXX-------------XXXXXXXX---------------oooo------XXXX---------------ooooo---------------------------------------------XXX
-----------XXXXXXXXXXXXX----------oo--XXXXXXX------XXXXXXXXXXXXXXXXXXXXXXXXXXXXXXX---XXXXXXXXXXXXXXXXXXXXXXXXXX-----------------XXXX-------XXXXX-------g-XXXXXXXXXXX---ooooo--XX----oooo----ooooo----XXX
-----------XXXXXXXXXXXXXXXXXXXXX------XXXXXXXXXXXXXXXXXXXXXXXXXXXXXXXXXXXXXXXXXXXXXXXXXXXXXXXXXXXXXXXXXXXXXXXXXXXXXXXXXXXXXXXXXXXXXXXXXXXXXXXXXXXXXXXXXXXXXXXXXXXXXX------g---XX----------------g----XXX
XXXXXXXXXXXXXXXXXXXXXXXXXXXXXXXXXXXXXXXXXXXXXXXXXXXXXXXXXXXXXXXXXXXXXXXXXXXXXXXXXXXXXXXXXXXXXXXXXXXXXXXXXXXXXXXXXXXXXXXXXXXXXXXXXXXXXXXXXXXXXXXXXXXXXXXXXXXXXXXXXXXXXXXXXXXXXXXXXXXXXXXXXXXXXXXXXXXXXXXX

