--------------------------------------------------------------------------------------------------------------------------------------------------------------------------------------------------------
--------------------------------------------------------------------------------------------------------------------------------------------------------------------------------------------------------
--------------------------------------------------------------------------------------------------------------------------------------------------------------------------------------------------------
--------------------------------------------------------------------------------------------------------------------------------------------------------------------------------------------------------
--------------------------------------------------------------------------------------------------------------------------------------------------------------------------------------------------------
--------------------------------------------------------------------------------------------------------------------------------------------------------------------------------------------------------
--------------------------------------------------------------------------------------------------------------------------------------------------------------------------------------------------------
--------------------------------------------------------------------------------------------------------------------------------------------------------------------------------------------------------
--------------------------------------------------------------------------------------------------------------------------------------------------------------------------------------------------------
--------------------------------------------------------------------------------------------------------------------------------------------------------------------------------------------------------
--------------------------------------------------------------------------------------------------------------------------------------------------------------------------------------------------------
--------------------------------------------------------------------------------------------------------------------------------------------------------------------------------------------------------
---------------------------------SoSooo-----------------------------------------------------------------------------------------------------------------------------------------------------------------
----------------------------------------------------------------------ooSS----------------------------------------------------------------ooSSoo-----------------------------------SooS-----------------
----------------oSo----oooo-----oooooo--------------------oo------------------Soo----ooo--------------------------------------------------------------------------oooSoSo---------------------SooS------
-----------------------------------------ooSooooo-------------------oooo----------------------------------------ooo---------------------------------------ooSo--------------------ooooooo---------------
XXXXXXXXXXXXXX---------oo----XXXXXXXXXXX---------------XXXXXX-------------------oo--XXXXXXXXXXXX---------------------------------------------g-------XXX-----------ooooo-------XX------------ooo------XX
XXXXXXXXXXXXXX---------------XXXXXXXXXXX---oooo----XXXXXXXXXX-----XXXXXXXXXX--------XXXXXXXXXXXX-oo-------------ooo-------XXXX--XXXXXXXXXXXXXXXXX----XXX---oo--XX--------------XXXXXXXXXXXX----g----XXXX
XXXXXXXXXXXXXXXXXXXXXXXXXXXXXXXXXXXXXXXX-----------XXXXXXXXXXXXXXXXXXXXXXXXXXXXXXXXXXXXXXXXXXXXX------XXXXXX--------------XXXX--XXXXXXXXXXXXXXXXX----XXX-------XXXXXXXXXXX-----XXXXXXXXXXXXXXXXXXXXXXXXX
XXXXXXXXXXXXXXXXXXXXXXXXXXXXXXXXXXXXXXXXXXXXXXXXXXXXXXXXXXXXXXXXXXXXXXXXXXXXXXXXXXXXXXXXXXXXXXXXXXXXXXXXXXXXXXXXXXXXXXXXXXXXXXXXXXXXXXXXXXXXXXXXXXXXXXXXXXXXXXXXXXXXXXXXXXXXXXXXXXXXXXXXXXXXXXXXXXXXXXXX

