--------------------------------------------------------------------------------------------------------------------------------------------------------------------------------------------------------
--------------------------------------------------------------------------------------------------------------------------------------------------------------------------------------------------------
--------------------------------------------------------------------------------------------------------------------------------------------------------------------------------------------------------
--------------------------------------------------------------------------------------------------------------------------------------------------------------------------------------------------------
--------------------------------------------------------------------------------------------------------------------------------------------------------------------------------------------------------
--------------------------------------------------------------------------------------------------------------------------------------------------------------------------------------------------------
--------------------------------------------------------------------------------------------------------------------------------------------------------------------------------------------------------
--------------------------------------------------------------------------------------------------------------------------------------------------------------------------------------------------------
--------------------------------------------------------------------------------------------------------------------------------------------------------------------------------------------------------
--------------------------------------------------------------------------------------------------------------------------------------------------------------------------------------------------------
--------------------------------------------------------------------------------------------------------------------------------------------------------------------------------------------------------
--------------------------------------------------------------------------------------------------------------------------------------------------------------------------------------------------------
-----------------------------------------------------------------------------oooSo----------------------------------------------------------------------------------------------------------------------
-----------------------------------------------------Soooo-----------------------------------------------------------------------------------------------oooS----------------------------oSoS-----------
---------------------------------------------------------------oo---------ooooooo---------------------------------------------------------------oo-----------------------------------------------oooS---
---------------------oSoo----oSSoSoS-----SSoooo-----ooooo--------------------g------------oSoooSooo--ooooo--------oooS-----Sooo----ooSooo---------------oooo--------Sooo----ooooooo---ooooo-------------
-------------------------------------------------------g---XXXXXXX-------XXXXXXXXXX-ooo---------------------XX-------------------------------XXXXXXXX---------------------------------------------------
-------------------------------ooo-------oooooo-XXXXXXXXXXXXXXXXXX-------XXXXXXXXXX----------ooooo--XXXXXXXXXX--ooooo-----ooooooo----oooo----XXXXXXXXXXXXXXXXXXX---ooooo-----oooo----XXXXXXXXXX---------
--------------XXXXXX--------------------g----g--XXXXXXXXXXXXXXXXXXXXXXX--XXXXXXXXXXXXXXXX-----------XXXXXXXXXX-------g-----------------------XXXXXXXXXXXXXXXXXXX-g-------------------XXXXXXXXXXXXXXXXXXX
XXXXXXXXXXXXXXXXXXXXXXXXXXXXXXXXXXXXXXXXXXXXXXXXXXXXXXXXXXXXXXXXXXXXXXXXXXXXXXXXXXXXXXXXXXXXXXXXXXXXXXXXXXXXXXXXXXXXXXXXXXXXXXXXXXXXXXXXXXXXXXXXXXXXXXXXXXXXXXXXXXXXXXXXXXXXXXXXXXXXXXXXXXXXXXXXXXXXXXXX

