--------------------------------------------------------------------------------------------------------------------------------------------------------------------------------------------------------
--------------------------------------------------------------------------------------------------------------------------------------------------------------------------------------------------------
--------------------------------------------------------------------------------------------------------------------------------------------------------------------------------------------------------
--------------------------------------------------------------------------------------------------------------------------------------------------------------------------------------------------------
--------------------------------------------------------------------------------------------------------------------------------------------------------------------------------------------------------
--------------------------------------------------------------------------------------------------------------------------------------------------------------------------------------------------------
--------------------------------------------------------------------------------------------------------------------------------------------------------------------------------------------------------
--------------------------------------------------------------------------------------------------------------------------------------------------------------------------------------------------------
--------------------------------------------------------------------------------------------------------------------------------------------------------------------------------------------------------
--------------------------------------------------------------------------------------------------------------------------------------------------------------------------------------------------------
--------------------------------------------------------------------------------------------------------------------------------------------------------------------------------------------------------
--------------------------------------------------------------------------------------------------------------------------------------------------------------------------------------------------------
-----------------------------------------------------oSoo------------------------------------------------------------SooSo-----------------------------------ooSoo-----oooo--------------------Sooo-----
-------------------------------------------------------------------------------------oooS----------------------------------------------------------SSSoo------------------------------------------------
--------------------ooSo------------------oo---------oooo---ooo-----------------------------------------------------oooo-----------------------------------------------oooooo-----------------ooooo-----
---------------------------------------------------------------------------ooS------oooo--------------------------------------ooSoo----oSooo--------ooooo-----------------------------------------------
----------XXXXX----ooooooo------ooooo----XXXXXXXXXXXXXXXXXXXXXXXXXX-------------------g--------------------------XXXXXXXXXX---------------------------------XXXXXXX--XXXXXXXXX-oooo--------XXXXXXXXXXX--
----------XXXXX-------------XX---------XXXXXXXXXXXXXXXXXXXXXXXXXXXX--------ooo-----XXXXXXXXX---------------------XXXXXXXXXX----oooooo---ooo--XXXXXXXXXXXXXXXXXXXXXXXXXXXXXXXXX-------------XXXXXXXXXXX--
----------XXXXX---XXXXXXXXXXXXXXXXXXXXXXXXXXXXXXXXXXXXXXXXXXXXXXXXX----------------XXXXXXXXXXXX------------------XXXXXXXXXX---------------g--XXXXXXXXXXXXXXXXXXXXXXXXXXXXXXXXXXXXXXXX------XXXXXXXXXXX--
XXXXXXXXXXXXXXXXXXXXXXXXXXXXXXXXXXXXXXXXXXXXXXXXXXXXXXXXXXXXXXXXXXXXXXXXXXXXXXXXXXXXXXXXXXXXXXXXXXXXXXXXXXXXXXXXXXXXXXXXXXXXXXXXXXXXXXXXXXXXXXXXXXXXXXXXXXXXXXXXXXXXXXXXXXXXXXXXXXXXXXXXXXXXXXXXXXXXXXXX

