--------------------------------------------------------------------------------------------------------------------------------------------------------------------------------------------------------
--------------------------------------------------------------------------------------------------------------------------------------------------------------------------------------------------------
--------------------------------------------------------------------------------------------------------------------------------------------------------------------------------------------------------
--------------------------------------------------------------------------------------------------------------------------------------------------------------------------------------------------------
--------------------------------------------------------------------------------------------------------------------------------------------------------------------------------------------------------
--------------------------------------------------------------------------------------------------------------------------------------------------------------------------------------------------------
--------------------------------------------------------------------------------------------------------------------------------------------------------------------------------------------------------
--------------------------------------------------------------------------------------------------------------------------------------------------------------------------------------------------------
--------------------------------------------------------------------------------------------------------------------------------------------------------------------------------------------------------
--------------------------------------------------------------------------------------------------------------------------------------------------------------------------------------------------------
--------------------------------------------------------------------------------------------------------------------------------------------------------------------------------------------------------
--------------------------------------------------------------------------------------------------------------------------------------------------------------------------------------------------------
--------------Soo-----------------------------------------------------------------------------oSSo------------------------------------------------------------------------------------------------------
--------------------------SoSoSooo------------------------------------------------oSo-------------------------------------------------------------------------------------------------------------------
------------------------------------------oo--------------------------------------------------oooo---------------------------oSo----------------------SooSo-----ooo--------------ooo-----------ooo------
--------------------------oooooooo---------------------------ooSooSo----ooo-------oo-------------g-----oSoSo------oSoo--------------------------ooo--------------------SSoo-----------------------------
XXXXXXXXXXXXXXXXXX---oo-----g----------XXXXXXXXXX-------ooo---------------------------------XXXXXXXXX-----------------------ooooo-----------------------oooo-XXXXXXX------------------------XXXXXXX-----
XXXXXXXXXXXXXXXXXX------XXXXXXXXXXX----XXXXXXXXXXXXX---------oooooo------------XXXXXXXXXXXXXXXXXXXXXX----------ooooooooo---------------------oooooo----------XXXXXXX----oooo------------oo--XXXXXXXXX---
XXXXXXXXXXXXXXXXXXXXXXXXXXXXXXXXXXXXXXXXXXXXXXXXXXXXXXXXXXXX-------------------XXXXXXXXXXXXXXXXXXXXXX----------------gg--XXXXXXXXXXXXXXXXXXX--------XXXXXXXXXXXXXXXX---------g-XXXXXX-------XXXXXXXXXXXX
XXXXXXXXXXXXXXXXXXXXXXXXXXXXXXXXXXXXXXXXXXXXXXXXXXXXXXXXXXXXXXXXXXXXXXXXXXXXXXXXXXXXXXXXXXXXXXXXXXXXXXXXXXXXXXXXXXXXXXXXXXXXXXXXXXXXXXXXXXXXXXXXXXXXXXXXXXXXXXXXXXXXXXXXXXXXXXXXXXXXXXXXXXXXXXXXXXXXXXXX

