--------------------------------------------------------------------------------------------------------------------------------------------------------------------------------------------------------
--------------------------------------------------------------------------------------------------------------------------------------------------------------------------------------------------------
--------------------------------------------------------------------------------------------------------------------------------------------------------------------------------------------------------
--------------------------------------------------------------------------------------------------------------------------------------------------------------------------------------------------------
--------------------------------------------------------------------------------------------------------------------------------------------------------------------------------------------------------
--------------------------------------------------------------------------------------------------------------------------------------------------------------------------------------------------------
--------------------------------------------------------------------------------------------------------------------------------------------------------------------------------------------------------
--------------------------------------------------------------------------------------------------------------------------------------------------------------------------------------------------------
--------------------------------------------------------------------------------------------------------------------------------------------------------------------------------------------------------
--------------------------------------------------------------------------------------------------------------------------------------------------------------------------------------------------------
--------------------------------------------------------------------------------------------------------------------------------------------------------------------------------------------------------
--------------------------------------------------------------------------------------------------------------------------------------------------------------------------------------------------------
--------------------------------------------------------------------------------------------------------------------------------------------------------------------------------------------------------
----------------------------------------------------------------------------------------SSSooo--oSoooSo-------------------------------------------------------------------------------------------------
----------------------------------------------oooSo------------------ooo--------------------------------------------------------------------oooo------------------ooo-----------------------------------
--------------oooooSo---------------------------------------------------------------------oo------ooooo-----------------------------oooSo---------------------------------------------------------------
----------------------------XXXXXX------------oooooo----------------------------------------------g-----XXXX--------XXXX--------------------ooooo------XXXXX-----XXXXXXX---XXX------g-------------------
---------------ooooooo-XXXXXXXXXXX---------------------------------------------XXXXXXXXXXXXXXXXXXXXXXXXXXXXX--------XXXX----oooo-----ooo---------------XXXXX-----XXXXXXX---XXXXXXXXXXXXXXXXXXX-----XXXXX
-----------------------XXXXXXXXXXXXXXX----XXXXXXXXXXX---XXXXXXXXXXXXXXXXXXX----XXXXXXXXXXXXXXXXXXXXXXXXXXXXX-----XXXXXXX-------------------XXXXXXXX----XXXXX-----XXXXXXXXXXXXXXXXXXXXXXXXXXXXX-----XXXXX
XXXXXXXXXXXXXXXXXXXXXXXXXXXXXXXXXXXXXXXXXXXXXXXXXXXXXXXXXXXXXXXXXXXXXXXXXXXXXXXXXXXXXXXXXXXXXXXXXXXXXXXXXXXXXXXXXXXXXXXXXXXXXXXXXXXXXXXXXXXXXXXXXXXXXXXXXXXXXXXXXXXXXXXXXXXXXXXXXXXXXXXXXXXXXXXXXXXXXXXX

