--------------------------------------------------------------------------------------------------------------------------------------------------------------------------------------------------------
--------------------------------------------------------------------------------------------------------------------------------------------------------------------------------------------------------
--------------------------------------------------------------------------------------------------------------------------------------------------------------------------------------------------------
--------------------------------------------------------------------------------------------------------------------------------------------------------------------------------------------------------
--------------------------------------------------------------------------------------------------------------------------------------------------------------------------------------------------------
--------------------------------------------------------------------------------------------------------------------------------------------------------------------------------------------------------
--------------------------------------------------------------------------------------------------------------------------------------------------------------------------------------------------------
--------------------------------------------------------------------------------------------------------------------------------------------------------------------------------------------------------
--------------------------------------------------------------------------------------------------------------------------------------------------------------------------------------------------------
--------------------------------------------------------------------------------------------------------------------------------------------------------------------------------------------------------
--------------------------------------------------------------------------------------------------------------------------------------------------------------------------------------------------------
--------------------------------------------------------------------------------------------------------------------------------------------------------------------------------------------------------
-----------------------------------------------------------------------------------------------------SSo-------------------------oSSSooSSo------oSooo---------------------------------------------------
----------------------------------------------------------------------------ooooo---------------------------oSoSS---------------------------------------------------oooooo------------------------------
----------------------------------SoooS-----oSoooo----SoSSooo---------------------------------------oooooo-----------------------oooooo-----------ooo------ooS------------------------------------------
-------------------ooSoSSo----------------------------------------------------ooo-------Soooooo---------g---ooooo-----ooSooSooo---------------------------------------oo-------------------oSo----------
XXXXXXXXXXXXXXXXX------------------oooo------oooo----ooooo------XXXX----------------XX-----------XXXXXXXXXX---------------------XXXXXXXXXXXXXXXXXXXXXXXXXX--oooo------g-----XXXXXX----------------------
XXXXXXXXXXXXXXXXX---oooooo-XXXXX------------------------------XXXXXX-------XXXXXXXXXXX-ooooooo---XXXXXXXXXXXXXXXXXXXX---ooooo---XXXXXXXXXXXXXXXXXXXXXXXXXX----gg--XXXXXXXXXXXXXXXXXXXXX-----------------
XXXXXXXXXXXXXXXXX----------XXXXXXXXXXXXXXXXXXXXXXXXXXXXXXXXXXXXXXXXXXXXX---XXXXXXXXXXX-----------XXXXXXXXXXXXXXXXXXXX-----------XXXXXXXXXXXXXXXXXXXXXXXXXXXXXXXXXXXXXXXXXXXXXXXXXXXXXXX-----------------
XXXXXXXXXXXXXXXXXXXXXXXXXXXXXXXXXXXXXXXXXXXXXXXXXXXXXXXXXXXXXXXXXXXXXXXXXXXXXXXXXXXXXXXXXXXXXXXXXXXXXXXXXXXXXXXXXXXXXXXXXXXXXXXXXXXXXXXXXXXXXXXXXXXXXXXXXXXXXXXXXXXXXXXXXXXXXXXXXXXXXXXXXXXXXXXXXXXXXXXX

