--------------------------------------------------------------------------------------------------------------------------------------------------------------------------------------------------------
--------------------------------------------------------------------------------------------------------------------------------------------------------------------------------------------------------
--------------------------------------------------------------------------------------------------------------------------------------------------------------------------------------------------------
--------------------------------------------------------------------------------------------------------------------------------------------------------------------------------------------------------
--------------------------------------------------------------------------------------------------------------------------------------------------------------------------------------------------------
--------------------------------------------------------------------------------------------------------------------------------------------------------------------------------------------------------
--------------------------------------------------------------------------------------------------------------------------------------------------------------------------------------------------------
--------------------------------------------------------------------------------------------------------------------------------------------------------------------------------------------------------
--------------------------------------------------------------------------------------------------------------------------------------------------------------------------------------------------------
--------------------------------------------------------------------------------------------------------------------------------------------------------------------------------------------------------
--------------------------------------------------------------------------------------------------------------------------------------------------------------------------------------------------------
--------------------------------------------------------------------------------------------------------------------------------------------------------------------------------------------------------
------------------------------------------------------------ooooo----------------------------------------------------------------------------------------------------------------------ooo--------------
-------------oSS-------------------------------------------------------------ooS----------------------------------------------------------------oooSSSo-------------------------------------------------
------------------------------------------------------ooS-----------------------------ooS---------------oSooSSo---------------------------------------------oooo--------------------oooooooo------------
-------------oo----------------------oSo--------------------------------------oooo----------------------------------Sooo-------------------------oooo---------------------SooSooo-----------------------
-------------------------ooooo-----------------oo-----oooo-XXXXXXXXXXXXX-------------ooooooo-----XXXXX---oooooo-------------XXXXXXXX--------------------XXXXXXXXXXXXXXXX-----------XXXXXXXXXX----XXX----
----------XXXXXXXXX-------------------oooo-----------------XXXXXXXXXXXXXXXXXXXXXXXXX-------g-----XXXXX------------ooooooo---XXXXXXXX------XXXXXXXXXXXXXXXXXXXXXXXXXXXXXX--oooooooo-XXXXXXXXXX----XXXXXXX
----------XXXXXXXXX-----XXXXXXX-------------XXXXXXXXXXXXXXXXXXXXXXXXXXXXXXXXXXXXXXXXXXXXXXXXX----XXXXXXXXXXXXXXXX-----------XXXXXXXXXXXXXXXXXXXXXXXXXXXXXXXXXXXXXXXXXXXX-----------XXXXXXXXXXXXXXXXXXXXX
XXXXXXXXXXXXXXXXXXXXXXXXXXXXXXXXXXXXXXXXXXXXXXXXXXXXXXXXXXXXXXXXXXXXXXXXXXXXXXXXXXXXXXXXXXXXXXXXXXXXXXXXXXXXXXXXXXXXXXXXXXXXXXXXXXXXXXXXXXXXXXXXXXXXXXXXXXXXXXXXXXXXXXXXXXXXXXXXXXXXXXXXXXXXXXXXXXXXXXXX

