--------------------------------------------------------------------------------------------------------------------------------------------------------------------------------------------------------
--------------------------------------------------------------------------------------------------------------------------------------------------------------------------------------------------------
--------------------------------------------------------------------------------------------------------------------------------------------------------------------------------------------------------
--------------------------------------------------------------------------------------------------------------------------------------------------------------------------------------------------------
--------------------------------------------------------------------------------------------------------------------------------------------------------------------------------------------------------
--------------------------------------------------------------------------------------------------------------------------------------------------------------------------------------------------------
--------------------------------------------------------------------------------------------------------------------------------------------------------------------------------------------------------
--------------------------------------------------------------------------------------------------------------------------------------------------------------------------------------------------------
--------------------------------------------------------------------------------------------------------------------------------------------------------------------------------------------------------
--------------------------------------------------------------------------------------------------------------------------------------------------------------------------------------------------------
--------------------------------------------------------------------------------------------------------------------------------------------------------------------------------------------------------
--------------------------------------------------------------------------------------------------------------------------------------------------------------------------------------------------------
---------------------------------------------------------oSoo-------------------------------------------------------SoSSoo--------Soooo-----------------------------------------------------------------
--------------------------------------------------------------------------------------------------------------------------------------------------------------SooS--------------------------ooooSoo-----
-------------ooSoo--------------ooo---------------------ooooo------oSo--------oo--------------------------------------oooooo-----ooo--------------------------------------------------------------------
--------------------------------------SoooSooo---------------------------------------------ooo----------oooo------------------------g-g------------------------ooo----------------ooo-------ooooooooo---
XXXXXXXXXXXX----oo------oo----------------------------XXXXXXXXX---oooooo--XXXXXXX------------------------------XXXXXXXXXXXXXXXXXXXXXXXXX----XXXXXXXXXXXX--------g-g----XXXXX----------------------------
XXXXXXXXXXXX----g---------------------ooooooo--XXXXX--XXXXXXXXX-----------XXXXXXXXXX-------------------ooooooo-XXXXXXXXXXXXXXXXXXXXXXXXX----XXXXXXXXXXXXXXXXXXXXXXXXX--XXXXX----oooo-------XXXXXXXXXXX--
XXXXXXXXXXXXXXXXXXXXXXXXXXXXXXXXXXXX------g----XXXXXXXXXXXXXXXXXXXXXXXXXXXXXXXXXXXXX-----------------------g-g-XXXXXXXXXXXXXXXXXXXXXXXXXXXXXXXXXXXXXXXXXXXXXXXXXXXXXX--XXXXX-----------XXXXXXXXXXXXXXX--
XXXXXXXXXXXXXXXXXXXXXXXXXXXXXXXXXXXXXXXXXXXXXXXXXXXXXXXXXXXXXXXXXXXXXXXXXXXXXXXXXXXXXXXXXXXXXXXXXXXXXXXXXXXXXXXXXXXXXXXXXXXXXXXXXXXXXXXXXXXXXXXXXXXXXXXXXXXXXXXXXXXXXXXXXXXXXXXXXXXXXXXXXXXXXXXXXXXXXXXX

