--------------------------------------------------------------------------------------------------------------------------------------------------------------------------------------------------------
--------------------------------------------------------------------------------------------------------------------------------------------------------------------------------------------------------
--------------------------------------------------------------------------------------------------------------------------------------------------------------------------------------------------------
--------------------------------------------------------------------------------------------------------------------------------------------------------------------------------------------------------
--------------------------------------------------------------------------------------------------------------------------------------------------------------------------------------------------------
--------------------------------------------------------------------------------------------------------------------------------------------------------------------------------------------------------
--------------------------------------------------------------------------------------------------------------------------------------------------------------------------------------------------------
--------------------------------------------------------------------------------------------------------------------------------------------------------------------------------------------------------
--------------------------------------------------------------------------------------------------------------------------------------------------------------------------------------------------------
--------------------------------------------------------------------------------------------------------------------------------------------------------------------------------------------------------
--------------------------------------------------------------------------------------------------------------------------------------------------------------------------------------------------------
--------------------------------------------------------------------------------------------------------------------------------------------------------------------------------------------------------
---------------------------------------------------------------------ooS------------ooooS--------------------------------------------------------------ooSS---------------------------------------------
-----------------------------------oSoo---------------ooo-----------------------------------------------------------------------------------------------------------------------------------------------
-------------------------------------------------------------------ooooooo----------ooo-------------oo--------------------------------------oooooSooo---ooooo----------------oSSSo----------------------
--------------oSS----------oSo----oo----------------ooooo----------------------------------------------------------SoooS-----------oSSoSoo----------------------------oo--------------------------------
--------------------XXXXX------------g---------------------------XXXXXXXXXX-----XXXXXXXXXXXXXXXX--XXXXXXXXXXXXX-----------------------------oooooo----XXXXXXXXXXXX----g-----ooooooooo-------------------
---------------oooo-XXXXX---oo-XXXXXXXXX--oo---XXXXXXXXXXXXXXXXXXXXXXXXXXXX-----XXXXXXXXXXXXXXXX--XXXXXXXXXXXXX--oooooooo------------ooooo------------XXXXXXXXXXXXXXXXXXXXX------------ooo---------XXXXX
------------------g-XXXXX------XXXXXXXXX-------XXXXXXXXXXXXXXXXXXXXXXXXXXXX--XXXXXXXXXXXXXXXXXXXXXXXXXXXXXXXXXX-----------XXXXXXX----------XXXXXXXXXXXXXXXXXXXXXXXXXXXXXXXXXXXXXXXXXXX--------XXXXXXXXXX
XXXXXXXXXXXXXXXXXXXXXXXXXXXXXXXXXXXXXXXXXXXXXXXXXXXXXXXXXXXXXXXXXXXXXXXXXXXXXXXXXXXXXXXXXXXXXXXXXXXXXXXXXXXXXXXXXXXXXXXXXXXXXXXXXXXXXXXXXXXXXXXXXXXXXXXXXXXXXXXXXXXXXXXXXXXXXXXXXXXXXXXXXXXXXXXXXXXXXXXX

