--------------------------------------------------------------------------------------------------------------------------------------------------------------------------------------------------------
--------------------------------------------------------------------------------------------------------------------------------------------------------------------------------------------------------
--------------------------------------------------------------------------------------------------------------------------------------------------------------------------------------------------------
--------------------------------------------------------------------------------------------------------------------------------------------------------------------------------------------------------
--------------------------------------------------------------------------------------------------------------------------------------------------------------------------------------------------------
--------------------------------------------------------------------------------------------------------------------------------------------------------------------------------------------------------
--------------------------------------------------------------------------------------------------------------------------------------------------------------------------------------------------------
--------------------------------------------------------------------------------------------------------------------------------------------------------------------------------------------------------
--------------------------------------------------------------------------------------------------------------------------------------------------------------------------------------------------------
--------------------------------------------------------------------------------------------------------------------------------------------------------------------------------------------------------
--------------------------------------------------------------------------------------------------------------------------------------------------------------------------------------------------------
--------------------------------------------------------------------------------------------------------------------------------------------------------------------------------------------------------
---------------------------------------------------------------------Soooooo---------------------------------------------------Soo----------------SSSooo----------------------------ooSS----ooSoSo------
------------------------------------------------------------SSoooo-----------------------------ooS-----------------------------------------------------------oooSooo------------------------------------
---------------------oooSS------------------------------------------ooooo-------------oSSo--------------------ooSoo-----------oooooo--------------ooooo------------------oooo-----oooo--------oo--------
------------ooooo--------------oooo--------------------------oooo-------------------------------oo--------------------------------------oSo-------------------ooo---------------------------------------
XXXXXXXXXX-------------ooo---------------------XXXX---XXXX---------XXXXXXXXXX------ooooooo--XX---------------oooooo----------XXXXXXXXXX--------XXXXXXXXXXX-----------XXX---ooooo-XXXXXXXXXXXXXXXXXX----X
XXXXXXXXXX---oooooo------g---oooooo----XXXXXXXXXXXXXXXXXXXXXXXXXXXXXXXXXXXXXX---------------XXXXXXXXXX----------------XXXXXXXXXXXXXXXXX-oooooo-XXXXXXXXXXXXXXXXXXXXXXXXX-------g-XXXXXXXXXXXXXXXXXX----X
XXXXXXXXXX----------XXXXXXXX----g------XXXXXXXXXXXXXXXXXXXXXXXXXXXXXXXXXXXXXX-----XXXXXXXXXXXXXXXXXXXXXXXXXXXXXXXXXXXXXXXXXXXXXXXXXXXXX--------XXXXXXXXXXXXXXXXXXXXXXXXXXXXXXXXXXXXXXXXXXXXXXXXXXXXXXXXX
XXXXXXXXXXXXXXXXXXXXXXXXXXXXXXXXXXXXXXXXXXXXXXXXXXXXXXXXXXXXXXXXXXXXXXXXXXXXXXXXXXXXXXXXXXXXXXXXXXXXXXXXXXXXXXXXXXXXXXXXXXXXXXXXXXXXXXXXXXXXXXXXXXXXXXXXXXXXXXXXXXXXXXXXXXXXXXXXXXXXXXXXXXXXXXXXXXXXXXXX

