--------------------------------------------------------------------------------------------------------------------------------------------------------------------------------------------------------
--------------------------------------------------------------------------------------------------------------------------------------------------------------------------------------------------------
--------------------------------------------------------------------------------------------------------------------------------------------------------------------------------------------------------
--------------------------------------------------------------------------------------------------------------------------------------------------------------------------------------------------------
--------------------------------------------------------------------------------------------------------------------------------------------------------------------------------------------------------
--------------------------------------------------------------------------------------------------------------------------------------------------------------------------------------------------------
--------------------------------------------------------------------------------------------------------------------------------------------------------------------------------------------------------
--------------------------------------------------------------------------------------------------------------------------------------------------------------------------------------------------------
--------------------------------------------------------------------------------------------------------------------------------------------------------------------------------------------------------
--------------------------------------------------------------------------------------------------------------------------------------------------------------------------------------------------------
--------------------------------------------------------------------------------------------------------------------------------------------------------------------------------------------------------
--------------------------------------------------------------------------------------------------------------------------------------------------------------------------------------------------------
------------------------------------------------------------------------Soo----------------------oooSo------------------------------------------SoSoSo--------------------------------------------oSoo--
--------------------ooo-----------ooooSSS---------------------------------------ooSoooSo------------------------------------------------------------------oSSo------------------------------------------
------------ooo-----------------------------oo-----SooooS----------------oo------------------------ooo-----------ooo---------------------------oooooo--------------------------ooS----------------ooo---
-------------------ooo------------oooooooo-------------------oooo------g-----------ooooo--------g------------------g-----------oSo--------------------------------ooo-----------------------------g-----
-------------------------------------------XXXXXX----ooo------------XXXXXXXXXXX-----------XXXXXXXXXXXXX-------XXXXXXX--ooo--------------------XXXXXXXXXXX-------------------ooooo-------------oo-XXXXXXX
-----------------XXXXXXXX--oo----XXXXXXXXXXXXXXXX------------ooooo--XXXXXXXXXXXXXXXXXXXXXXXXXXXXXXXXXXXXX-----XXXXXXX----------ooooo----------XXXXXXXXXXXXXXXXX--XXXXXX--------------XXXXXX------XXXXXXX
XXXXXXXXXXXXXXXXXXXXXXXXX--------XXXXXXXXXXXXXXXXXXXXXXXXXXX--------XXXXXXXXXXXXXXXXXXXXXXXXXXXXXXXXXXXXX-----XXXXXXXXXXXXX-----------XXXXXXXXXXXXXXXXXXXXXXXXX--XXXXXX----XXXXXXXXXXXXXXXXXXXXXXXXXXXXX
XXXXXXXXXXXXXXXXXXXXXXXXXXXXXXXXXXXXXXXXXXXXXXXXXXXXXXXXXXXXXXXXXXXXXXXXXXXXXXXXXXXXXXXXXXXXXXXXXXXXXXXXXXXXXXXXXXXXXXXXXXXXXXXXXXXXXXXXXXXXXXXXXXXXXXXXXXXXXXXXXXXXXXXXXXXXXXXXXXXXXXXXXXXXXXXXXXXXXXXX

