--------------------------------------------------------------------------------------------------------------------------------------------------------------------------------------------------------
--------------------------------------------------------------------------------------------------------------------------------------------------------------------------------------------------------
--------------------------------------------------------------------------------------------------------------------------------------------------------------------------------------------------------
--------------------------------------------------------------------------------------------------------------------------------------------------------------------------------------------------------
--------------------------------------------------------------------------------------------------------------------------------------------------------------------------------------------------------
--------------------------------------------------------------------------------------------------------------------------------------------------------------------------------------------------------
--------------------------------------------------------------------------------------------------------------------------------------------------------------------------------------------------------
--------------------------------------------------------------------------------------------------------------------------------------------------------------------------------------------------------
--------------------------------------------------------------------------------------------------------------------------------------------------------------------------------------------------------
--------------------------------------------------------------------------------------------------------------------------------------------------------------------------------------------------------
--------------------------------------------------------------------------------------------------------------------------------------------------------------------------------------------------------
--------------------------------------------------------------------------------------------------------------------------------------------------------------------------------------------------------
-----------------------------------------------------------------------------------------------ooSo----------------------------------------------------------------------------------------------oSoS---
---------------oSSSo-----------------------------------oSo-------------------SSS----------------------------------------------SoSo----------------------------------------------------------------------
--------------------------ooo--------------------------------------------------------------------ooo----------------------------------oSoo----------oooooo-----------------------------------------oo---
----------------ooo-------------------ooo------------ooooo--------oSoSSS----oo-----------------g--------ooo-----------------oooooo----------------------------------------------------------------------
---------------------XXX------------------------XXXX------------------------------XXXXX------XXXXXXXX----------XXXX-------------g------oooo-----------oooo------------------------------oo-XXXXXXXXXXXXX
--------------XXXXXXXXXX-------------XXXXXXX----XXXXXXXXXXXXX-----ooooooo--XXXXXXXXXXXX------XXXXXXXX---oooo---XXXXXXXXX--XXXXXXXXX---------------------------oooo--XXXXX--XXX-------------XXXXXXXXXXXXX
--------------XXXXXXXXXXXXXXXXXXXXXXXXXXXXXXXXXXXXXXXXXXXXXXXXXXX----------XXXXXXXXXXXXXXXXXXXXXXXXXX----------XXXXXXXXXXXXXXXXXXXX--XXXXXXXXX-----XXXXXXXXXX-------XXXXX--XXX------XXXXXXXXXXXXXXXXXXXX
XXXXXXXXXXXXXXXXXXXXXXXXXXXXXXXXXXXXXXXXXXXXXXXXXXXXXXXXXXXXXXXXXXXXXXXXXXXXXXXXXXXXXXXXXXXXXXXXXXXXXXXXXXXXXXXXXXXXXXXXXXXXXXXXXXXXXXXXXXXXXXXXXXXXXXXXXXXXXXXXXXXXXXXXXXXXXXXXXXXXXXXXXXXXXXXXXXXXXXXX

