--------------------------------------------------------------------------------------------------------------------------------------------------------------------------------------------------------
--------------------------------------------------------------------------------------------------------------------------------------------------------------------------------------------------------
--------------------------------------------------------------------------------------------------------------------------------------------------------------------------------------------------------
--------------------------------------------------------------------------------------------------------------------------------------------------------------------------------------------------------
--------------------------------------------------------------------------------------------------------------------------------------------------------------------------------------------------------
--------------------------------------------------------------------------------------------------------------------------------------------------------------------------------------------------------
--------------------------------------------------------------------------------------------------------------------------------------------------------------------------------------------------------
--------------------------------------------------------------------------------------------------------------------------------------------------------------------------------------------------------
--------------------------------------------------------------------------------------------------------------------------------------------------------------------------------------------------------
--------------------------------------------------------------------------------------------------------------------------------------------------------------------------------------------------------
--------------------------------------------------------------------------------------------------------------------------------------------------------------------------------------------------------
--------------------------------------------------------------------------------------------------------------------------------------------------------------------------------------------------------
-----------------------------------------------------------------------------oSoooSSo--------------------------------------------------------oSSSSoo----------------------------------------------------
---------------------ooSo------------------------------------------------------------------------SoooSo-------------------------------------------------------------------------------------------------
------------------------------------ooS-----------SSSooo---------------------oooooo--------------------------------SSoooo-------------------------------------------------------------------------------
----------------------ooooo---------------------------------------------------------------------ooooooo------------------------------------------------------ooo----------------------------------------
------------------------g-----------ooooo-------ooooo-----------------------XXXXXXXXXXX------------------------------oo----------XXX--------XXXXXXXXX---------------------------XXXXX-----------XX------
---------------XXXXXXXXXXXXXX------g--g------------------------XXX----------XXXXXXXXXXX---oo---XXXXXXXXXX------------------------XXXXXXXXXXXXXXXXXXXX-------XXXXXXX-------------XXXXXXXXX---oo--XX------
-----------XXXXXXXXXXXXXXXXXXXXXXXXXXXXXXXXXXXXXXXXXXXXXXXXXXXXXXXXXXXXX----XXXXXXXXXXX---g----XXXXXXXXXX--------XXXXXXXXXX------XXXXXXXXXXXXXXXXXXXX-------XXXXXXXXXXXXXXXXXXXXXXXXXXXXX-----g-XXXXXXXX
XXXXXXXXXXXXXXXXXXXXXXXXXXXXXXXXXXXXXXXXXXXXXXXXXXXXXXXXXXXXXXXXXXXXXXXXXXXXXXXXXXXXXXXXXXXXXXXXXXXXXXXXXXXXXXXXXXXXXXXXXXXXXXXXXXXXXXXXXXXXXXXXXXXXXXXXXXXXXXXXXXXXXXXXXXXXXXXXXXXXXXXXXXXXXXXXXXXXXXXX

