--------------------------------------------------------------------------------------------------------------------------------------------------------------------------------------------------------
--------------------------------------------------------------------------------------------------------------------------------------------------------------------------------------------------------
--------------------------------------------------------------------------------------------------------------------------------------------------------------------------------------------------------
--------------------------------------------------------------------------------------------------------------------------------------------------------------------------------------------------------
--------------------------------------------------------------------------------------------------------------------------------------------------------------------------------------------------------
--------------------------------------------------------------------------------------------------------------------------------------------------------------------------------------------------------
--------------------------------------------------------------------------------------------------------------------------------------------------------------------------------------------------------
--------------------------------------------------------------------------------------------------------------------------------------------------------------------------------------------------------
--------------------------------------------------------------------------------------------------------------------------------------------------------------------------------------------------------
--------------------------------------------------------------------------------------------------------------------------------------------------------------------------------------------------------
--------------------------------------------------------------------------------------------------------------------------------------------------------------------------------------------------------
--------------------------------------------------------------------------------------------------------------------------------------------------------------------------------------------------------
----------------------------------------oSoSo-----------------------------------------oooo-----------------ooSoooS--------------------------------------------------------------------------------------
--------------------------------------------------ooooSoo----------------------------------------oSo----------------------------------------------------SSoSooo-----------------------------------------
----------------------------------------ooooo------------------------------------------ooo-----------------oooooo-----------------------SSooo---oooo------------------------oSSoSo----------ooSoooo-----
--------------------oSooo--------------------g-----ooooo-----------SoSo----------------g----------------------g----------------------------------------oooooooo-----------------------oo----------------
---------------------------------------XXXXXXXX-----------XX-------------------------XXXXXXX--------------XXXXXXXXXXX------------XXXXX----oo--XXXXXXXX-------g------oo---XX--oooo-----g----oooooo-------
------------XXXX----oooo---------------XXXXXXXXXXXXXXXXXXXXX-----ooooooo-------XXXXXXXXXXXXXXXXXXXXXXXXXXXXXXXXXXXXXX--------XXXXXXXXX--------XXXXXXXXXXXXXXXXXXX--------XX---------XXXXXX--------------
XXXXXXXXXXXXXXXX------------------XXXXXXXXXXXXXXXXXXXXXXXXXX--------------XXXXXXXXXXXXXXXXXXXXXXXXXXXXXXXXXXXXXXXXXXX--------XXXXXXXXXXXXXXXXXXXXXXXXXXXXXXXXXXXXXXXXXXXXXXXXXXXXXXXXXXXXXXXXXXXXXXXX---
XXXXXXXXXXXXXXXXXXXXXXXXXXXXXXXXXXXXXXXXXXXXXXXXXXXXXXXXXXXXXXXXXXXXXXXXXXXXXXXXXXXXXXXXXXXXXXXXXXXXXXXXXXXXXXXXXXXXXXXXXXXXXXXXXXXXXXXXXXXXXXXXXXXXXXXXXXXXXXXXXXXXXXXXXXXXXXXXXXXXXXXXXXXXXXXXXXXXXXXX

