--------------------------------------------------------------------------------------------------------------------------------------------------------------------------------------------------------
--------------------------------------------------------------------------------------------------------------------------------------------------------------------------------------------------------
--------------------------------------------------------------------------------------------------------------------------------------------------------------------------------------------------------
--------------------------------------------------------------------------------------------------------------------------------------------------------------------------------------------------------
--------------------------------------------------------------------------------------------------------------------------------------------------------------------------------------------------------
--------------------------------------------------------------------------------------------------------------------------------------------------------------------------------------------------------
--------------------------------------------------------------------------------------------------------------------------------------------------------------------------------------------------------
--------------------------------------------------------------------------------------------------------------------------------------------------------------------------------------------------------
--------------------------------------------------------------------------------------------------------------------------------------------------------------------------------------------------------
--------------------------------------------------------------------------------------------------------------------------------------------------------------------------------------------------------
--------------------------------------------------------------------------------------------------------------------------------------------------------------------------------------------------------
--------------------------------------------------------------------------------------------------------------------------------------------------------------------------------------------------------
---------------------------------------Soo----ooSoo-----------------------------------------------------------------------------------------------------------------------------------------------------
----------------------------------------------------------------------SooSo-----------ooooooo----------------------------------oooo-------------------------------------------------ooooS---------------
----------------------oooo----oo------ooooo---ooo----------------------------------------------------------oSSoS-------------------------ooSoSoo-----Soo------------------------------------------------
------------------------------g-----------------g-----------------------ooo-----oSo---ooooooo------------------------oSoSS-----ooo---------------------------oSSo--------------------ooo----------------
----------------------oo---XXXXXXXXXXXXXXXXXXXXXXXXX---------------------------------------------ooo-------oooooo----------------------oooooooo----oooo----------------ooooo----------------------------
-----------------------g---XXXXXXXXXXXXXXXXXXXXXXXXX-------ooo--XXXXXXXXXXXXX----ooo-XXXXXXXXXXX------------------------oo--XXXXXXXXXX-----------------------oo--------------------XXXXXXXX---------oo--
XXXXXXXXXXXXXXXX--XXXXXXXXXXXXXXXXXXXXXXXXXXXXXXXXXX------------XXXXXXXXXXXXX--------XXXXXXXXXXXXXXXXXX---XXXXXXXXXX--------XXXXXXXXXXXXXXXXXXXXXXXXXXXXX------g---XXXXXXXXXXXXXXXXXXXXXXXXXXXXXX-------
XXXXXXXXXXXXXXXXXXXXXXXXXXXXXXXXXXXXXXXXXXXXXXXXXXXXXXXXXXXXXXXXXXXXXXXXXXXXXXXXXXXXXXXXXXXXXXXXXXXXXXXXXXXXXXXXXXXXXXXXXXXXXXXXXXXXXXXXXXXXXXXXXXXXXXXXXXXXXXXXXXXXXXXXXXXXXXXXXXXXXXXXXXXXXXXXXXXXXXXX

