--------------------------------------------------------------------------------------------------------------------------------------------------------------------------------------------------------
--------------------------------------------------------------------------------------------------------------------------------------------------------------------------------------------------------
--------------------------------------------------------------------------------------------------------------------------------------------------------------------------------------------------------
--------------------------------------------------------------------------------------------------------------------------------------------------------------------------------------------------------
--------------------------------------------------------------------------------------------------------------------------------------------------------------------------------------------------------
--------------------------------------------------------------------------------------------------------------------------------------------------------------------------------------------------------
--------------------------------------------------------------------------------------------------------------------------------------------------------------------------------------------------------
--------------------------------------------------------------------------------------------------------------------------------------------------------------------------------------------------------
--------------------------------------------------------------------------------------------------------------------------------------------------------------------------------------------------------
--------------------------------------------------------------------------------------------------------------------------------------------------------------------------------------------------------
--------------------------------------------------------------------------------------------------------------------------------------------------------------------------------------------------------
--------------------------------------------------------------------------------------------------------------------------------------------------------------------------------------------------------
---------------------oSooo-----------------------------------------------------------------oSoo--------------------------------------ooooSoo------------------------------------------------------------
------------------------------SoSS---------------ooSo----------------oSS-------------------------------------------------------------------------SSo----oSSSooo-----ooSooSo--------------------oSoo-----
---------------------ooooo---------------------------------------------------------------ooooooo------ooooS----------------oooo-------ooooooo-----------------------------------------------------------
--------------oooS---Yy-------ooooo--ooSo-----------------------oo----oo----------------yrg---Y-----------------oSoSooo---------------k---k--------------oooooo-----oooo--------------------------------
--------------------XXXXXXX-g--------------------R-y----------K--rY--------------------XXXXXXXXXXX-oooooooo-------------------------XXXXXXXXXXX--R---XX--yk--------y-Kkr-rg------------------R---Y------
XXXXXXXXXXX----ooo--XXXXXXXXXXXXXXXX--------XXXXXXXXXX------XXXXXXXXXXXXXXX-oo---------XXXXXXXXXXX--gR---gG---ooooooo-----Rr----XXXXXXXXXXXXXXXXXXXXXXXXXXXXXXXXXXXXXXXXXXXX--kg---oooo-XXXXXXXXXXXX----
XXXXXXXXXXX-rKk-y---XXXXXXXXXXXXXXXX--r-----XXXXXXXXXX--R---XXXXXXXXXXXXXXX-g-y--------XXXXXXXXXXXXXXXXXXXXXX-R-k--yG---XXXXXXXXXXXXXXXXXXXXXXXXXXXXXXXXXXXXXXXXXXXXXXXXXXXXXXXXXX-y----XXXXXXXXXXXXXX--
XXXXXXXXXXXXXXXXXXXXXXXXXXXXXXXXXXXXXXXXXXXXXXXXXXXXXXXXXXXXXXXXXXXXXXXXXXXXXXXXXXXXXXXXXXXXXXXXXXXXXXXXXXXXXXXXXXXXXXXXXXXXXXXXXXXXXXXXXXXXXXXXXXXXXXXXXXXXXXXXXXXXXXXXXXXXXXXXXXXXXXXXXXXXXXXXXXXXXXXX

