--------------------------------------------------------------------------------------------------------------------------------------------------------------------------------------------------------
--------------------------------------------------------------------------------------------------------------------------------------------------------------------------------------------------------
--------------------------------------------------------------------------------------------------------------------------------------------------------------------------------------------------------
--------------------------------------------------------------------------------------------------------------------------------------------------------------------------------------------------------
--------------------------------------------------------------------------------------------------------------------------------------------------------------------------------------------------------
--------------------------------------------------------------------------------------------------------------------------------------------------------------------------------------------------------
--------------------------------------------------------------------------------------------------------------------------------------------------------------------------------------------------------
--------------------------------------------------------------------------------------------------------------------------------------------------------------------------------------------------------
--------------------------------------------------------------------------------------------------------------------------------------------------------------------------------------------------------
--------------------------------------------------------------------------------------------------------------------------------------------------------------------------------------------------------
--------------------------------------------------------------------------------------------------------------------------------------------------------------------------------------------------------
--------------------------------------------------------------------------------------------------------------------------------------------------------------------------------------------------------
-----------------------------------------------------------------------------------ooo------------------------------------------------------------------------------------------------------------------
----------------------------------ooooSooo-------oooSSo----------------oooo----------------oSS--------------oSoSoSoo---------------ooooSo-------------------oSooo-----------------------------oSoSo-----
-------------------------------------------------------------oo---------------------oooo-----------------------------------ooo-----------------Soo-------------------------ooo--------------------------
--------------oSSSoooo---G-G---------ooo----------ooooo------RR------------------------Y-------------oSoSo---oooooooo----------------oo--------------ooo-----ooooo----kk---------oooSooo--------ooo-----
-----------------------XXXXXX-----yk--r--r------------------XXXXXX-----------oooo-XXXXXXXX-g---r---------------K------------oo-----k-K--G---------------------------XXXXXXXXXXXX---------------G----XXXX
XXXXXXXXXXXXX--ooooo---XXXXXX----XXXXXXXXXXXXXXXXXXXXXXXXXXXXXXXXX----XXXXXX------XXXXXXXXXXXXXXX----------XXXXXXXXXXX-----r--r---XXXXXXXXX------------ooo-XXXXXXXXXXXXXXXXXXXXX-oooooo------XXXXXXXXXXX
XXXXXXXXXXXXX-y--R--RK-XXXXXXXXXXXXXXXXXXXXXXXXXXXXXXXXXXXXXXXXXXX--XXXXXXXXXXXXXXXXXXXXXXXXXXXXXXXX--R----XXXXXXXXXXX----XXXXXXXXXXXXXXXXXXXXXXXXX--------XXXXXXXXXXXXXXXXXXXXX-R--K-r--XXXXXXXXXXXXXXX
XXXXXXXXXXXXXXXXXXXXXXXXXXXXXXXXXXXXXXXXXXXXXXXXXXXXXXXXXXXXXXXXXXXXXXXXXXXXXXXXXXXXXXXXXXXXXXXXXXXXXXXXXXXXXXXXXXXXXXXXXXXXXXXXXXXXXXXXXXXXXXXXXXXXXXXXXXXXXXXXXXXXXXXXXXXXXXXXXXXXXXXXXXXXXXXXXXXXXXXX

