--------------------------------------------------------------------------------------------------------------------------------------------------------------------------------------------------------
--------------------------------------------------------------------------------------------------------------------------------------------------------------------------------------------------------
--------------------------------------------------------------------------------------------------------------------------------------------------------------------------------------------------------
--------------------------------------------------------------------------------------------------------------------------------------------------------------------------------------------------------
--------------------------------------------------------------------------------------------------------------------------------------------------------------------------------------------------------
--------------------------------------------------------------------------------------------------------------------------------------------------------------------------------------------------------
--------------------------------------------------------------------------------------------------------------------------------------------------------------------------------------------------------
--------------------------------------------------------------------------------------------------------------------------------------------------------------------------------------------------------
--------------------------------------------------------------------------------------------------------------------------------------------------------------------------------------------------------
--------------------------------------------------------------------------------------------------------------------------------------------------------------------------------------------------------
--------------------------------------------------------------------------------------------------------------------------------------------------------------------------------------------------------
--------------------------------------------------------------------------------------------------------------------------------------------------------------------------------------------------------
--------------------------------------ooo--ooS---------------ooSS---------------------------------------------------------------------------------------------------------------------------------------
--------------------------------------------------------------------------------------------------------oSo------------------oSo------------------------------------SSo---------------------------------
-----------ooS--------------------------------------------oooooooo--oooooo---ooSSoS----------oSoooo-------------------------------------------------oSSoSoSoo------------------------------ooooSSo------
-------------------SSooo-----oooo------------k------------------K-------------------------------------oooooooo----oooS-----oooooo----------------------------------oooo-------ooo-----------------------
--------------------------XX--y-r---XXXXXXXXXXXX-----XXXXXXXXXXXXXX-ooooo-------ooooo--------oooooo--g---yk-r---------------ky-R--------------------oooooo---------Y-Rk----------r-----------oo---------
------------------ooooooo-XXXXXXXXXXXXXXXXXXXXXX-----XXXXXXXXXXXXXX---y-kk-----rY--R---------Gg-Rr--XXXXXXXXXXX---oooo----XXXXXXXXXXX---------ooo---r-k-yk-y-----XXXXXXXXXXXXXXXXXX--gkk-------yK--XXXXX
XXXXXXXXXXXXXXXXX--kg-----XXXXXXXXXXXXXXXXXXXXXX-----XXXXXXXXXXXXXXXXXXXXXXXXXXXXXXXXX-----XXXXXXXXXXXXXXXXXXXX------yYg--XXXXXXXXXXX--XXXXX--gg---XXXXXXXXXXX---XXXXXXXXXXXXXXXXXXXXXXXXXXXXXXXXXXXXXXX
XXXXXXXXXXXXXXXXXXXXXXXXXXXXXXXXXXXXXXXXXXXXXXXXXXXXXXXXXXXXXXXXXXXXXXXXXXXXXXXXXXXXXXXXXXXXXXXXXXXXXXXXXXXXXXXXXXXXXXXXXXXXXXXXXXXXXXXXXXXXXXXXXXXXXXXXXXXXXXXXXXXXXXXXXXXXXXXXXXXXXXXXXXXXXXXXXXXXXXXX

