--------------------------------------------------------------------------------------------------------------------------------------------------------------------------------------------------------
--------------------------------------------------------------------------------------------------------------------------------------------------------------------------------------------------------
--------------------------------------------------------------------------------------------------------------------------------------------------------------------------------------------------------
--------------------------------------------------------------------------------------------------------------------------------------------------------------------------------------------------------
--------------------------------------------------------------------------------------------------------------------------------------------------------------------------------------------------------
--------------------------------------------------------------------------------------------------------------------------------------------------------------------------------------------------------
--------------------------------------------------------------------------------------------------------------------------------------------------------------------------------------------------------
--------------------------------------------------------------------------------------------------------------------------------------------------------------------------------------------------------
--------------------------------------------------------------------------------------------------------------------------------------------------------------------------------------------------------
--------------------------------------------------------------------------------------------------------------------------------------------------------------------------------------------------------
--------------------------------------------------------------------------------------------------------------------------------------------------------------------------------------------------------
--------------------------------------------------------------------------------------------------------------------------------------------------------------------------------------------------------
-----------------------------------ooS--------------------------------------------------------------------------------------SSo-----------------------------ooSoooo------oSSSo--oooo--------------------
-----------------------------------------------------------------------------ooSoS----------------------oSS--------------------------oSoooS-------------------------------------------------------------
-----------------ooooS----ooSoS---oooo------ooS-----------oooooS---------------------------------------------------------------------------------------------ooooooo------ooo---ooo------------oooooS---
----------------------------------kr--K----------------g-------------oSo------ooo--------Soo-----------ooooooo------ooS----k---------oooooo---------oooooo----rk-k-ry------G----------------------------
-----------------oooo------oo----XXXXXXX---oooooo--XXXXXX----oooo--------------r-R--------------XX------y-rrg-------------XXXXXX----y-----r----------k--k--XXXXXXXXXXXXXXXXXXXXXXXXXXXXXXX-------oooooo-
---------------------YY---K---G--XXXXXXX-r--y-y-r--XXXXXX----yG--r-----ooo-XXXXXXXXXX-oooooo----XX--XXXXXXXXXXXXX---------XXXXXX--XXXXXXXXXXXXXX---XXXXXXXXXXXXXXXXXXXXXXXXXXXXXXXXXXXXXXX---------rr-y-
XXXXXXXXXX---XXXXXXXXXXXXXXXXXXXXXXXXXXXXXXXXXXXXXXXXXXXXXXXXXXXXXXX----kr-XXXXXXXXXX-k--K------XX--XXXXXXXXXXXXX--yR---k-XXXXXX--XXXXXXXXXXXXXX---XXXXXXXXXXXXXXXXXXXXXXXXXXXXXXXXXXXXXXX----XXXXXXXXXX
XXXXXXXXXXXXXXXXXXXXXXXXXXXXXXXXXXXXXXXXXXXXXXXXXXXXXXXXXXXXXXXXXXXXXXXXXXXXXXXXXXXXXXXXXXXXXXXXXXXXXXXXXXXXXXXXXXXXXXXXXXXXXXXXXXXXXXXXXXXXXXXXXXXXXXXXXXXXXXXXXXXXXXXXXXXXXXXXXXXXXXXXXXXXXXXXXXXXXXXX

