--------------------------------------------------------------------------------------------------------------------------------------------------------------------------------------------------------
--------------------------------------------------------------------------------------------------------------------------------------------------------------------------------------------------------
--------------------------------------------------------------------------------------------------------------------------------------------------------------------------------------------------------
--------------------------------------------------------------------------------------------------------------------------------------------------------------------------------------------------------
--------------------------------------------------------------------------------------------------------------------------------------------------------------------------------------------------------
--------------------------------------------------------------------------------------------------------------------------------------------------------------------------------------------------------
--------------------------------------------------------------------------------------------------------------------------------------------------------------------------------------------------------
--------------------------------------------------------------------------------------------------------------------------------------------------------------------------------------------------------
--------------------------------------------------------------------------------------------------------------------------------------------------------------------------------------------------------
--------------------------------------------------------------------------------------------------------------------------------------------------------------------------------------------------------
--------------------------------------------------------------------------------------------------------------------------------------------------------------------------------------------------------
--------------------------------------------------------------------------------------------------------------------------------------------------------------------------------------------------------
------------------------------------------------------------ooo---oSSo---------------------------------------------------------------SoSo---------oSSooSo---------------------------Soo-----------------
------------------------------------------------------------------------------------------oSoo----------------------------ooooo-------------------------------ooo---------------------------------------
--------------ooSooS----------------------------------------------------------------------------------------------------------------ooooooo----------oooo-----------------------------------------------
---------------------------------------------------SoSoo----g-Gy--Y--y-----------------y---ooo---ooooS----------ooSo-------ooo-----gkYr----------------r-----oooooo-----------------ygg--------ooooo----
--------------oooooo-----------oo----ooo--y---------------XXXXXXXXXXXXXX-oooo------XXXXXX-r--r------------XXXX--------------g-----XXXXXXXXXXX----XXXXXXXXXXX----r--g------oooo---XXXXXXXX--------Gkk----
XXXXXXXXXXXXX-y-K--y-r--XXXX---------k---XXXXXX------ooo--XXXXXXXXXXXXXX---gr-XXXXXXXXXXXXXXXXXX---oooo---XXXX---ooooo-XXXXXXXXX--XXXXXXXXXXX--XXXXXXXXXXXXXXXXXXXXXXXXXX---kg---XXXXXXXXXXX--XXXXXXXXXX
XXXXXXXXXXXXXXXXXXXXXXXXXXXXXXXXXXXXXXXXXXXXXXX------yg---XXXXXXXXXXXXXXXXXXXXXXXXXXXXXXXXXXXXXX---rkGg-g-XXXX----y--Y-XXXXXXXXX--XXXXXXXXXXX--XXXXXXXXXXXXXXXXXXXXXXXXXXXXXXXXXXXXXXXXXXXXXXXXXXXXXXXXX
XXXXXXXXXXXXXXXXXXXXXXXXXXXXXXXXXXXXXXXXXXXXXXXXXXXXXXXXXXXXXXXXXXXXXXXXXXXXXXXXXXXXXXXXXXXXXXXXXXXXXXXXXXXXXXXXXXXXXXXXXXXXXXXXXXXXXXXXXXXXXXXXXXXXXXXXXXXXXXXXXXXXXXXXXXXXXXXXXXXXXXXXXXXXXXXXXXXXXXXX

