--------------------------------------------------------------------------------------------------------------------------------------------------------------------------------------------------------
--------------------------------------------------------------------------------------------------------------------------------------------------------------------------------------------------------
--------------------------------------------------------------------------------------------------------------------------------------------------------------------------------------------------------
--------------------------------------------------------------------------------------------------------------------------------------------------------------------------------------------------------
--------------------------------------------------------------------------------------------------------------------------------------------------------------------------------------------------------
--------------------------------------------------------------------------------------------------------------------------------------------------------------------------------------------------------
--------------------------------------------------------------------------------------------------------------------------------------------------------------------------------------------------------
--------------------------------------------------------------------------------------------------------------------------------------------------------------------------------------------------------
--------------------------------------------------------------------------------------------------------------------------------------------------------------------------------------------------------
--------------------------------------------------------------------------------------------------------------------------------------------------------------------------------------------------------
--------------------------------------------------------------------------------------------------------------------------------------------------------------------------------------------------------
--------------------------------------------------------------------------------------------------------------------------------------------------------------------------------------------------------
------------------------------------------------------------------------------------Sooo----------------------------------------------------------------------------------------------------------------
--------------------oSoooooo---------------ooSo------------------------------------------------------------oSo-------------------------------------------------oooo-------------------------------------
---------------oo-------------------------------------------------------------------oooooo--ooSoo-------------------------------------ooSoo-------------------------------------------------------------
-----------------y-----ooooo--------------ooooo------------------------------------y-y-gk------------------oo-----ooo---ooSSS------------------ooo--------------oooo------------------------------------
-------------XXXXXX-----K-r----ooo--XXXX-----k----oooo--------------------------XXXXXXXXXXX-ooo----XXXXXX---------r--k--------------ooooo-------K-------------y-----r---------XXXXX---oo--XXXXXXXX----XX
-------------XXXXXXXXXXXXXXXX-ry----XXXXXXXXXXXXX---yR---------r-XXXXX--y-k-----XXXXXXXXXXX---k-y--XXXXXXXXXXXXXXXXXXXX--------XXXX-KgkK-k---XXXXXXXXXXXXXXXXXXXXXXXXXX-------XXXXX-k--Y--XXXXXXXX----XX
XXXXXXXXXXXXXXXXXXXXXXXXXXXXXXXXXXXXXXXXXXXXXXXXXXXXXXX----XXXXXXXXXXXXXXXXXXXXXXXXXXXXXXXXXXXXXXXXXXXXXXXXXXXXXXXXXXXX--k-----XXXXXXXXXXXXXXXXXXXXXXXXXXXXXXXXXXXXXXXXXXXXXXXXXXXXXXXXXXXXXXXXXXXXXXXXX
XXXXXXXXXXXXXXXXXXXXXXXXXXXXXXXXXXXXXXXXXXXXXXXXXXXXXXXXXXXXXXXXXXXXXXXXXXXXXXXXXXXXXXXXXXXXXXXXXXXXXXXXXXXXXXXXXXXXXXXXXXXXXXXXXXXXXXXXXXXXXXXXXXXXXXXXXXXXXXXXXXXXXXXXXXXXXXXXXXXXXXXXXXXXXXXXXXXXXXXX

