--------------------------------------------------------------------------------------------------------------------------------------------------------------------------------------------------------
--------------------------------------------------------------------------------------------------------------------------------------------------------------------------------------------------------
--------------------------------------------------------------------------------------------------------------------------------------------------------------------------------------------------------
--------------------------------------------------------------------------------------------------------------------------------------------------------------------------------------------------------
--------------------------------------------------------------------------------------------------------------------------------------------------------------------------------------------------------
--------------------------------------------------------------------------------------------------------------------------------------------------------------------------------------------------------
--------------------------------------------------------------------------------------------------------------------------------------------------------------------------------------------------------
--------------------------------------------------------------------------------------------------------------------------------------------------------------------------------------------------------
--------------------------------------------------------------------------------------------------------------------------------------------------------------------------------------------------------
--------------------------------------------------------------------------------------------------------------------------------------------------------------------------------------------------------
--------------------------------------------------------------------------------------------------------------------------------------------------------------------------------------------------------
--------------------------------------------------------------------------------------------------------------------------------------------------------------------------------------------------------
-----------------------------------------------------------------Soooooo---------------------------------------------------------------------------------------------------------------oSoSSo-----------
----------------------------------------------------SSoooo------------------------------------------------------------------------------------------------------------------oSoooo-----------------ooo--
---------------------------oooo----------------------------------ooooooo--------------------------------------------------------SSo-----------SoooS--------------------------------------ooo------------
-------------------------------------ooSooo--------ooooo--------------------------SoSSoo---------------ooo---------------------------------------------------------------------ooo-----y---R-r----------
------------------------------------------------------K--------XXXXXXXXXX-----------------XXX----oo----------------------R------oooo--Y-----oooooooo----------------Y-y---------g-K--XXXXXXXXXX-y-------
------------------XXXXX---------XXXX-oooooo-------XXXXXXXXX----XXXXXXXXXX--ooo--oooooooo--XXX-------g---oo-----ooo---XXXXXX---rr-----XXXXXX--g-y--------------XXXXXXXXXXXXXXXXXXXXXXXXXXXXXXXXXXXXXXXXXX
------------------XXXXXXXXXXXXXXXXXX-Gy------XXXXXXXXXXXXXXXXXXXXXXXXXXXX-rkg---gr-R------XXXXXXXXXXXX---kr----------XXXXXXXXXXXXXXXXXXXXXXXXXXXXXXXXX--y-R---XXXXXXXXXXXXXXXXXXXXXXXXXXXXXXXXXXXXXXXXXX
XXXXXXXXXXXXXXXXXXXXXXXXXXXXXXXXXXXXXXXXXXXXXXXXXXXXXXXXXXXXXXXXXXXXXXXXXXXXXXXXXXXXXXXXXXXXXXXXXXXXXXXXXXXXXXXXXXXXXXXXXXXXXXXXXXXXXXXXXXXXXXXXXXXXXXXXXXXXXXXXXXXXXXXXXXXXXXXXXXXXXXXXXXXXXXXXXXXXXXXX

