--------------------------------------------------------------------------------------------------------------------------------------------------------------------------------------------------------
--------------------------------------------------------------------------------------------------------------------------------------------------------------------------------------------------------
--------------------------------------------------------------------------------------------------------------------------------------------------------------------------------------------------------
--------------------------------------------------------------------------------------------------------------------------------------------------------------------------------------------------------
--------------------------------------------------------------------------------------------------------------------------------------------------------------------------------------------------------
--------------------------------------------------------------------------------------------------------------------------------------------------------------------------------------------------------
--------------------------------------------------------------------------------------------------------------------------------------------------------------------------------------------------------
--------------------------------------------------------------------------------------------------------------------------------------------------------------------------------------------------------
--------------------------------------------------------------------------------------------------------------------------------------------------------------------------------------------------------
--------------------------------------------------------------------------------------------------------------------------------------------------------------------------------------------------------
--------------------------------------------------------------------------------------------------------------------------------------------------------------------------------------------------------
--------------------------------------------------------------------------------------------------------------------------------------------------------------------------------------------------------
--------------------------------------------------------------------------------------ooS-----------------------------------------------------------------------------------oSSoo--------------ooo------
--------------------------------------oSSSoo------------------------------------------------------------------------------------------------------------------------------------------------------------
------------------------------------------------SoSS----------ooSoo-------------------ooooo---------------oo-------ooSoo------oSSS------------------------------------ooo-----ooo------------oooooo-----
--------------------------------------ooo--------------------------------------------------------oooo------k-k---------------------------------------ooooS-------------y----Gg--r-------R-----Y--yr-----
--------------oooo-----------gRyry-------------ooooo--XXXXXXX-------------XXXXXXX----XXXXXXXX-----------XXXXXXX-oooooooo------oooooo----------------------------oooo-XXXXXXXXXXXXXXXXXXXXXXXXXXXXXXXXXXX
-------------g---------oooo-XXXXXXXXXXXXXXXXX--r--G---XXXXXXX--G-g--------XXXXXXX----XXXXXXXX---oooo----XXXXXXX---k---G---------RG---XXXX--ooo-------ooooo---r-----y-XXXXXXXXXXXXXXXXXXXXXXXXXXXXXXXXXXX
------------XXXXXXXX---g-RR-XXXXXXXXXXXXXXXXXXXXXXXXXXXXXXXXXXXXXXXX---R--XXXXXXX----XXXXXXXX--y-R-yRk--XXXXXXXXXXXXXXXXX---XXXXXXXXXXXXX--kgr-XXXXX---kk-k-XXXXXXXXXXXXXXXXXXXXXXXXXXXXXXXXXXXXXXXXXXXX
XXXXXXXXXXXXXXXXXXXXXXXXXXXXXXXXXXXXXXXXXXXXXXXXXXXXXXXXXXXXXXXXXXXXXXXXXXXXXXXXXXXXXXXXXXXXXXXXXXXXXXXXXXXXXXXXXXXXXXXXXXXXXXXXXXXXXXXXXXXXXXXXXXXXXXXXXXXXXXXXXXXXXXXXXXXXXXXXXXXXXXXXXXXXXXXXXXXXXXXX

