--------------------------------------------------------------------------------------------------------------------------------------------------------------------------------------------------------
--------------------------------------------------------------------------------------------------------------------------------------------------------------------------------------------------------
--------------------------------------------------------------------------------------------------------------------------------------------------------------------------------------------------------
--------------------------------------------------------------------------------------------------------------------------------------------------------------------------------------------------------
--------------------------------------------------------------------------------------------------------------------------------------------------------------------------------------------------------
--------------------------------------------------------------------------------------------------------------------------------------------------------------------------------------------------------
--------------------------------------------------------------------------------------------------------------------------------------------------------------------------------------------------------
--------------------------------------------------------------------------------------------------------------------------------------------------------------------------------------------------------
--------------------------------------------------------------------------------------------------------------------------------------------------------------------------------------------------------
--------------------------------------------------------------------------------------------------------------------------------------------------------------------------------------------------------
--------------------------------------------------------------------------------------------------------------------------------------------------------------------------------------------------------
--------------------------------------------------------------------------------------------------------------------------------------------------------------------------------------------------------
------------------------------------------ooo---------------------oooooS--------------------------------------------------------------------------------------------------------------------------------
---------------------------------------------------------------------------------------------------------------------------------------------------SSoo-------------------------------------------------
-----------------oooo------------------ooooooooo--oSoSoSS---------oooo--------------------ooo--------------oSoo---------------------------SoSo----------------------oooooo----ooo-----------------------
-----------------kkR--g--------ooSooo-----------------------------gy---y-------ooSSo------------------------------------------------------------ooooooo-------------------------r---Sooooooo----SoSoSoo-
----------------XXXXXXXXXXXXXX--------XXXXXXXXXXX-ooooooooo-----XXXXXXXXXX---------------------------------oooooo----------ooooo----------------r----------r-g------ooo----XXXXXXX----------------------
XXXXXXXXXXXXX---XXXXXXXXXXXXXX--------XXXXXXXXXXX--y-----k------XXXXXXXXXX-----oooo------yk---XXXXXXXXXX----Rk--g-XXXXXXXX---g-g---------------XXXXXXXXXXXXXXXXXX------g---XXXXXXX---ooooooo--oooooo----
XXXXXXXXXXXXX---XXXXXXXXXXXXXX-----r--XXXXXXXXXXXXXXXXXXXXXXXXXXXXXXXXXXXX-----G--Yy--XXXXXXXXXXXXXXXXXXXXXXXXXXXXXXXXXXXXXXXXXXXXX-----XXXXXXXXXXXXXXXXXXXXXXXXXXXXXXXXXXXXXXXXXX-gk-y-yg----rr--------
XXXXXXXXXXXXXXXXXXXXXXXXXXXXXXXXXXXXXXXXXXXXXXXXXXXXXXXXXXXXXXXXXXXXXXXXXXXXXXXXXXXXXXXXXXXXXXXXXXXXXXXXXXXXXXXXXXXXXXXXXXXXXXXXXXXXXXXXXXXXXXXXXXXXXXXXXXXXXXXXXXXXXXXXXXXXXXXXXXXXXXXXXXXXXXXXXXXXXXXX

