--------------------------------------------------------------------------------------------------------------------------------------------------------------------------------------------------------
--------------------------------------------------------------------------------------------------------------------------------------------------------------------------------------------------------
--------------------------------------------------------------------------------------------------------------------------------------------------------------------------------------------------------
--------------------------------------------------------------------------------------------------------------------------------------------------------------------------------------------------------
--------------------------------------------------------------------------------------------------------------------------------------------------------------------------------------------------------
--------------------------------------------------------------------------------------------------------------------------------------------------------------------------------------------------------
--------------------------------------------------------------------------------------------------------------------------------------------------------------------------------------------------------
--------------------------------------------------------------------------------------------------------------------------------------------------------------------------------------------------------
--------------------------------------------------------------------------------------------------------------------------------------------------------------------------------------------------------
--------------------------------------------------------------------------------------------------------------------------------------------------------------------------------------------------------
--------------------------------------------------------------------------------------------------------------------------------------------------------------------------------------------------------
--------------------------------------------------------------------------------------------------------------------------------------------------------------------------------------------------------
------------------------------------------------SoSS----------------------------------------------------------------------------------------------------------------------------------------ooooS-------
------------------------------------------------------------------------ooo----------------------------oSoooo-------------------------------------------------oSoooSoo----------------------------------
-----------------------------ooS--------ooo-----ooooo---------------------------------------------------------------SooSo----------------------------ooS----------------oSooo----oo---------oooooo------
----------------ooooo-------------------------ykr----k------oooooo-----ooo------------oSSooSoo----------ooooooo-----------------oooS---------------------------oooo------------------------kk----k------
XXXXXXXXXXXXXX---------------------XXXXXXXXXXXXXXXXXXXXX----------------Y---XXXX---------------XX---------rg--------ooooo-------------------------------------------r----oooo-XXXXXX-----XXXXXXXXXXX----
XXXXXXXXXXXXXX-oooooo-------G-yY---XXXXXXXXXXXXXXXXXXXXX---oooo-------XXXXXXXXXXXXXXX--ooooo---XX-----XXXXXXXXXXX-R---y-yg----ooooo------ooo---------r-rk---XXXXXXXXXXX-GGgk--XXXXXX-----XXXXXXXXXXX----
XXXXXXXXXXXXXX--yyr--------XXXXXXXXXXXXXXXXXXXXXXXXXXXXX-----ykg-R----XXXXXXXXXXXXXXX--y-----r-XX-----XXXXXXXXXXXXXXXXXXXXXX--g-R---Y---Gk-g-XXXXXXXXXXXXXXXXXXXXXXXXXXXXXXXXXXXXXXX-----XXXXXXXXXXXXX--
XXXXXXXXXXXXXXXXXXXXXXXXXXXXXXXXXXXXXXXXXXXXXXXXXXXXXXXXXXXXXXXXXXXXXXXXXXXXXXXXXXXXXXXXXXXXXXXXXXXXXXXXXXXXXXXXXXXXXXXXXXXXXXXXXXXXXXXXXXXXXXXXXXXXXXXXXXXXXXXXXXXXXXXXXXXXXXXXXXXXXXXXXXXXXXXXXXXXXXXX

