--------------------------------------------------------------------------------------------------------------------------------------------------------------------------------------------------------
--------------------------------------------------------------------------------------------------------------------------------------------------------------------------------------------------------
--------------------------------------------------------------------------------------------------------------------------------------------------------------------------------------------------------
--------------------------------------------------------------------------------------------------------------------------------------------------------------------------------------------------------
--------------------------------------------------------------------------------------------------------------------------------------------------------------------------------------------------------
--------------------------------------------------------------------------------------------------------------------------------------------------------------------------------------------------------
--------------------------------------------------------------------------------------------------------------------------------------------------------------------------------------------------------
--------------------------------------------------------------------------------------------------------------------------------------------------------------------------------------------------------
--------------------------------------------------------------------------------------------------------------------------------------------------------------------------------------------------------
--------------------------------------------------------------------------------------------------------------------------------------------------------------------------------------------------------
--------------------------------------------------------------------------------------------------------------------------------------------------------------------------------------------------------
--------------------------------------------------------------------------------------------------------------------------------------------------------------------------------------------------------
--------------------------------------------oSoSSo------------------------------------------------------------------------------------------------------------------------------------------------------
-------------------------oooS-----------------------------------------------------ooSooooo---------------------------------------------------------ooS--------------------------------------------------
----------------------------------oooo------oooo--------------------------------------------------------------------------------------------------------------------------------------------------------
---------------ooooSo--------------g-kR---k--yg---k--------SooS-------Soo------------ooooo-----oooo---SoSSooo--------------------k-----------------oo--------ooooo------------------oSoo----------------
XXXXXXXXXXXX-------------gy-rr---XXXXXXXXXXXXXXXXXXX------------------------oooo--r--gkRY----------------------------oo-----XXXXXXX----------XXXX--yg--------------------------k------------------------
XXXXXXXXXXXXXX----oo----XXXXXXXXXXXXXXXXXXXXXXXXXXXX-------ooooooo--oooo-----ryg-XXXXXXXXXX----oo-----oooooooo------r-------XXXXXXX---ooooo--XXXXXXXXXXX-------ooooo--------XXXXXX-------XXXXXXXXX--ooo-
XXXXXXXXXXXXXX------G---XXXXXXXXXXXXXXXXXXXXXXXXXXXX-------Yy--------yrk---XXXXXXXXXXXXXXXX----KK-y------g-------XXXXXXXXXXXXXXXXXX-kGr--g---XXXXXXXXXXX----------G------R--XXXXXX-------XXXXXXXXX------
XXXXXXXXXXXXXXXXXXXXXXXXXXXXXXXXXXXXXXXXXXXXXXXXXXXXXXXXXXXXXXXXXXXXXXXXXXXXXXXXXXXXXXXXXXXXXXXXXXXXXXXXXXXXXXXXXXXXXXXXXXXXXXXXXXXXXXXXXXXXXXXXXXXXXXXXXXXXXXXXXXXXXXXXXXXXXXXXXXXXXXXXXXXXXXXXXXXXXXXX

