--------------------------------------------------------------------------------------------------------------------------------------------------------------------------------------------------------
--------------------------------------------------------------------------------------------------------------------------------------------------------------------------------------------------------
--------------------------------------------------------------------------------------------------------------------------------------------------------------------------------------------------------
--------------------------------------------------------------------------------------------------------------------------------------------------------------------------------------------------------
--------------------------------------------------------------------------------------------------------------------------------------------------------------------------------------------------------
--------------------------------------------------------------------------------------------------------------------------------------------------------------------------------------------------------
--------------------------------------------------------------------------------------------------------------------------------------------------------------------------------------------------------
--------------------------------------------------------------------------------------------------------------------------------------------------------------------------------------------------------
--------------------------------------------------------------------------------------------------------------------------------------------------------------------------------------------------------
--------------------------------------------------------------------------------------------------------------------------------------------------------------------------------------------------------
--------------------------------------------------------------------------------------------------------------------------------------------------------------------------------------------------------
--------------------------------------------------------------------------------------------------------------------------------------------------------------------------------------------------------
---------------------------------------------------oooo-----------------------------------------ooSo----oSSooo------------------------------------------------------------------------------------------
------------------------------------------------------------------------------------------------------------------------------------------------------------------------oooo----------------------------
----------------------------------------------------oooo-------------------------------------------------ooooo-----ooSo-------------------------------------SSSS------------------------Soo-------------
------------k-----ooo----------------------ooo---Y---k----------------SooSS----------g-y--------yGy--------RY---------------SSo-----------------------------------------ooooo---ooo---------------------
----------XXXXXX-k----g-XXXXX--ry---------G-----XXXXXXXXX------------------------XXXXXXXXXXXXXXXXXXXXXXXXXXXXXX--oooooooo------------------------------XX-ooooooooo---rY-Gy------------ooo--------------
XXXXXXXXXXXXXXXXXXXXXXXXXXXXXXXXXXX-yKy--XXXXXXXXXXXXXXXXXXXXXXXXXX--oooooo------XXXXXXXXXXXXXXXXXXXXXXXXXXXXXX-r-r----k----ooooo--oooo--XXXX---XXXXXXXXX-r-yr------XXXXXXXXXXXXXXXX------r-------------
XXXXXXXXXXXXXXXXXXXXXXXXXXXXXXXXXXXXXXXXXXXXXXXXXXXXXXXXXXXXXXXXXXX-rkYG--R--XXXXXXXXXXXXXXXXXXXXXXXXXXXXXXXXXXXXXXXXXXXXX----Ry---------XXXXXXXXXXXXXXXXXXXXXXXXXXXXXXXXXXXXXXXXXXXXXXXXXXX-----XXXXX--
XXXXXXXXXXXXXXXXXXXXXXXXXXXXXXXXXXXXXXXXXXXXXXXXXXXXXXXXXXXXXXXXXXXXXXXXXXXXXXXXXXXXXXXXXXXXXXXXXXXXXXXXXXXXXXXXXXXXXXXXXXXXXXXXXXXXXXXXXXXXXXXXXXXXXXXXXXXXXXXXXXXXXXXXXXXXXXXXXXXXXXXXXXXXXXXXXXXXXXXX

