--------------------------------------------------------------------------------------------------------------------------------------------------------------------------------------------------------
--------------------------------------------------------------------------------------------------------------------------------------------------------------------------------------------------------
--------------------------------------------------------------------------------------------------------------------------------------------------------------------------------------------------------
--------------------------------------------------------------------------------------------------------------------------------------------------------------------------------------------------------
--------------------------------------------------------------------------------------------------------------------------------------------------------------------------------------------------------
--------------------------------------------------------------------------------------------------------------------------------------------------------------------------------------------------------
--------------------------------------------------------------------------------------------------------------------------------------------------------------------------------------------------------
--------------------------------------------------------------------------------------------------------------------------------------------------------------------------------------------------------
--------------------------------------------------------------------------------------------------------------------------------------------------------------------------------------------------------
--------------------------------------------------------------------------------------------------------------------------------------------------------------------------------------------------------
--------------------------------------------------------------------------------------------------------------------------------------------------------------------------------------------------------
--------------------------------------------------------------------------------------------------------------------------------------------------------------------------------------------------------
---------------------------------------------------------------------------------------------------------------------------------------------------oSoS-------------------------------------------------
-------------------------------------SSooSo----------------------------------------------SooS------------------------------------------oSoSS------------------------------------------------------------
------------oooSoo--------------------------------------------------------------SoS--------------------------------oo-----------------------------ooooo------ooS----------------------------------------
---------------------------oooo----oooooooo-------SoSoo----------oooSSoo------------------ooooo----------Soo-----rg--r--------------------ooo------------------------------ooSoooSo--------------oSoS---
-------------oooooo-----------r----G-GG-GRg-XXX------------------------------------------gky-------------------XXXXXXXX--XX-------------kk---k-XXXXXXXXXX--ooo-----------------------------------------X
-------------k-------XXXXXXXXXXX--XXXXXXXXXXXXX--oooooooo-XX-------ooo--------------r-XXXXXXXXXXXX-------oooo--XXXXXXXX--XXXXXXX-g-k--XXXXXXXXXXXXXXXXXXX-y--Yk---XXXXXXX----oooooo-XXXX---------ooooo-X
-----------XXXXXXXXXXXXXXXXXXXXXXXXXXXXXXXXXXXX-K-k--Y-yy-XX------g--r---XXXXXXXXXXXXXXXXXXXXXXXXX--------k-Yk-XXXXXXXX--XXXXXXXXXXXXXXXXXXXXXXXXXXXXXXXXXXXXXXXXXXXXXXXX-ky-----kr-XXXX---XX-rkr------X
XXXXXXXXXXXXXXXXXXXXXXXXXXXXXXXXXXXXXXXXXXXXXXXXXXXXXXXXXXXXXXXXXXXXXXXXXXXXXXXXXXXXXXXXXXXXXXXXXXXXXXXXXXXXXXXXXXXXXXXXXXXXXXXXXXXXXXXXXXXXXXXXXXXXXXXXXXXXXXXXXXXXXXXXXXXXXXXXXXXXXXXXXXXXXXXXXXXXXXXX

