--------------------------------------------------------------------------------------------------------------------------------------------------------------------------------------------------------
--------------------------------------------------------------------------------------------------------------------------------------------------------------------------------------------------------
--------------------------------------------------------------------------------------------------------------------------------------------------------------------------------------------------------
--------------------------------------------------------------------------------------------------------------------------------------------------------------------------------------------------------
--------------------------------------------------------------------------------------------------------------------------------------------------------------------------------------------------------
--------------------------------------------------------------------------------------------------------------------------------------------------------------------------------------------------------
--------------------------------------------------------------------------------------------------------------------------------------------------------------------------------------------------------
--------------------------------------------------------------------------------------------------------------------------------------------------------------------------------------------------------
--------------------------------------------------------------------------------------------------------------------------------------------------------------------------------------------------------
--------------------------------------------------------------------------------------------------------------------------------------------------------------------------------------------------------
--------------------------------------------------------------------------------------------------------------------------------------------------------------------------------------------------------
--------------------------------------------------------------------------------------------------------------------------------------------------------------------------------------------------------
--------------------------------------------------------------------------------------------------------------------------------------------------------------------------------------------------------
---------------Sooo--------oooo----------------------------------------------------------------------------------------------------------------Soo------------------------------------------------------
---------------------------------------------------------SSooS-----------------------------------------------------ooo--oSoSo---------------------------------------------------------------------------
---------------oooo---------------ooS------Y-----------------------Sooooo---------------------------------------------------------gry-g--------oo---------yr-K--ooooSo----------oSoo----oooo------------
----------------gGy---------gg----------XXXXXXXXXXX-------ooo---------------XXX-----XXXX----oo--------------------------oooo--XXXXXXXXXXX------K-------g-XXXXXX---------------------------k-------------
------------XXXXXXXXXXX---XXXXXX--ooooo-XXXXXXXXXXXXXX-g-r--krr------ooooo--XXX-----XXXX-----------ooooo-------------y------G-XXXXXXXXXXX----XXXXXXXXXXXXXXXXXX--------XXXXXX-ooooooo-XXXXXXXXX------XXX
------------XXXXXXXXXXXXXXXXXXXX-----y--XXXXXXXXXXXXXXXXXXXXXXXXX-RKk--g----XXX-----XXXXXXXXXXXX-R--ky-----------XXXXXXXXXXXXXXXXXXXXXXXXXXXXXXXXXXXXXXXXXXXXXX---r-y--XXXXXX--kyyk-y-XXXXXXXXX----XXXXX
XXXXXXXXXXXXXXXXXXXXXXXXXXXXXXXXXXXXXXXXXXXXXXXXXXXXXXXXXXXXXXXXXXXXXXXXXXXXXXXXXXXXXXXXXXXXXXXXXXXXXXXXXXXXXXXXXXXXXXXXXXXXXXXXXXXXXXXXXXXXXXXXXXXXXXXXXXXXXXXXXXXXXXXXXXXXXXXXXXXXXXXXXXXXXXXXXXXXXXXX

