--------------------------------------------------------------------------------------------------------------------------------------------------------------------------------------------------------
--------------------------------------------------------------------------------------------------------------------------------------------------------------------------------------------------------
--------------------------------------------------------------------------------------------------------------------------------------------------------------------------------------------------------
--------------------------------------------------------------------------------------------------------------------------------------------------------------------------------------------------------
--------------------------------------------------------------------------------------------------------------------------------------------------------------------------------------------------------
--------------------------------------------------------------------------------------------------------------------------------------------------------------------------------------------------------
--------------------------------------------------------------------------------------------------------------------------------------------------------------------------------------------------------
--------------------------------------------------------------------------------------------------------------------------------------------------------------------------------------------------------
--------------------------------------------------------------------------------------------------------------------------------------------------------------------------------------------------------
--------------------------------------------------------------------------------------------------------------------------------------------------------------------------------------------------------
--------------------------------------------------------------------------------------------------------------------------------------------------------------------------------------------------------
--------------------------------------------------------------------------------------------------------------------------------------------------------------------------------------------------------
---------------------------------------------------------------------------------------------------------SoS---------------------------SSoSo------------------------------------------------------------
-----------------------------------------------------------------------------------ooS---------------------------------------------------------------------oooS-----------------------------------------
------------------------oooSo----SoSo--------------oo---------ooSSo-----------------------------------------------------------ooo-----oooooo---ooooo----------------------------------------------------
---------------r--------------------------ooooo---Rk----------------------------------ooo-----SoSSo----yR--k----------oooo-------------y-kY-g---y-r--------oooooo---ooo-----------------ooo-------------
XXXXXXXXXXXXXXXXXXXXX---oo-----ooooooo---kg---g-XXXXXX---------oooooo-----------------Kg--XX---------XXXXXXXXX---ooo----------ooooo--XXXXXXXXXXXXXXXXXXXX-ry--krK----g------------ooo-------------------
XXXXXXXXXXXXXXXXXXXXX----r-----ryK--rgY-XXXXXXXXXXXXXXXX-----gyK---Y--XXX-----XXXXXXXXXXXXXX--oooo---XXXXXXXXX--R-----ooo--------rry-XXXXXXXXXXXXXXXXXXXXXXXXXXXXXXXXXXXX---XXXX---K----ooo-------------
XXXXXXXXXXXXXXXXXXXXXXXXXXXXXXXXXXXXXXXXXXXXXXXXXXXXXXXX---XXXXXXXXXXXXXX-----XXXXXXXXXXXXXX-r--k--g-XXXXXXXXXXXXXXXX------XXXXXXXXXXXXXXXXXXXXXXXXXXXXXXXXXXXXXXXXXXXXXXXXXXXXXXXXXXXX-g---------------
XXXXXXXXXXXXXXXXXXXXXXXXXXXXXXXXXXXXXXXXXXXXXXXXXXXXXXXXXXXXXXXXXXXXXXXXXXXXXXXXXXXXXXXXXXXXXXXXXXXXXXXXXXXXXXXXXXXXXXXXXXXXXXXXXXXXXXXXXXXXXXXXXXXXXXXXXXXXXXXXXXXXXXXXXXXXXXXXXXXXXXXXXXXXXXXXX---XXXX

