--------------------------------------------------------------------------------------------------------------------------------------------------------------------------------------------------------
--------------------------------------------------------------------------------------------------------------------------------------------------------------------------------------------------------
--------------------------------------------------------------------------------------------------------------------------------------------------------------------------------------------------------
--------------------------------------------------------------------------------------------------------------------------------------------------------------------------------------------------------
--------------------------------------------------------------------------------------------------------------------------------------------------------------------------------------------------------
--------------------------------------------------------------------------------------------------------------------------------------------------------------------------------------------------------
--------------------------------------------------------------------------------------------------------------------------------------------------------------------------------------------------------
--------------------------------------------------------------------------------------------------------------------------------------------------------------------------------------------------------
--------------------------------------------------------------------------------------------------------------------------------------------------------------------------------------------------------
--------------------------------------------------------------------------------------------------------------------------------------------------------------------------------------------------------
--------------------------------------------------------------------------------------------------------------------------------------------------------------------------------------------------------
--------------------------------------------------------------------------------------------------------------------------------------------------------------------------------------------------------
--------------------------------------------------------------------------------------------------oooo---------oSSoo---------------Soo------------------------------------------------------------------
------------------------------------------------------------------------------------------------------------------------------------------------------------------------------------------------oooSo---
---------------------------------------------Soo-------------------------------------------------ooo--------ooooooo------Soooo---oo-----------oooooo----------Sooooo------------------------------------
----------------------------------------------------SoSS-----------------------------------k---------R--------Y------------------yK-gk--------------------------------oSSSo--------ooSo---------ooooooo-
------------XXX-----------------------------oo----------------------------XXXXX--------XXXXXX--XXXXXXXX----XXXXXXXXXX-oooooooo-XXXXXXXX------oooooooo-------ooooooo-----------------------------k--g----
------------XXXXXXXXXXXXXXXX-------oooooo------g----ooooo-----------ooo---XXXXX--------XXXXXX--XXXXXXXXXXXXXXXXXXXXXX-----R--K-XXXXXXXXXX---gg------r-------------gr---oooo-------ooooooo----XXXXXXXXXXX
------------XXXXXXXXXXXXXXXX---g---Y--ry--XXXXXXX--R-y-----r---------y----XXXXX---g--XXXXXXXX--XXXXXXXXXXXXXXXXXXXXXXXXXXXXXXXXXXXXXXXXXX--XXXXXXXXXXX----XXXXXXXXXXX-----r------r-yg--g--XXXXXXXXXXXXXX
XXXXXXXXXXXXXXXXXXXXXXXXXXXXXXXXXXXXXXXXXXXXXXXXXXXXXXXXXXXXXXXXXXXXXXXXXXXXXXXXXXXXXXXXXXXXXXXXXXXXXXXXXXXXXXXXXXXXXXXXXXXXXXXXXXXXXXXXXXXXXXXXXXXXXXXXXXXXXXXXXXXXXXXXXXXXXXXXXXXXXXXXXXXXXXXXXXXXXXXX

