--------------------------------------------------------------------------------------------------------------------------------------------------------------------------------------------------------
--------------------------------------------------------------------------------------------------------------------------------------------------------------------------------------------------------
--------------------------------------------------------------------------------------------------------------------------------------------------------------------------------------------------------
--------------------------------------------------------------------------------------------------------------------------------------------------------------------------------------------------------
--------------------------------------------------------------------------------------------------------------------------------------------------------------------------------------------------------
--------------------------------------------------------------------------------------------------------------------------------------------------------------------------------------------------------
--------------------------------------------------------------------------------------------------------------------------------------------------------------------------------------------------------
--------------------------------------------------------------------------------------------------------------------------------------------------------------------------------------------------------
--------------------------------------------------------------------------------------------------------------------------------------------------------------------------------------------------------
--------------------------------------------------------------------------------------------------------------------------------------------------------------------------------------------------------
--------------------------------------------------------------------------------------------------------------------------------------------------------------------------------------------------------
--------------------------------------------------------------------------------------------------------------------------------------------------------------------------------------------------------
------------------------------------------------------ooSo---------------------------------------------------------------------------------------------------------------oSoSoSo---------ooo------------
-------------------------------------------------------------oSSooSo---------------------------------------oSooooooo------------------------------------------------------------------------------------
---------------------------oo---oSSooo-----------------oooo--------------------------oooo---------------------------------------ooooSo----Soo-------------------oSSSSo-----ooooo-------oo---------------
------------------------Y-----------------oooSS------k-r------oooooo--oooo-----------------ooSo--------------ooooo-----ooo--------------------------Soo--------------------yY-r-r------K---k------------
XXXXXXXXXXXXXX---------XXXXXXXX--ooo---------------XXXXXXXXX---R---y-----k-----------oooo---------------------y-y------Rk-k----oooooo----oooooo-------------------oooo--XXXXXXXXXX---XXXXXXXX-------XXXX
XXXXXXXXXXXXXX---------XXXXXXXX-y-----------ooooo--XXXXXXXXXXXXXXXXXXXXXXXXX-oooooo----kr-----------G-----XXXXXXXXXXXXXXXXXXX--r---rY----ry-r-----oooo----------y-----y-XXXXXXXXXX---XXXXXXXX--ooo--XXXX
XXXXXXXXXXXXXXXXXXXXXXXXXXXXXXXXXXXXXXXXX--g-y-----XXXXXXXXXXXXXXXXXXXXXXXXX-----y--XXXXXX--krk-XXXXXXXXXXXXXXXXXXXXXXXXXXXXXXXXXXXXXXXXXXXXXXXXX---k--rr-XXXXXXXXXXXXXXXXXXXXXXXXXXXXXXXXXXX-g--kR-XXXX
XXXXXXXXXXXXXXXXXXXXXXXXXXXXXXXXXXXXXXXXXXXXXXXXXXXXXXXXXXXXXXXXXXXXXXXXXXXXXXXXXXXXXXXXXXXXXXXXXXXXXXXXXXXXXXXXXXXXXXXXXXXXXXXXXXXXXXXXXXXXXXXXXXXXXXXXXXXXXXXXXXXXXXXXXXXXXXXXXXXXXXXXXXXXXXXXXXXXXXXX

