--------------------------------------------------------------------------------------------------------------------------------------------------------------------------------------------------------
--------------------------------------------------------------------------------------------------------------------------------------------------------------------------------------------------------
--------------------------------------------------------------------------------------------------------------------------------------------------------------------------------------------------------
--------------------------------------------------------------------------------------------------------------------------------------------------------------------------------------------------------
--------------------------------------------------------------------------------------------------------------------------------------------------------------------------------------------------------
--------------------------------------------------------------------------------------------------------------------------------------------------------------------------------------------------------
--------------------------------------------------------------------------------------------------------------------------------------------------------------------------------------------------------
--------------------------------------------------------------------------------------------------------------------------------------------------------------------------------------------------------
--------------------------------------------------------------------------------------------------------------------------------------------------------------------------------------------------------
--------------------------------------------------------------------------------------------------------------------------------------------------------------------------------------------------------
--------------------------------------------------------------------------------------------------------------------------------------------------------------------------------------------------------
--------------------------------------------------------------------------------------------------------------------------------------------------------------------------------------------------------
---------------------------------------------------------------------------------------ooS----SSo-----oSoSo-------------------------------------------------------------oooSS---------------------------
------------------------SSSo------------ooooo----------------ooo---------------------------------------------------------------------------------oSooooSo-----------------------------------------------
----------------------------------------------------------------------------------------------ooooo---ooooo-----------------------oo-----------------------------------ooooooo-------------ooSSoSo------
-----------------ooo--ooooooo---oSooo--------------oooooooo---oo------------------------Yr---K-------rKk-k-----------ooSo----------yG-k------gY---ooooo------------------k-------ooo--------------------
XXXXXXXXXXX-------r---y-------------------Rr--XXX--------------y-yG-XXXXXXXXXX--------XXXXXXXXXXXXXXXXXXXXXX---XXXXX------------XXXXXXXXXXXXXXXX-kkkR---Rr-XXXX--Tt---XXXXXXXXXX------------ooooo-------
XXXXXXXXXXX----XXXXXXXXXXXXXXX---oooo--XXXXXXXXXX----ooo----XXXXXXXXXXXXXXXXXX-Kk-y---XXXXXXXXXXXXXXXXXXXXXX---XXXXX-oooo---XXXXXXXXXXXXXXXXXXXXXXXXXXXXXXXXXXX--Tt---XXXXXXXXXX---ooo----------Y-------
XXXXXXXXXXXXXXXXXXXXXXXXXXXXXX-ryykY---XXXXXXXXXX------k----XXXXXXXXXXXXXXXXXXXXXXXX--XXXXXXXXXXXXXXXXXXXXXX---XXXXX--Y--k--XXXXXXXXXXXXXXXXXXXXXXXXXXXXXXXXXXX--Tt---XXXXXXXXXX-RRk-y--XXXXXXXXXXX-----
XXXXXXXXXXXXXXXXXXXXXXXXXXXXXXXXXXXXXXXXXXXXXXXXXXXXXXXXXXXXXXXXXXXXXXXXXXXXXXXXXXXXXXXXXXXXXXXXXXXXXXXXXXXXXXXXXXXXXXXXXXXXXXXXXXXXXXXXXXXXXXXXXXXXXXXXXXXXXXXXXXXXXXXXXXXXXXXXXXXXXXXXXXXXXXXXXXXXXXXX

