--------------------------------------------------------------------------------------------------------------------------------------------------------------------------------------------------------
--------------------------------------------------------------------------------------------------------------------------------------------------------------------------------------------------------
--------------------------------------------------------------------------------------------------------------------------------------------------------------------------------------------------------
--------------------------------------------------------------------------------------------------------------------------------------------------------------------------------------------------------
--------------------------------------------------------------------------------------------------------------------------------------------------------------------------------------------------------
--------------------------------------------------------------------------------------------------------------------------------------------------------------------------------------------------------
--------------------------------------------------------------------------------------------------------------------------------------------------------------------------------------------------------
--------------------------------------------------------------------------------------------------------------------------------------------------------------------------------------------------------
--------------------------------------------------------------------------------------------------------------------------------------------------------------------------------------------------------
--------------------------------------------------------------------------------------------------------------------------------------------------------------------------------------------------------
--------------------------------------------------------------------------------------------------------------------------------------------------------------------------------------------------------
--------------------------------------------------------------------------------------------------------------------------------------------------------------------------------------------------------
----------------------------------------------oooo------------------------------------------------------------------------------------------------------------ooooS----------------------oSooo----------
------------------------------------------------------------------SSo-----------------------------------------------------------------SSoo--------------------------------------------------------------
--------------------------------------------ooooooo----------------------------------------------------------------------------------------------------ooo---oooo----------------ooooo--ooooooo---------
----------------------------------Soo---------r-------ooooo---------------------------oo-------------------------ooSoo-------------ooooooo------------------k--R---k---oooo--------g----kk---y----oSSo--
XXXXXXXXXXXXX--GGr----XXXXX---------------XXXXXXXXXX------------k--------------XXXX----Y-------XX-----------------------XX---------r-k--y--XXX-------oooo--XXXXXXXXXX----------XXXXXXXXXXXXXXXXXX------X
XXXXXXXXXXXXXXXXXXXXXXXXXXXXXXX----ooo----XXXXXXXXXX---oooooo--XXXXXXXXXXX-----XXXXXXXXXXXXXX--XX---XXXX------ooooooo---XX--oooo--XXXXXXXXXXXX--XXXX---rr--XXXXXXXXXXXXXXXXXXXXXXXXXXXXXXXXXXXXXX------X
XXXXXXXXXXXXXXXXXXXXXXXXXXXXXXX---g----XXXXXXXXXXXXX----Gr--y--XXXXXXXXXXXXXXXXXXXXXXXXXXXXXX--XXXXXXXXXXXXXX--------kr-XX-y------XXXXXXXXXXXXXXXXXXXXXXXXXXXXXXXXXXXXXXXXXXXXXXXXXXXXXXXXXXXXXXX--Ry--X
XXXXXXXXXXXXXXXXXXXXXXXXXXXXXXXXXXXXXXXXXXXXXXXXXXXXXXXXXXXXXXXXXXXXXXXXXXXXXXXXXXXXXXXXXXXXXXXXXXXXXXXXXXXXXXXXXXXXXXXXXXXXXXXXXXXXXXXXXXXXXXXXXXXXXXXXXXXXXXXXXXXXXXXXXXXXXXXXXXXXXXXXXXXXXXXXXXXXXXXX

