--------------------------------------------------------------------------------------------------------------------------------------------------------------------------------------------------------
--------------------------------------------------------------------------------------------------------------------------------------------------------------------------------------------------------
--------------------------------------------------------------------------------------------------------------------------------------------------------------------------------------------------------
--------------------------------------------------------------------------------------------------------------------------------------------------------------------------------------------------------
--------------------------------------------------------------------------------------------------------------------------------------------------------------------------------------------------------
--------------------------------------------------------------------------------------------------------------------------------------------------------------------------------------------------------
--------------------------------------------------------------------------------------------------------------------------------------------------------------------------------------------------------
--------------------------------------------------------------------------------------------------------------------------------------------------------------------------------------------------------
--------------------------------------------------------------------------------------------------------------------------------------------------------------------------------------------------------
--------------------------------------------------------------------------------------------------------------------------------------------------------------------------------------------------------
--------------------------------------------------------------------------------------------------------------------------------------------------------------------------------------------------------
--------------------------------------------------------------------------------------------------------------------------------------------------------------------------------------------------------
--------------ooS----------------------------------------------------------------------------------------------------------------------------------------------------------Soo--------------------------
-------------------------------------------------------------------------------------------SSoSoo--------------------------------------------------oSooo------------------------------------------------
--------------oooo-----------oSooooo-------------------------------------------oSSSooo---------------------------------------------------oSSoo----------------------------ooo---------------------------
------------kG--Y-Y----ooS------------------------------------------------Soo------------oooooooo--ooooS-----Y----ooo-------------oooo----------oooooooo------------------K-------oSoSSoo---------------
-----------XXXXXXXXX---------ooooooo------XXXXX--------------ooooo----------------ooo---K-----k-y---------XXXXXX------------------g-----oooo--------k-----XX-------------XXXXXXXX-----------------------
-----------XXXXXXXXX-ooo------R--yygky----XXXXX----------------ky----------------k-----XXXXXXXXXXX----oo--XXXXXX-oooo------oooo-XXXXXXX----rr--XXXXXXXXXXXXX-------XXXXXXXXXXXXXX--ooooooo--------------
XXXXXXXXXXXXXXXXXXXX---k----XXXXXXXXXXX---XXXXX------------XXXXXXXX----r-g----XXXXXXXXXXXXXXXXXXXX--------XXXXXX-yrGG-r-------k-XXXXXXXXXXXXXXXXXXXXXXXXXXXXXX--XXXXXXXXXXXXXXXXX-kk--y-------------XXXX
XXXXXXXXXXXXXXXXXXXXXXXXXXXXXXXXXXXXXXXXXXXXXXXXXXXXXXXXXXXXXXXXXXXXXXXXXXXXXXXXXXXXXXXXXXXXXXXXXXXXXXXXXXXXXXXXXXXXXXXXXXXXXXXXXXXXXXXXXXXXXXXXXXXXXXXXXXXXXXXXXXXXXXXXXXXXXXXXXXXXXXXXXXXXXXXXXXXXXXXX

