--------------------------------------------------------------------------------------------------------------------------------------------------------------------------------------------------------
--------------------------------------------------------------------------------------------------------------------------------------------------------------------------------------------------------
--------------------------------------------------------------------------------------------------------------------------------------------------------------------------------------------------------
--------------------------------------------------------------------------------------------------------------------------------------------------------------------------------------------------------
--------------------------------------------------------------------------------------------------------------------------------------------------------------------------------------------------------
--------------------------------------------------------------------------------------------------------------------------------------------------------------------------------------------------------
--------------------------------------------------------------------------------------------------------------------------------------------------------------------------------------------------------
--------------------------------------------------------------------------------------------------------------------------------------------------------------------------------------------------------
--------------------------------------------------------------------------------------------------------------------------------------------------------------------------------------------------------
--------------------------------------------------------------------------------------------------------------------------------------------------------------------------------------------------------
--------------------------------------------------------------------------------------------------------------------------------------------------------------------------------------------------------
--------------------------------------------------------------------------------------------------------------------------------------------------------------------------------------------------------
-------------------------------------------------------------------------------------------------------oSo---------------------------------Sooo---------------------------------------------------------
---------------------------------------------------------------------------------------------------------------------------------------------------SSSooSo------------------------------------ooooooS---
-------------------------------------------------------------oo---------------------------------------ooo--------oSooo--------------------oooooo--------------------------------------------------------
--------------------------ooo-----------oooo---------oSooo----------oSooo-----------------------------k---------------------r------------------g-----oooooo-------------------------------------ooooooo-
-----------------------------------------------------------XXXXXXX----------------------XXXX---------XXXXXXXX-ooooooooo-XXXXXX---------XXXXXXXXXX-kr-y---r--------y---------XXXX----XXXXXXXXX---y---R---
XXXXXXXXXXXXXX---------ooooo---XXXXXXXX--oo-----------oo---XXXXXXX---ooooo--XXX---oooo--XXXX----XXXXXXXXXXXXX--y-g---Y--XXXXXX---------XXXXXXXXXXXXXXXXXXXXX---XXXXXX---XXXXXXXX----XXXXXXXXXXXXXXXXXXXX
XXXXXXXXXXXXXX---rkG---Y---k---XXXXXXXX--y-----XXX---y-g---XXXXXXX------r---XXXXX-yk-r--XXXX----XXXXXXXXXXXXXXXXXXXXXXXXXXXXXX---------XXXXXXXXXXXXXXXXXXXXX---XXXXXX---XXXXXXXX----XXXXXXXXXXXXXXXXXXXX
XXXXXXXXXXXXXXXXXXXXXXXXXXXXXXXXXXXXXXXXXXXXXXXXXXXXXXXXXXXXXXXXXXXXXXXXXXXXXXXXXXXXXXXXXXXXXXXXXXXXXXXXXXXXXXXXXXXXXXXXXXXXXXXXXXXXXXXXXXXXXXXXXXXXXXXXXXXXXXXXXXXXXXXXXXXXXXXXXXXXXXXXXXXXXXXXXXXXXXXX

