--------------------------------------------------------------------------------------------------------------------------------------------------------------------------------------------------------
--------------------------------------------------------------------------------------------------------------------------------------------------------------------------------------------------------
--------------------------------------------------------------------------------------------------------------------------------------------------------------------------------------------------------
--------------------------------------------------------------------------------------------------------------------------------------------------------------------------------------------------------
--------------------------------------------------------------------------------------------------------------------------------------------------------------------------------------------------------
--------------------------------------------------------------------------------------------------------------------------------------------------------------------------------------------------------
--------------------------------------------------------------------------------------------------------------------------------------------------------------------------------------------------------
--------------------------------------------------------------------------------------------------------------------------------------------------------------------------------------------------------
--------------------------------------------------------------------------------------------------------------------------------------------------------------------------------------------------------
--------------------------------------------------------------------------------------------------------------------------------------------------------------------------------------------------------
--------------------------------------------------------------------------------------------------------------------------------------------------------------------------------------------------------
--------------------------------------------------------------------------------------------------------------------------------------------------------------------------------------------------------
---------------------------------------------ooS-------------------------------------------------------------ooSoo----------------------------------------------------------------------------oooS------
-----------------------------------ooo--------------oSSo----------oooSooSo------------------------------------------------------------------------------------------------oSSo--------------------------
-------------------SSo-----ooSSo----------oooooo------------------------------------ooo-------------------------oo-----ooS-------------------------------------------------------------------ooooooo----
----------------------------------oooooo----k------oooooo------------ooo--------------Y-----------ooo----------k-K--------------ooSoSoo------------oSo------kg-yr----------oooo-----Soooo----YR--y------
-----------------ooooooo-----------------XXXXXXXXX-----r----------rR-y-R--------XXXXXXXXXX------------------XXXXXXX----oooo--------------------------------XXXXXXXXXXXX---Y---g------------XXXXXXXXXXX--
XXXXXXXXXXXXXXXX-K---------gr-G--XXXXXXXXXXXXXXXXXXXXXXXXXXX-----XXXXXXXXXXXXXXXXXXXXXXXXXXXXXXXX-oooo--XXXXXXXXXXXXX-K-----K--oooooo--------------ooo--XXXXXXXXXXXXXXXXXXXXXXXX--oooooooo-XXXXXXXXXXX--
XXXXXXXXXXXXXXXXXXXXXXXXXXXXXXXXXXXXXXXXXXXXXXXXXXXXXXXXXXXXXXXXXXXXXXXXXXXXXXXXXXXXXXXXXXXXXXXXX-----r-XXXXXXXXXXXXXXXXXXXXXX-------y---------------RY-XXXXXXXXXXXXXXXXXXXXXXXX-R---g--K--XXXXXXXXXXX--
XXXXXXXXXXXXXXXXXXXXXXXXXXXXXXXXXXXXXXXXXXXXXXXXXXXXXXXXXXXXXXXXXXXXXXXXXXXXXXXXXXXXXXXXXXXXXXXXXXXXXXXXXXXXXXXXXXXXXXXXXXXXXXXXXXXXXXXXXXXXXXXXXXXXXXXXXXXXXXXXXXXXXXXXXXXXXXXXXXXXXXXXXXXXXXXXXXXXXXXX

