--------------------------------------------------------------------------------------------------------------------------------------------------------------------------------------------------------
--------------------------------------------------------------------------------------------------------------------------------------------------------------------------------------------------------
--------------------------------------------------------------------------------------------------------------------------------------------------------------------------------------------------------
--------------------------------------------------------------------------------------------------------------------------------------------------------------------------------------------------------
--------------------------------------------------------------------------------------------------------------------------------------------------------------------------------------------------------
--------------------------------------------------------------------------------------------------------------------------------------------------------------------------------------------------------
--------------------------------------------------------------------------------------------------------------------------------------------------------------------------------------------------------
--------------------------------------------------------------------------------------------------------------------------------------------------------------------------------------------------------
--------------------------------------------------------------------------------------------------------------------------------------------------------------------------------------------------------
--------------------------------------------------------------------------------------------------------------------------------------------------------------------------------------------------------
--------------------------------------------------------------------------------------------------------------------------------------------------------------------------------------------------------
--------------------------------------------------------------------------------------------------------------------------------------------------------------------------------------------------------
--------------------------------------------------------------------------------------------ooo------------------SSoo-----------------------------------------------------------------------------------
----------------------oSo---------------------------------------------------------------------------------------------------------------------------------------------------------------oSSooo----------
-------------------------------------------------oSoSoSo----SoooSS------------------------------------------------ooo-----oSoSoo------------------------ooo---------------------------------------------
--------------------ooooo---------------------------------------------------oo------oo-----rGg--k----------------k-k-G--------------ooo---------oSoS-------------------oSo----------------ooooo---------
-------------------R--g---------XXXXXX----XXXX-oooooo-----ooooooooo---------Gk------gk---XXXXXXXXX---------XXXXXXXXXXXX--ooooooo----KYG-----------------oooooo---oo----------------------yr-------------
-----------kG-g---XXXXXXXXXX----XXXXXXXXXXXXXX---g--k--g-------R-g--------XXXXXXXXXXXXXXXXXXXXXXXX---------XXXXXXXXXXXX-g----G----XXXXXX---------oo-----g---------r-K------------------XXXXXXXXXXX------
----------XXXXXXXXXXXXXXXXXX----XXXXXXXXXXXXXXXXXXXXXXXXXXXXXXXXXXXX-g--y-XXXXXXXXXXXXXXXXXXXXXXXXXXXXXXXXXXXXXXXXXXXXXXXXXXXXXXXXXXXXXXXXX------K---K-XXXXXXXXXXXXXXX-y-r--XX-----XXXXXXXXXXXXXXX-Y----
XXXXXXXXXXXXXXXXXXXXXXXXXXXXXXXXXXXXXXXXXXXXXXXXXXXXXXXXXXXXXXXXXXXXXXXXXXXXXXXXXXXXXXXXXXXXXXXXXXXXXXXXXXXXXXXXXXXXXXXXXXXXXXXXXXXXXXXXXXXXXXXXXXXXXXXXXXXXXXXXXXXXXXXXXXXXXXXXXXXXXXXXXXXXXXXXXXXXXXXX

