--------------------------------------------------------------------------------------------------------------------------------------------------------------------------------------------------------
--------------------------------------------------------------------------------------------------------------------------------------------------------------------------------------------------------
--------------------------------------------------------------------------------------------------------------------------------------------------------------------------------------------------------
--------------------------------------------------------------------------------------------------------------------------------------------------------------------------------------------------------
--------------------------------------------------------------------------------------------------------------------------------------------------------------------------------------------------------
--------------------------------------------------------------------------------------------------------------------------------------------------------------------------------------------------------
--------------------------------------------------------------------------------------------------------------------------------------------------------------------------------------------------------
--------------------------------------------------------------------------------------------------------------------------------------------------------------------------------------------------------
--------------------------------------------------------------------------------------------------------------------------------------------------------------------------------------------------------
--------------------------------------------------------------------------------------------------------------------------------------------------------------------------------------------------------
--------------------------------------------------------------------------------------------------------------------------------------------------------------------------------------------------------
--------------------------------------------------------------------------------------------------------------------------------------------------------------------------------------------------------
------------oooSo--ooooo--------------------SoSo--------------------------------------------------------------oSooo--------------------------------------------------------------------------------oooo-
------------------------------------------------------------------------------------------------------------------------Soo------SoSSo-----oooSo--------------oSooooo-----------------------------------
----------------------oo-------------------oooooooo--------------SoSo---------------------------------------ooooooo-----------------------------------------------------------------------oooo------ooo-
---------------y--------------Soo-------------r-Rkr--oSoSS--------------------ooooooo--K---kG---------------Y-g-y-------ooo-------oooo--------------------------oooo----ooo----------------Y--------k-g-
-----------XXXXXXXXXXXXXXX----------------XXXXXXXXXX-----------oooooooo---------------XXXXXXXX-------ooo--XXXXXXXXXX----Kr---------k-r-XXX---GGk--------------G---gg-------------------g-XXXXXXXXXXXXXXX
-----------XXXXXXXXXXXXXXX----ooo---------XXXXXXXXXX-ooooo-------------------ooooo----XXXXXXXX---XXX-g----XXXXXXXXXXXXXXXXXXXXXXXXXXXXXXXXXXXXXXX----Kg------XXXXXXXXXX-oo---------XXXXXXXXXXXXXXXXXXXXX
XXXXXXXXXXXXXXXXXXXXXXXXXX--kk------------XXXXXXXXXX------y---XXXXXXXXXXXXXX--Yr-y--Y-XXXXXXXXXXXXXXXXXXXXXXXXXXXXXXXXXXXXXXXXXXXXXXXXXXXXXXXXXXXXXXXXXX-----XXXXXXXXXX-Gy---XX----XXXXXXXXXXXXXXXXXXXXX
XXXXXXXXXXXXXXXXXXXXXXXXXXXXXXXXXXXXXXXXXXXXXXXXXXXXXXXXXXXXXXXXXXXXXXXXXXXXXXXXXXXXXXXXXXXXXXXXXXXXXXXXXXXXXXXXXXXXXXXXXXXXXXXXXXXXXXXXXXXXXXXXXXXXXXXXXXXXXXXXXXXXXXXXXXXXXXXXXXXXXXXXXXXXXXXXXXXXXXXX

