--------------------------------------------------------------------------------------------------------------------------------------------------------------------------------------------------------
--------------------------------------------------------------------------------------------------------------------------------------------------------------------------------------------------------
--------------------------------------------------------------------------------------------------------------------------------------------------------------------------------------------------------
--------------------------------------------------------------------------------------------------------------------------------------------------------------------------------------------------------
--------------------------------------------------------------------------------------------------------------------------------------------------------------------------------------------------------
--------------------------------------------------------------------------------------------------------------------------------------------------------------------------------------------------------
--------------------------------------------------------------------------------------------------------------------------------------------------------------------------------------------------------
--------------------------------------------------------------------------------------------------------------------------------------------------------------------------------------------------------
--------------------------------------------------------------------------------------------------------------------------------------------------------------------------------------------------------
--------------------------------------------------------------------------------------------------------------------------------------------------------------------------------------------------------
--------------------------------------------------------------------------------------------------------------------------------------------------------------------------------------------------------
--------------------------------------------------------------------------------------------------------------------------------------------------------------------------------------------------------
------------------------------------oooo------------------------------------------------------------------------------------------------------------------------------oSo-------------------------------
-----------------------------------------------------------------------------------------------------ooooSoo----------------SoS------------------oSS--------------------------SoSo----------------------
-----------------------------------oooooo-----------------------------------------------------ooooo------------oooo-------------------------------------------------------------------ooooo-------------
------------------r--k------------ky-r---Y-----------------------oooooo-------SSSoo------------R-R------ooooo---------------oo----------SSoo--------ooo---------------------oooooo----------------------
-------------ooo-XXXXXX---------XXXXXXXXXXXXXXX------------XXXXX---------------------------XXXXXXXXX--RKKr-K--XXXXXXX------k---rg-----------------yK----------------XXXXXX-rK-kk-----ooo----------------
-----------------XXXXXXXX-------XXXXXXXXXXXXXXX-----XXXXXXXXXXXX---ooooo------oooooo-------XXXXXXXXXXXXXXXXXXXXXXXXXX-----XXXXXXXX----oooooo----XXXXXXXX----------XXXXXXXXXXXXXXXXX-Gg-----------XXX----
XXXXXXXXXXXXXXXXXXXXXXXXX----XXXXXXXXXXXXXXXXXXXXXXXXXXXXXXXXXXX--k--r--y----G---g----XXXXXXXXXXXXXXXXXXXXXXXXXXXXXXX-----XXXXXXXX----gYr--rGy--XXXXXXXX-----XXX--XXXXXXXXXXXXXXXXXXXXXXXXXX-----XXX----
XXXXXXXXXXXXXXXXXXXXXXXXXXXXXXXXXXXXXXXXXXXXXXXXXXXXXXXXXXXXXXXXXXXXXXXXXXXXXXXXXXXXXXXXXXXXXXXXXXXXXXXXXXXXXXXXXXXXXXXXXXXXXXXXXXXXXXXXXXXXXXXXXXXXXXXXXXXXXXXXXXXXXXXXXXXXXXXXXXXXXXXXXXXXXXXXXXXXXXXX

