--------------------------------------------------------------------------------------------------------------------------------------------------------------------------------------------------------
--------------------------------------------------------------------------------------------------------------------------------------------------------------------------------------------------------
--------------------------------------------------------------------------------------------------------------------------------------------------------------------------------------------------------
--------------------------------------------------------------------------------------------------------------------------------------------------------------------------------------------------------
--------------------------------------------------------------------------------------------------------------------------------------------------------------------------------------------------------
--------------------------------------------------------------------------------------------------------------------------------------------------------------------------------------------------------
--------------------------------------------------------------------------------------------------------------------------------------------------------------------------------------------------------
--------------------------------------------------------------------------------------------------------------------------------------------------------------------------------------------------------
--------------------------------------------------------------------------------------------------------------------------------------------------------------------------------------------------------
--------------------------------------------------------------------------------------------------------------------------------------------------------------------------------------------------------
--------------------------------------------------------------------------------------------------------------------------------------------------------------------------------------------------------
--------------------------------------------------------------------------------------------------------------------------------------------------------------------------------------------------------
------------------------------------------------------------------------------------------------oSooSoS--------------------------------------------------------------------------------------------Soo--
---------------------------------------------------------------SoSoo--------------------oooSSo----------------------------------------------------------------oSoSSS------------------------------------
--------------------------------------ooS--------------------------------------------------------oooooooo----------------------------------------------------------------------------------------ooooo--
--------------------------------oo---------------------------ooooo-----------SSoSo-----oooooo-------kY---------------SoSo---------------------------ooooS----ooooooo---------------ooS------------rRk-r-
-------------------------------------oooo---XX---oo--ooooo--------------------------------g-Kk-XXXXXXXXXXX-------------------XXXXX-----XXXXX------------------r--rY---XXXX----------------------XXXXXXXX
XXXXXXXXXX-------------------XXXXXX----k--Y-XX-------k-k----XXXXXXXXXX-------oooooo-XXXXXXXXXXXXXXXXXXXXXX-ooo------oooooooo-XXXXXXXXXXXXXXX-------oooooo--XXXXXXXXXXXXXXX-------ooooo----------XXXXXXXX
XXXXXXXXXXXXXXX---g--XXXXX---XXXXXXXXXXXXXXXXXXXXXXXXXXXXXXXXXXXXXXXXXXXXX------Yy--XXXXXXXXXXXXXXXXXXXXXX----g--------y---y-XXXXXXXXXXXXXXX-------------k-XXXXXXXXXXXXXXXXXXXX---R---KK------k-XXXXXXXX
XXXXXXXXXXXXXXXXXXXXXXXXXXXXXXXXXXXXXXXXXXXXXXXXXXXXXXXXXXXXXXXXXXXXXXXXXXXXXXXXXXXXXXXXXXXXXXXXXXXXXXXXXXXXXXXXXXXXXXXXXXXXXXXXXXXXXXXXXXXXXXXXXXXXXXXXXXXXXXXXXXXXXXXXXXXXXXXXXXXXXXXXXXXXXXXXXXXXXXXX

