--------------------------------------------------------------------------------------------------------------------------------------------------------------------------------------------------------
--------------------------------------------------------------------------------------------------------------------------------------------------------------------------------------------------------
--------------------------------------------------------------------------------------------------------------------------------------------------------------------------------------------------------
--------------------------------------------------------------------------------------------------------------------------------------------------------------------------------------------------------
--------------------------------------------------------------------------------------------------------------------------------------------------------------------------------------------------------
--------------------------------------------------------------------------------------------------------------------------------------------------------------------------------------------------------
--------------------------------------------------------------------------------------------------------------------------------------------------------------------------------------------------------
--------------------------------------------------------------------------------------------------------------------------------------------------------------------------------------------------------
--------------------------------------------------------------------------------------------------------------------------------------------------------------------------------------------------------
--------------------------------------------------------------------------------------------------------------------------------------------------------------------------------------------------------
--------------------------------------------------------------------------------------------------------------------------------------------------------------------------------------------------------
--------------------------------------------------------------------------------------------------------------------------------------------------------------------------------------------------------
----------------oSo-----oooSoS-------------ooSoSo--------ooSo-------------------------------------------------------------------------------------------------------------ooSS--------oSo----oSooSoo----
-------------------------------------------------------------------------------------------------------------------------------ooSoo---------------------SooooSo----------------------------------------
-----------------ooo-----ooo----------------oooooo-------------ooSoo----oooSSS----oooo------------oo---------------ooooSoo----------------------ooooo-----------------------oooo-----oooo------oooooo---
----------------------------r-----------------y-------------y--------------------g----g-------------Yg---oooSo-----------------------------------RK--G-----oooo------------R---y-----K--Gg------GyR-----
----------XXXXXXXXXXXXXXXXXXXXXX----ooooo-XXXXXXXXXX----XXXXXX--ooo--------oooo-XXXXXXXX---------XXXXXXX-------------ooooooo---k---------------XXXXXXXX----------XX-----XXXXXXXXXX--XXXXXXXXXXXXXXXXXXX-
----------XXXXXXXXXXXXXXXXXXXXXX-g-Rg---r-XXXXXXXXXX----XXXXXX------r------G----XXXXXXXX--oooo-XXXXXXXXX--oo---XXX-r----r----XXXXXXXX----------XXXXXXXXXXXXXXXXXXXXXXXXXXXXXXXXXXX--XXXXXXXXXXXXXXXXXXXX
----------XXXXXXXXXXXXXXXXXXXXXXXXXXXXXXXXXXXXXXXXXX----XXXXXXXXXXXXXXXXXXXXXXXXXXXXXXXX-ggg---XXXXXXXXX-grY-y-XXXXXXXXXXXXXXXXXXXXXXXXXXXXXXXXXXXXXXXXXXXXXXXXXXXXXXXXXXXXXXXXXXX--XXXXXXXXXXXXXXXXXXXX
XXXXXXXXXXXXXXXXXXXXXXXXXXXXXXXXXXXXXXXXXXXXXXXXXXXXXXXXXXXXXXXXXXXXXXXXXXXXXXXXXXXXXXXXXXXXXXXXXXXXXXXXXXXXXXXXXXXXXXXXXXXXXXXXXXXXXXXXXXXXXXXXXXXXXXXXXXXXXXXXXXXXXXXXXXXXXXXXXXXXXXXXXXXXXXXXXXXXXXXX

