--------------------------------------------------------------------------------------------------------------------------------------------------------------------------------------------------------
--------------------------------------------------------------------------------------------------------------------------------------------------------------------------------------------------------
--------------------------------------------------------------------------------------------------------------------------------------------------------------------------------------------------------
--------------------------------------------------------------------------------------------------------------------------------------------------------------------------------------------------------
--------------------------------------------------------------------------------------------------------------------------------------------------------------------------------------------------------
--------------------------------------------------------------------------------------------------------------------------------------------------------------------------------------------------------
--------------------------------------------------------------------------------------------------------------------------------------------------------------------------------------------------------
--------------------------------------------------------------------------------------------------------------------------------------------------------------------------------------------------------
--------------------------------------------------------------------------------------------------------------------------------------------------------------------------------------------------------
--------------------------------------------------------------------------------------------------------------------------------------------------------------------------------------------------------
--------------------------------------------------------------------------------------------------------------------------------------------------------------------------------------------------------
--------------------------------------------------------------------------------------------------------------------------------------------------------------------------------------------------------
-----------------------------------------------------------------------ooooooo--------------------------------------------------------------------------------------------------------------------------
--------------------oSoo----SooSS--------------------------------------------------------------------------------------------------------------oSSoo---------------------------oooo---------------------
----------------------------------------------------ooSoo-----------------oo-----ooS------oSooo---ooo-----oSoooo--------------------oooo-------------------------------oooo-----------------------------
-------------ooooo--ooo------oo-----------------------------------------GYy------------------------Y-r---------------------------------------ooooo----gy------------------Ggr---ooooo----oSoo-----------
XXXXXXXXXXXX--ry-y----yR------r-yr------------XXXX-oooo-------XXX-----XXXXXXXXX---oooo-----oooo--XXXXXXXX----ooo-------------oo---ooo----------------XXXXXXX----------XXXXXXXX---krK--------------------
XXXXXXXXXXXXXXXXXXXXXXXXXXXXXXXXXXX-----------XXXX-y-g--------XXXXXXXXXXXXXXXXX-gR-gY--------r-r-XXXXXXXX--------XXXXX---------y----gr-y----XXXXXXXXXXXXXXXX---oooooo-XXXXXXXXXXXXXXXX-oooooooo---------
XXXXXXXXXXXXXXXXXXXXXXXXXXXXXXXXXXX----k--XXXXXXXXXXXXXXXX----XXXXXXXXXXXXXXXXXXXXXXXXXXXXXXXXXXXXXXXXXXXXXXXXXXXXXXXX-----XXXXXXXXXXXXXXXXXXXXXXXXXXXXXXXXX---R--k---XXXXXXXXXXXXXXXX---------y------y-
XXXXXXXXXXXXXXXXXXXXXXXXXXXXXXXXXXXXXXXXXXXXXXXXXXXXXXXXXXXXXXXXXXXXXXXXXXXXXXXXXXXXXXXXXXXXXXXXXXXXXXXXXXXXXXXXXXXXXXXXXXXXXXXXXXXXXXXXXXXXXXXXXXXXXXXXXXXXXXXXXXXXXXXXXXXXXXXXXXXXXXXXXXXXXXXXXXXXXXXX

