--------------------------------------------------------------------------------------------------------------------------------------------------------------------------------------------------------
--------------------------------------------------------------------------------------------------------------------------------------------------------------------------------------------------------
--------------------------------------------------------------------------------------------------------------------------------------------------------------------------------------------------------
--------------------------------------------------------------------------------------------------------------------------------------------------------------------------------------------------------
--------------------------------------------------------------------------------------------------------------------------------------------------------------------------------------------------------
--------------------------------------------------------------------------------------------------------------------------------------------------------------------------------------------------------
--------------------------------------------------------------------------------------------------------------------------------------------------------------------------------------------------------
--------------------------------------------------------------------------------------------------------------------------------------------------------------------------------------------------------
--------------------------------------------------------------------------------------------------------------------------------------------------------------------------------------------------------
--------------------------------------------------------------------------------------------------------------------------------------------------------------------------------------------------------
--------------------------------------------------------------------------------------------------------------------------------------------------------------------------------------------------------
--------------------------------------------------------------------------------------------------------------------------------------------------------------------------------------------------------
---------------------------------------------------------------ooo--------------------------------------------------------------------------------------------------oSoooS-------SooS-------------------
----------------------oooo------------------------------------------------------------------------------------------------------------------------------------------------------------------------------
------------------------------------oSo------------------------oo-------ooooo-----ooooooS----oSoS------ooSoooo-------oooSo-----------------ooo-------------------------oooo----oooooooo----ooo----------
------------------------oo-------------------------------------G-r----------------------------------------------------------oSoo-----------------------------Soooo--y-Yr--y-K---y-k-ryR-----------ooo---
--------------XX----------r--------ooooo-----ooo---------XXXXXXXXXXXX--------------oooooo------ooooo---oooooooo------oo--------------------------XXXX--------------XXXXXXXXXXXXXXXXXXXXX-oooooo----g----
--------------XX----XXXXXXXXXX--------rK-r----K----oo----XXXXXXXXXXXX-R----rK-----y-----r-------k---------rk--r-XXXX----k-----ooooo------------g-XXXXXXXX--oooo----XXXXXXXXXXXXXXXXXXXXX-R--gYk-XXXXXXXX
--------------XXXXXXXXXXXXXXXX----XXXXXXXXXXXXXXXX-gky-y-XXXXXXXXXXXXXXXXXXXXX---XXXXXXXXXXXXXXXXXXXXXXXXXXXXXXXXXXXXXXXXXX------k--XXXXXXXXXXXXXXXXXXXXX-------Y--XXXXXXXXXXXXXXXXXXXXXXXXXXXXXXXXXXXXX
XXXXXXXXXXXXXXXXXXXXXXXXXXXXXXXXXXXXXXXXXXXXXXXXXXXXXXXXXXXXXXXXXXXXXXXXXXXXXXXXXXXXXXXXXXXXXXXXXXXXXXXXXXXXXXXXXXXXXXXXXXXXXXXXXXXXXXXXXXXXXXXXXXXXXXXXXXXXXXXXXXXXXXXXXXXXXXXXXXXXXXXXXXXXXXXXXXXXXXXX

