--------------------------------------------------------------------------------------------------------------------------------------------------------------------------------------------------------
--------------------------------------------------------------------------------------------------------------------------------------------------------------------------------------------------------
--------------------------------------------------------------------------------------------------------------------------------------------------------------------------------------------------------
--------------------------------------------------------------------------------------------------------------------------------------------------------------------------------------------------------
--------------------------------------------------------------------------------------------------------------------------------------------------------------------------------------------------------
--------------------------------------------------------------------------------------------------------------------------------------------------------------------------------------------------------
--------------------------------------------------------------------------------------------------------------------------------------------------------------------------------------------------------
--------------------------------------------------------------------------------------------------------------------------------------------------------------------------------------------------------
--------------------------------------------------------------------------------------------------------------------------------------------------------------------------------------------------------
--------------------------------------------------------------------------------------------------------------------------------------------------------------------------------------------------------
--------------------------------------------------------------------------------------------------------------------------------------------------------------------------------------------------------
--------------------------------------------------------------------------------------------------------------------------------------------------------------------------------------------------------
-------------------------------------------------------------------------SSSo---------------------------------------------------------------------------------------------------------------------------
------------------------------------------------------------------------------------------ooo----SSoSo------------oSoSo-----------------------ooooSo----------------------------------------------------
------------------------------------oo----------------------------------ooo------------------------------------------------SoS------------------------oSooooS-------------------------------------------
-----------------ooooS---------------Yg--------------------------------------------------ooooo-----ooo----------oooooo------------------------ooo-------------------k-----------*-----------------------
------------------------------yrR--XXXXXXX---------oo-----------------XXXXXXXXXX-----XX-K-Ryy-------ky-rg----------g------------XXXXXXXXXX---y--yg-----ooooooo--XXXXXXXXXX------*--------------XXXXXXX--
XXXXXXXXXXXX-----oooooooo-XXXXXXXXXXXXXXXXXX------r-yY-----XXXXXX-----XXXXXXXXXX-----XXXXXXXXXXXXXXXXXXXXX-----XXXXXXXXX-y------XXXXXXXXXX--XXXXXXXXX--RR-----Y-XXXXXXXXXXXX----*--------oo----XXXXXXX--
XXXXXXXXXXXXXXXX-----yYr--XXXXXXXXXXXXXXXXXX-----XXXXXXX---XXXXXXXXXXXXXXXXXXXXXXX---XXXXXXXXXXXXXXXXXXXXX-----XXXXXXXXXXXXXXXXXXXXXXXXXXXXXXXXXXXXXXXXXXXXXXXXXXXXXXXXXXXXX----*-------Kr-----XXXXXXXXX
XXXXXXXXXXXXXXXXXXXXXXXXXXXXXXXXXXXXXXXXXXXXXXXXXXXXXXXXXXXXXXXXXXXXXXXXXXXXXXXXXXXXXXXXXXXXXXXXXXXXXXXXXXXXXXXXXXXXXXXXXXXXXXXXXXXXXXXXXXXXXXXXXXXXXXXXXXXXXXXXXXXXXXXXXXXXXXXXXXXXXXXXXXXXXXXXXXXXXXXX

