--------------------------------------------------------------------------------------------------------------------------------------------------------------------------------------------------------
--------------------------------------------------------------------------------------------------------------------------------------------------------------------------------------------------------
--------------------------------------------------------------------------------------------------------------------------------------------------------------------------------------------------------
--------------------------------------------------------------------------------------------------------------------------------------------------------------------------------------------------------
--------------------------------------------------------------------------------------------------------------------------------------------------------------------------------------------------------
--------------------------------------------------------------------------------------------------------------------------------------------------------------------------------------------------------
--------------------------------------------------------------------------------------------------------------------------------------------------------------------------------------------------------
--------------------------------------------------------------------------------------------------------------------------------------------------------------------------------------------------------
--------------------------------------------------------------------------------------------------------------------------------------------------------------------------------------------------------
--------------------------------------------------------------------------------------------------------------------------------------------------------------------------------------------------------
--------------------------------------------------------------------------------------------------------------------------------------------------------------------------------------------------------
--------------------------------------------------------------------------------------------------------------------------------------------------------------------------------------------------------
-------------------------------------------------------------------------------------------------------oSo------------------------SoSo------------------------------------------------------------------
--------------------------------------ooSoS--------------------------------------------------------------------------------------------------ooo----------------------------Soooo-----------------------
-------------------------------------------------------------------------*-------------ooo--------------oooo----------------------oooo-----------------------------ooooS----------------oo--------------
----------------oooooooo------------ooooooo---yKy-----ooS-----------*----*----------------y------------kykk-----------------------R--------oooo----------ooSo--------------ooooooo-----y-R-------oSoooo-
XXXXXXXXXX---XX-----------------------kr-gg--XXXXXX----------XXX----*----*----XXX-----XXXXXXX-------XXXXXXXXX------XXXX--------XXXXXXXXXXX---rG--------------------oooooo-----y-g-Y--XXXXXXX------------
XXXXXXXXXX---XX-ooooooo-----------XXXXXXXXXXXXXXXXX--ooooooo-XXX-*--*----*----XXX-----XXXXXXX--XXXXXXXXXXXXXX-gkr--XXXX--------XXXXXXXXXXXXXXXXXX-------ooooo-----g-------XXXXXXXXXXXXXXXXXX------oooo--
XXXXXXXXXX---XX----YY-k--XXXXXXXXXXXXXXXXXXXXXXXXXX------rr--XXXXXXXXXXXXXXXXXXXXXXXXXXXXXXXXXXXXXXXXXXXXXXXXXXXXXXXXXXXXXXX---XXXXXXXXXXXXXXXXXXXXXX--yY-krr--XXXXXXXXXXXXXXXXXXXXXXXXXXXXXXXXX-Yy---g-
XXXXXXXXXXXXXXXXXXXXXXXXXXXXXXXXXXXXXXXXXXXXXXXXXXXXXXXXXXXXXXXXXXXXXXXXXXXXXXXXXXXXXXXXXXXXXXXXXXXXXXXXXXXXXXXXXXXXXXXXXXXXXXXXXXXXXXXXXXXXXXXXXXXXXXXXXXXXXXXXXXXXXXXXXXXXXXXXXXXXXXXXXXXXXXXXXXXXXXXX

