--------------------------------------------------------------------------------------------------------------------------------------------------------------------------------------------------------
--------------------------------------------------------------------------------------------------------------------------------------------------------------------------------------------------------
--------------------------------------------------------------------------------------------------------------------------------------------------------------------------------------------------------
--------------------------------------------------------------------------------------------------------------------------------------------------------------------------------------------------------
--------------------------------------------------------------------------------------------------------------------------------------------------------------------------------------------------------
--------------------------------------------------------------------------------------------------------------------------------------------------------------------------------------------------------
--------------------------------------------------------------------------------------------------------------------------------------------------------------------------------------------------------
--------------------------------------------------------------------------------------------------------------------------------------------------------------------------------------------------------
--------------------------------------------------------------------------------------------------------------------------------------------------------------------------------------------------------
--------------------------------------------------------------------------------------------------------------------------------------------------------------------------------------------------------
--------------------------------------------------------------------------------------------------------------------------------------------------------------------------------------------------------
--------------------------------------------------------------------------------------------------------------------------------------------------------------------------------------------------------
--------------------------------------------------------------------------------------------------------------------------------------------SoSSoS------------------------------------------------------
-----------ooooo----------oooo------------SSS------------------------------------------------------------------------------------oSooSoo-----------------oSoo------------------ooSooo-------------------
------------------------------------------------------------oooSS---------------------------------oo----------------------------------------oooooooo--------------------------------------------Sooo----
-------------ooo--ooo-------------------oooo------ooSo--------------------oooo--------ooo------ry-----------SSSooo------oooSoo--oooooo-------k-K---g----ooooooo----------------oooooo-------------------
-----------gg-yK--g---------Y--XXX-----------------------------oo---------r---g-----rk---y----XXXXXXXX-------------XXXX----------Yrr-kk---XXXXXXXXXXX---y---Y---XXXXXX------y------K---oo-------ooo-----
XXXXXXXXXXXXXXXXXXXXXXXXXXXXXXXXXX----XXXXXXXXX--------------K---rg-XXXXXXXXXXXXXXXXXXXXXXX---XXXXXXXXXX---oooo----XXXX--------XXXXXXXXXXXXXXXXXXXXXXXXXXXXXXXXXXXXXXXXXXXXXXXXXXXXXXX-k-rg---KY--------
XXXXXXXXXXXXXXXXXXXXXXXXXXXXXXXXXX----XXXXXXXXX------k-XXXXXXXXXXXXXXXXXXXXXXXXXXXXXXXXXXXX---XXXXXXXXXX--kk-----y-XXXX-G------XXXXXXXXXXXXXXXXXXXXXXXXXXXXXXXXXXXXXXXXXXXXXXXXXXXXXXXXXXXXXXXXXXXXXX---
XXXXXXXXXXXXXXXXXXXXXXXXXXXXXXXXXXXXXXXXXXXXXXXXXXXXXXXXXXXXXXXXXXXXXXXXXXXXXXXXXXXXXXXXXXXXXXXXXXXXXXXXXXXXXXXXXXXXXXXXXXXXXXXXXXXXXXXXXXXXXXXXXXXXXXXXXXXXXXXXXXXXXXXXXXXXXXXXXXXXXXXXXXXXXXXXXXXXXXXX

