--------------------------------------------------------------------------------------------------------------------------------------------------------------------------------------------------------
--------------------------------------------------------------------------------------------------------------------------------------------------------------------------------------------------------
--------------------------------------------------------------------------------------------------------------------------------------------------------------------------------------------------------
--------------------------------------------------------------------------------------------------------------------------------------------------------------------------------------------------------
--------------------------------------------------------------------------------------------------------------------------------------------------------------------------------------------------------
--------------------------------------------------------------------------------------------------------------------------------------------------------------------------------------------------------
--------------------------------------------------------------------------------------------------------------------------------------------------------------------------------------------------------
--------------------------------------------------------------------------------------------------------------------------------------------------------------------------------------------------------
--------------------------------------------------------------------------------------------------------------------------------------------------------------------------------------------------------
--------------------------------------------------------------------------------------------------------------------------------------------------------------------------------------------------------
--------------------------------------------------------------------------------------------------------------------------------------------------------------------------------------------------------
--------------------------------------------------------------------------------------------------------------------------------------------------------------------------------------------------------
-----------------------------------------------------------------------oSS--------------------------------------------------------------------------------------ooooSo----------------------------------
---------------------------------------------------------------------------------------------------------------------------------------------------------ooS--------------------------------------------
--------------SSoS-----------------------------------------ooo---------oooo----SoSSo------------------------------------------------------------------------------ooo-----------ooo---------------------
------------------------------ooSoooo-----------ooo------------------------G------------------------------ooSSSooo------------SSSo-------oo-------------oooo------KG-r-------------------oSS------K---K-
-------------ooooo-------------------------Yg-------XXXXXXXXXXXXX-----XXXXXXX--oooo------------XXX----------------------------------XXX-yk--------------k------XXXXXXXX--------XXXXXX------------XXXXXXX
XXXXXXXXXX--------K---XXXXXXX--oooo----XXXXXXXXXXXXXXXXXXXXXXXXXXXXXXXXXXXXXX-G-kk-----oo----XXXXX---XX----oooo--------------oooo---XXXXXXXXXXXX------XXXXXXXXXXXXXXXXX--------XXXXXX------------XXXXXXX
XXXXXXXXXXXXXXXXXXXXXXXXXXXXX-K---g----XXXXXXXXXXXXXXXXXXXXXXXXXXXXXXXXXXXXXXXXXXXXXXX-k-y---XXXXX---XX------g-g-Y-XXXXX--------ryr-XXXXXXXXXXXXXXXXXXXXXXXXXXXXXXXXXXX----R-r-XXXXXXXXX-KK-R-XXXXXXXXXX
XXXXXXXXXXXXXXXXXXXXXXXXXXXXXXXXXXXXXXXXXXXXXXXXXXXXXXXXXXXXXXXXXXXXXXXXXXXXXXXXXXXXXXXXXXXXXXXXXXXXXXXXXXXXXXXXXXXXXXXXXXXXXXXXXXXXXXXXXXXXXXXXXXXXXXXXXXXXXXXXXXXXXXXXXXXXXXXXXXXXXXXXXXXXXXXXXXXXXXXX

