--------------------------------------------------------------------------------------------------------------------------------------------------------------------------------------------------------
--------------------------------------------------------------------------------------------------------------------------------------------------------------------------------------------------------
--------------------------------------------------------------------------------------------------------------------------------------------------------------------------------------------------------
--------------------------------------------------------------------------------------------------------------------------------------------------------------------------------------------------------
--------------------------------------------------------------------------------------------------------------------------------------------------------------------------------------------------------
--------------------------------------------------------------------------------------------------------------------------------------------------------------------------------------------------------
--------------------------------------------------------------------------------------------------------------------------------------------------------------------------------------------------------
--------------------------------------------------------------------------------------------------------------------------------------------------------------------------------------------------------
--------------------------------------------------------------------------------------------------------------------------------------------------------------------------------------------------------
--------------------------------------------------------------------------------------------------------------------------------------------------------------------------------------------------------
--------------------------------------------------------------------------------------------------------------------------------------------------------------------------------------------------------
--------------------------------------------------------------------------------------------------------------------------------------------------------------------------------------------------------
-------------------------ooS------------------------------------------------oooo------------------------------------------------------------------------------------------------------------------------
---------------SoS---------------oSo-----------------------------------------------------Soo----------------------------------------------------------------------------------------------SSSo----------
--------------------------ooo-----------------------------------------------oo--------------------oooSSo--ooooo---oSS------------------------------------------------------------ooS--------------------
----------------ooo-----r--yY-----oo------------------------ooo-------------r------------oooo-------------------------------SSoo-----Soo------------------------SSo-----------------------ooooo---------
---------------R-y--K-XXXXXXXXXX--G---------------------------------------XXXXXXXX------r-g--Gy-------------oooo---------------------------------------XXX-------------XXXX--------------k-k------------
-------------XXXXXXXXXXXXXXXXXXXXXXXXXX---------oo--------ooooo-----------XXXXXXXXXXXXXXXXXXXXXX-G----g-------r-----Y--XX--oooo---oooo----XXX----------XXX---oooooooo--XXXX-------G---Y-XXXXXXXXX----oo-
-------------XXXXXXXXXXXXXXXXXXXXXXXXXX-------y----XXXXX-----Gr----XXXXXXXXXXXXXXXXXXXXXXXXXXXXXXXXXXXXXXXXXXXXXXXXXXXXXX-r--G----r----R--XXX---g------XXXXX---g-----y-XXXX----XXXXXXXXXXXXXXXXXX--R----
XXXXXXXXXXXXXXXXXXXXXXXXXXXXXXXXXXXXXXXXXXXXXXXXXXXXXXXXXXXXXXXXXXXXXXXXXXXXXXXXXXXXXXXXXXXXXXXXXXXXXXXXXXXXXXXXXXXXXXXXXXXXXXXXXXXXXXXXXXXXXXXXXXXXXXXXXXXXXXXXXXXXXXXXXXXXXXXXXXXXXXXXXXXXXXXXXXXXXXXX

