--------------------------------------------------------------------------------------------------------------------------------------------------------------------------------------------------------
--------------------------------------------------------------------------------------------------------------------------------------------------------------------------------------------------------
--------------------------------------------------------------------------------------------------------------------------------------------------------------------------------------------------------
--------------------------------------------------------------------------------------------------------------------------------------------------------------------------------------------------------
--------------------------------------------------------------------------------------------------------------------------------------------------------------------------------------------------------
--------------------------------------------------------------------------------------------------------------------------------------------------------------------------------------------------------
--------------------------------------------------------------------------------------------------------------------------------------------------------------------------------------------------------
--------------------------------------------------------------------------------------------------------------------------------------------------------------------------------------------------------
--------------------------------------------------------------------------------------------------------------------------------------------------------------------------------------------------------
--------------------------------------------------------------------------------------------------------------------------------------------------------------------------------------------------------
--------------------------------------------------------------------------------------------------------------------------------------------------------------------------------------------------------
--------------------------------------------------------------------------------------------------------------------------------------------------------------------------------------------------------
--------------SoSo---------------SoSoSo-----------------------------------------------------------------------------ooooSoSoo-------------------------------------oooooo--------------------------------
---------------------------------------------------------------------------------------------oooo-----ooo----ooo----------------------ooo---------------------------------------------------------------
-------------oooooooo------------oooooo-------------------------------------Sooo--------------------------------------oooo------------------------SoooSSo------------ooo--------------------------------
-------------r---r----------------y--y----oooooSo------------------------------------ooSo----ooooo-----------oooo-------K-----------------------------------------r---g-g---------------------------R---
-----------XXXXXXXXXXX-----ooo-XXXXXXXXX--------------yR-Gr--------------oooo---------------k----g------g-g---g----XXXXXXXXXXX----------gy------oooooooo---oooo--XXXXXXXXXXX------------XXXXX-----XXXXXX
-----------XXXXXXXXXXXXX-----k-XXXXXXXXX---ooooo---XXXXXXXXX--------------g--r-----oooo----XXXXXXXXXXXXXXXXXXXXXXXXXXXXXXXXXXX-------XXXXXX-----------Y-K--r--g--XXXXXXXXXXXXXXXXXX-----XXXXX-----XXXXXX
-----------XXXXXXXXXXXXXXXXXXXXXXXXXXXXX--yr-yk--Y-XXXXXXXXX------------XXXXXXXXX--k--rrr--XXXXXXXXXXXXXXXXXXXXXXXXXXXXXXXXXXXXXXXXXXXXXXXX----XXXXXXXXXXXXXXXXXXXXXXXXXXXXXXXXXXXX-----XXXXXXXXXXXXXXXX
XXXXXXXXXXXXXXXXXXXXXXXXXXXXXXXXXXXXXXXXXXXXXXXXXXXXXXXXXXXXXXXXXXXXXXXXXXXXXXXXXXXXXXXXXXXXXXXXXXXXXXXXXXXXXXXXXXXXXXXXXXXXXXXXXXXXXXXXXXXXXXXXXXXXXXXXXXXXXXXXXXXXXXXXXXXXXXXXXXXXXXXXXXXXXXXXXXXXXXXX

