--------------------------------------------------------------------------------------------------------------------------------------------------------------------------------------------------------
--------------------------------------------------------------------------------------------------------------------------------------------------------------------------------------------------------
--------------------------------------------------------------------------------------------------------------------------------------------------------------------------------------------------------
--------------------------------------------------------------------------------------------------------------------------------------------------------------------------------------------------------
--------------------------------------------------------------------------------------------------------------------------------------------------------------------------------------------------------
--------------------------------------------------------------------------------------------------------------------------------------------------------------------------------------------------------
--------------------------------------------------------------------------------------------------------------------------------------------------------------------------------------------------------
--------------------------------------------------------------------------------------------------------------------------------------------------------------------------------------------------------
--------------------------------------------------------------------------------------------------------------------------------------------------------------------------------------------------------
--------------------------------------------------------------------------------------------------------------------------------------------------------------------------------------------------------
--------------------------------------------------------------------------------------------------------------------------------------------------------------------------------------------------------
--------------------------------------------------------------------------------------------------------------------------------------------------------------------------------------------------------
--------------------------------ooooo------------------------------SSS-------------------------------------------------------------------------------------------oSoo-----------------------------------
----------------------------------------------------------------------------------------------SoSoo-------------------------------SSSo----------------------oSo------------------------------oooo-------
--------------oSooo--------------oooo---------------------------ooooooo--------------------------------------------------oSooo----------------------oooo----------oooo-----Soooooo----------------------
---------------------oooooS-----k--G--------oooo-----oSo--------------Y------------------------oooo---------------------------------------------------------------------------------oooo-----oooooo-----
XXXXXXXXXXXX--oooo-------------XXXXXXX-------gKr---------------XXXXXXXXXXXXXXXXX-----XXX----kk---y--y-XXXX--------oo---oooooo----GR-k-g------XXXX-----------yrk-XXXXXXXXX-oooooo-----G-------y--g-k-----
XXXXXXXXXXXX----r-G----ooooo---XXXXXXX---XXXXXXXX----oooo------XXXXXXXXXXXXXXXXX-----XXXXXXXXXXXXXXXXXXXXX-------------ggkgK----XXXXXXXXXXXXXXXXXXX-grr---XXXXXXXXXXXXXXX------rK--XXXXXXXXXXXXXXXXX----
XXXXXXXXXXXXXXXXXXXX-----------XXXXXXX---XXXXXXXX-y-r-G--gk-XXXXXXXXXXXXXXXXXXXX-----XXXXXXXXXXXXXXXXXXXXXXXXXXXXXXXXXXXXXXXXXXXXXXXXXXXXXXXXXXXXXXXXXXXXXXXXXXXXXXXXXXXXXXXXXXXXXXXXXXXXXXXXXXXXXXX----
XXXXXXXXXXXXXXXXXXXXXXXXXXXXXXXXXXXXXXXXXXXXXXXXXXXXXXXXXXXXXXXXXXXXXXXXXXXXXXXXXXXXXXXXXXXXXXXXXXXXXXXXXXXXXXXXXXXXXXXXXXXXXXXXXXXXXXXXXXXXXXXXXXXXXXXXXXXXXXXXXXXXXXXXXXXXXXXXXXXXXXXXXXXXXXXXXXXXXXXX

