--------------------------------------------------------------------------------------------------------------------------------------------------------------------------------------------------------
--------------------------------------------------------------------------------------------------------------------------------------------------------------------------------------------------------
--------------------------------------------------------------------------------------------------------------------------------------------------------------------------------------------------------
--------------------------------------------------------------------------------------------------------------------------------------------------------------------------------------------------------
--------------------------------------------------------------------------------------------------------------------------------------------------------------------------------------------------------
--------------------------------------------------------------------------------------------------------------------------------------------------------------------------------------------------------
--------------------------------------------------------------------------------------------------------------------------------------------------------------------------------------------------------
--------------------------------------------------------------------------------------------------------------------------------------------------------------------------------------------------------
--------------------------------------------------------------------------------------------------------------------------------------------------------------------------------------------------------
--------------------------------------------------------------------------------------------------------------------------------------------------------------------------------------------------------
--------------------------------------------------------------------------------------------------------------------------------------------------------------------------------------------------------
--------------------------------------------------------------------------------------------------------------------------------------------------------------------------------------------------------
----------------------------------------------------------------------------------------------------------------------------------------------------------------------------------------------Soo-------
--------------------------------------------------------oooo-----------SSS------------------------------------------------------------------------------------------------------------------------------
----------------------oooSo-----------------------------------------------------oooSo-------oooo---------------------------------------------------------ooo----oo----------------------------oooo------
------------------------------------ooSoSoo-----oSSS-------oo---------oooo--------------------------------------------------------------oSSo-----oooo----R-----Y---R-------------------r-K--r---G-------
---------------------ooooooo-----------------------------kkkg--------y---g------oooo-------XXXXXXXXXXX--------XXXX----XXXX--ooo-------------------------XXXXXXXXXXXXX----ooo--------XXXXXXXXXXXXXXX-----
----------------XXXX------y-----------oooo----oooooo---XXXXXXX------XXXXXXXXXX-R---g-------XXXXXXXXXXX----ooo-XXXX----XXXX--G-K---------oooo---ooooo----XXXXXXXXXXXXX----r------y-k-XXXXXXXXXXXXXXXXX---
XXXXXXXXXXXXXXXXXXXXXXXXXXXXXXXXXXX-R--K--------g-RkK--XXXXXXX--g-Y-XXXXXXXXXXXXXXXXXXX----XXXXXXXXXXX----r---XXXXXXXXXXXXXXXXXXXXXXXX-g--r----y-Y--rRk-XXXXXXXXXXXXXXXXXXXXXXXXXXXXXXXXXXXXXXXXXXXXX---
XXXXXXXXXXXXXXXXXXXXXXXXXXXXXXXXXXXXXXXXXXXXXXXXXXXXXXXXXXXXXXXXXXXXXXXXXXXXXXXXXXXXXXXXXXXXXXXXXXXXXXXXXXXXXXXXXXXXXXXXXXXXXXXXXXXXXXXXXXXXXXXXXXXXXXXXXXXXXXXXXXXXXXXXXXXXXXXXXXXXXXXXXXXXXXXXXXXXXXXX

