--------------------------------------------------------------------------------------------------------------------------------------------------------------------------------------------------------
--------------------------------------------------------------------------------------------------------------------------------------------------------------------------------------------------------
--------------------------------------------------------------------------------------------------------------------------------------------------------------------------------------------------------
--------------------------------------------------------------------------------------------------------------------------------------------------------------------------------------------------------
--------------------------------------------------------------------------------------------------------------------------------------------------------------------------------------------------------
--------------------------------------------------------------------------------------------------------------------------------------------------------------------------------------------------------
--------------------------------------------------------------------------------------------------------------------------------------------------------------------------------------------------------
--------------------------------------------------------------------------------------------------------------------------------------------------------------------------------------------------------
--------------------------------------------------------------------------------------------------------------------------------------------------------------------------------------------------------
--------------------------------------------------------------------------------------------------------------------------------------------------------------------------------------------------------
--------------------------------------------------------------------------------------------------------------------------------------------------------------------------------------------------------
--------------------------------------------------------------------------------------------------------------------------------------------------------------------------------------------------------
-------------------oooo------------------------------------------------------oSSoo----------------------------------------------------------------------------------------------------------------------
-----------------------------------------------------------------------------------------------------------------------ooooo----------------------------------------------------------------------------
-----------------------------------------------------------oooo---SooSSSo-----ooo-------------------------------oooSo--------------SSoooo---------------------------------------ooS---------------------
-----------------------------oSooo--------------oooSo-------------------------r--G----------------------------------------ooooo----------------------------oSooS-----------------------------oooSSo-----
XXXXXXXXXXXX-----XXXXXXXXX---------------oo----------------------ooooooo---XXXXXXXXX----------r-----------XX---oooooo--r--Kr------oooooo------------------------------------------------------------XXXX
XXXXXXXXXXXXXXXXXXXXXXXXXX---oooo------r-------ooo---------g-------Yr---Y--XXXXXXXXX---XXXXXXXXXXXXX-ooo--XX---YkGRk--XXXXXXXXXX------Ykr-------XXXX------ooooo------ooo--------k---------ooooooooo-XXXX
XXXXXXXXXXXXXXXXXXXXXXXXXX----R--r--XXXXXXXXX--y-y-KY----XXXXXXXXXXXXXXXXXXXXXXXXXXX---XXXXXXXXXXXXX---r--XXXXXXXXXXXXXXXXXXXXXXXXXXXXXXXXX-----XXXX-------yy-gg-------Y-XXXXXXXXXXXXXXXX-r--k-kg---XXXX
XXXXXXXXXXXXXXXXXXXXXXXXXXXXXXXXXXXXXXXXXXXXXXXXXXXXXXXXXXXXXXXXXXXXXXXXXXXXXXXXXXXXXXXXXXXXXXXXXXXXXXXXXXXXXXXXXXXXXXXXXXXXXXXXXXXXXXXXXXXXXXXXXXXXXXXXXXXXXXXXXXXXXXXXXXXXXXXXXXXXXXXXXXXXXXXXXXXXXXXX

