--------------------------------------------------------------------------------------------------------------------------------------------------------------------------------------------------------
--------------------------------------------------------------------------------------------------------------------------------------------------------------------------------------------------------
--------------------------------------------------------------------------------------------------------------------------------------------------------------------------------------------------------
--------------------------------------------------------------------------------------------------------------------------------------------------------------------------------------------------------
--------------------------------------------------------------------------------------------------------------------------------------------------------------------------------------------------------
--------------------------------------------------------------------------------------------------------------------------------------------------------------------------------------------------------
--------------------------------------------------------------------------------------------------------------------------------------------------------------------------------------------------------
--------------------------------------------------------------------------------------------------------------------------------------------------------------------------------------------------------
--------------------------------------------------------------------------------------------------------------------------------------------------------------------------------------------------------
--------------------------------------------------------------------------------------------------------------------------------------------------------------------------------------------------------
--------------------------------------------------------------------------------------------------------------------------------------------------------------------------------------------------------
--------------------------------------------------------------------------------------------------------------------------------------------------------------------------------------------------------
------------------oSSooo------------------------------------------------ooooo---------------------------------------------------------------------------------oSSoo----------------------SSo------------
-----------------------------------------------------------------------------------------ooo--------------------oooooo------------------------------------------------------------------------oSSoo-----
--------------------oo--------oooooo-------------------------------------oo------------------------------------------------------------ooo-----------oooSo-------------oo-------------ooo---------------
-------------------Gg---y----------------------------ooSSSo--oSSooooS---Y-Y-----oSS------ooo---------------------ooo-----------------r----k----kg-------------r---g---r-----ooooS-----R--rgK----oooooo--
----------XXX----XXXXXXXXX----oooooo-----------------------------------XXXXXXXX--------kr--y-------------y---k--r--r-R--------------XXXXXXXXXXXXXX--ooooo----XXXXXXXXXXXXX-----------XXXXXXXX---rr-gR--X
----------XXX----XXXXXXXXX-------k----------ooo--------ooo----oooooooo-XXXXXXXX-oo---XXXXXXXXXXX--------XXXXXXXXXXXXXXXXXXXX---XXXXXXXXXXXXXXXXXXX--g-g------XXXXXXXXXXXXX--ooooooo--XXXXXXXXXXXXXXXXXXX
XXXXXXXXXXXXXXXXXXXXXXXXXXXXXXXXXXXXXXXXXX-----yrg--rG-Yyk---y-----y---XXXXXXXX------XXXXXXXXXXXXXXXXXXXXXXXXXXXXXXXXXXXXXXXXXXXXXXXXXXXXXXXXXXXXXXXXXXXXXXXXXXXXXXXXXXXXX--Y--------XXXXXXXXXXXXXXXXXXX
XXXXXXXXXXXXXXXXXXXXXXXXXXXXXXXXXXXXXXXXXXXXXXXXXXXXXXXXXXXXXXXXXXXXXXXXXXXXXXXXXXXXXXXXXXXXXXXXXXXXXXXXXXXXXXXXXXXXXXXXXXXXXXXXXXXXXXXXXXXXXXXXXXXXXXXXXXXXXXXXXXXXXXXXXXXXXXXXXXXXXXXXXXXXXXXXXXXXXXXX

