--------------------------------------------------------------------------------------------------------------------------------------------------------------------------------------------------------
--------------------------------------------------------------------------------------------------------------------------------------------------------------------------------------------------------
--------------------------------------------------------------------------------------------------------------------------------------------------------------------------------------------------------
--------------------------------------------------------------------------------------------------------------------------------------------------------------------------------------------------------
--------------------------------------------------------------------------------------------------------------------------------------------------------------------------------------------------------
--------------------------------------------------------------------------------------------------------------------------------------------------------------------------------------------------------
--------------------------------------------------------------------------------------------------------------------------------------------------------------------------------------------------------
--------------------------------------------------------------------------------------------------------------------------------------------------------------------------------------------------------
--------------------------------------------------------------------------------------------------------------------------------------------------------------------------------------------------------
--------------------------------------------------------------------------------------------------------------------------------------------------------------------------------------------------------
--------------------------------------------------------------------------------------------------------------------------------------------------------------------------------------------------------
--------------------------------------------------------------------------------------------------------------------------------------------------------------------------------------------------------
-------------------------------k-k-K----------------------------------------------------------------------------------------------------------*-----------------------------oooS------------------------
-------------------------------%%%%%%-------------------------------------------------------------oSooSSo-------------------------oSSSoSoo----*-*-----------ooo-----ooSS-----------------oSoo-----------
-------------SoSoS-------------||||||------------SSo----------------------------------------------------------------------------------------*-*-*-------------------------------------------------------
-------------------------------||||||-------------------G---------oo--------------------------------oo---------------g--G--------oooooooo---*-*-*--ooooooo-----------oo-----Y---R-----------------------
-------------oooo---------g---Ry|||K|-----oo----ooo--XXXXXXXXXX-ryk-----oooo------------------------R-----XXXX------XXXXXX--ooo---k----gr--XXXXXXX--------------R--r-r--Gr-XXXXXXXXX-----K---y-----XXXXX
XXXXXXXXXXX-yy-k-----XXXXXXXXXXXXXXXXXX-k-kr---g-rr--XXXXXXXXXXXXXXXX----------------------------XXXXXXXXXXXXXXXXXXXXXXXXX--k-g-XXXXXXXXXXXXXXXXXX--oooo---XXXXXXXXXXXXXXXXXXXXXXXXXXXXXXXXXXXXXXXXXXXXX
XXXXXXXXXXXXXXXXXXXXXXXXXXXXXXXXXXXXXXXXXXXXXXXXXXXXXXXXXXXXXXXXXXXXXXXXXXXXX------r--r------XXXXXXXXXXXXXXXXXXXXXXXXXXXXXXXXXXXXXXXXXXXXXXXXXXXXX-Y--g----XXXXXXXXXXXXXXXXXXXXXXXXXXXXXXXXXXXXXXXXXXXXX
XXXXXXXXXXXXXXXXXXXXXXXXXXXXXXXXXXXXXXXXXXXXXXXXXXXXXXXXXXXXXXXXXXXXXXXXXXXXXXXXXXXXXXXXXXXXXXXXXXXXXXXXXXXXXXXXXXXXXXXXXXXXXXXXXXXXXXXXXXXXXXXXXXXXXXXXXXXXXXXXXXXXXXXXXXXXXXXXXXXXXXXXXXXXXXXXXXXXXXXX

