--------------------------------------------------------------------------------------------------------------------------------------------------------------------------------------------------------
--------------------------------------------------------------------------------------------------------------------------------------------------------------------------------------------------------
--------------------------------------------------------------------------------------------------------------------------------------------------------------------------------------------------------
--------------------------------------------------------------------------------------------------------------------------------------------------------------------------------------------------------
--------------------------------------------------------------------------------------------------------------------------------------------------------------------------------------------------------
--------------------------------------------------------------------------------------------------------------------------------------------------------------------------------------------------------
--------------------------------------------------------------------------------------------------------------------------------------------------------------------------------------------------------
--------------------------------------------------------------------------------------------------------------------------------------------------------------------------------------------------------
--------------------------------------------------------------------------------------------------------------------------------------------------------------------------------------------------------
--------------------------------------------------------------------------------------------------------------------------------------------------------------------------------------------------------
--------------------------------------------------------------------------------------------------------------------------------------------------------------------------------------------------------
--------------------------------------------------------------------------------------------------------------------------------------------------------------------------------------------------------
--------------------------------------------------------------------------------------------------------------------------------------------------------------------ooooo-------------------------------
---------------------------------------------------------------------------------------------ooSoSSo---oooSSSoo---------oSooSooSo-----------------------------------------------------------------------
-----------------------------------SSooS---------------------------------------------------------------------------------------------------------------oooSo--------oo-----oooo-------------------------
--------------------ooo---------------------oooooo---Y-y---------------oSSooo---------------ooooo------ooooooo------------ooooo----------------------------------------R----g--Y-------------ooooo------
-----------------------------XXXX----oooo------r-Y--XXXXXXX----oo----------------XX------------y---k--k--R-Yr-----ooo---gK---YG------gy----------------oooo--------XXXXXXXXXXXXXXX----------------------
---------------------ooo-----XXXX--------Y-XXXXXXXXXXXXXXXX-g-R----XXX----oooo---XX---ooo--XXXXXXXXXXXXXXXXXXXXX----R--XXXXXXXXXXXXXXXXX-----XXXX----k--k----------XXXXXXXXXXXXXXX--XXX-------oo--------
XXXXXXXXXXXXXX---------Gk-XXXXXXXXXXXXXXXXXXXXXXXXXXXXXXXXXXXXXXXXXXXX----G---rg-XX-r-r----XXXXXXXXXXXXXXXXXXXXXXXXXXXXXXXXXXXXXXXXXXXXXXXXXXXXXXXXXXXXXXXXXXXXXXXXXXXXXXXXXXXXXXX--XXXXXXX-gG-----XXXXX
XXXXXXXXXXXXXXXXXXXXXXXXXXXXXXXXXXXXXXXXXXXXXXXXXXXXXXXXXXXXXXXXXXXXXXXXXXXXXXXXXXXXXXXXXXXXXXXXXXXXXXXXXXXXXXXXXXXXXXXXXXXXXXXXXXXXXXXXXXXXXXXXXXXXXXXXXXXXXXXXXXXXXXXXXXXXXXXXXXXXXXXXXXXXXXXXXXXXXXXX

