--------------------------------------------------------------------------------------------------------------------------------------------------------------------------------------------------------
--------------------------------------------------------------------------------------------------------------------------------------------------------------------------------------------------------
--------------------------------------------------------------------------------------------------------------------------------------------------------------------------------------------------------
--------------------------------------------------------------------------------------------------------------------------------------------------------------------------------------------------------
--------------------------------------------------------------------------------------------------------------------------------------------------------------------------------------------------------
--------------------------------------------------------------------------------------------------------------------------------------------------------------------------------------------------------
--------------------------------------------------------------------------------------------------------------------------------------------------------------------------------------------------------
--------------------------------------------------------------------------------------------------------------------------------------------------------------------------------------------------------
--------------------------------------------------------------------------------------------------------------------------------------------------------------------------------------------------------
--------------------------------------------------------------------------------------------------------------------------------------------------------------------------------------------------------
--------------------------------------------------------------------------------------------------------------------------------------------------------------------------------------------------------
--------------------------------------------------------------------------------------------------------------------------------------------------------------------------------------------------------
--------------------------------------------------SSSoo------------------------oSooo--------------------oooooSo---ooSS-------------------------------SSS------------------------------------------------
-----------------------------SoSSo-----------------------------------------------------------------------------------------------------------------------------------------SSoSooo----------------------
--------------------------------------------------oooooo---------------oo-----ooo------oSoooo------------oooooo--ooooo----------oSo----------------ooooo---oSSS--------------------------------ooo------
----------------------------oooooo-----------------r--r----------------g------yr---------------------------k--Y--y---k--------------------Soo-----rr----------------------oooooooo--------------k-------
XXXXXXXXXXXXX-----------------y----gG----------XXXXXXXXXX-------R-----XXXXXXXXXXXXXXX-oooooo-----oo---XXXXXXXXXXXXXXXXXXX----oooooo--------------XXXXXXXXX---ooooo----------y-k--r-XXXXXXXXXXXXXXXX-----
XXXXXXXXXXXXX---XXXXX------XXXXXXXXXXX-oooooo--XXXXXXXXXXXXXXXXXXXXXXXXXXXXXXXXXXXXXX--r--------Rg----XXXXXXXXXXXXXXXXXXX----ykr---------oooooo--XXXXXXXXX---Ky-K-------XXXXXXXXXXXXXXXXXXXXXXXXXXXXXXXX
XXXXXXXXXXXXXXXXXXXXX--g---XXXXXXXXXXX---------XXXXXXXXXXXXXXXXXXXXXXXXXXXXXXXXXXXXXXXXXXXXXXXXXXXXX--XXXXXXXXXXXXXXXXXXX---XXXXXXXXXX-----K--g--XXXXXXXXXXXXXXXXXX-----XXXXXXXXXXXXXXXXXXXXXXXXXXXXXXXX
XXXXXXXXXXXXXXXXXXXXXXXXXXXXXXXXXXXXXXXXXXXXXXXXXXXXXXXXXXXXXXXXXXXXXXXXXXXXXXXXXXXXXXXXXXXXXXXXXXXXXXXXXXXXXXXXXXXXXXXXXXXXXXXXXXXXXXXXXXXXXXXXXXXXXXXXXXXXXXXXXXXXXXXXXXXXXXXXXXXXXXXXXXXXXXXXXXXXXXXX

