--------------------------------------------------------------------------------------------------------------------------------------------------------------------------------------------------------
--------------------------------------------------------------------------------------------------------------------------------------------------------------------------------------------------------
--------------------------------------------------------------------------------------------------------------------------------------------------------------------------------------------------------
--------------------------------------------------------------------------------------------------------------------------------------------------------------------------------------------------------
--------------------------------------------------------------------------------------------------------------------------------------------------------------------------------------------------------
--------------------------------------------------------------------------------------------------------------------------------------------------------------------------------------------------------
--------------------------------------------------------------------------------------------------------------------------------------------------------------------------------------------------------
--------------------------------------------------------------------------------------------------------------------------------------------------------------------------------------------------------
--------------------------------------------------------------------------------------------------------------------------------------------------------------------------------------------------------
--------------------------------------------------------------------------------------------------------------------------------------------------------------------------------------------------------
--------------------------------------------------------------------------------------------------------------------------------------------------------------------------------------------------------
--------------------------------------------------------------------------------------------------------------------------------------------------------------------------------------------------------
---------------------------------------------------------------------------------------------------------------------------------------------SSSoo----------------------------ooSoo---------------------
-----------oSSoo----------------------------------------------------------------------------------------------------------------------------------------------------------------------------------------
------------------------------------ooSoS-----------SoSoSS------------------------------------------------------------oSSoo------------------ooo------------ooo--------------oooo-----oooooo------------
-----------oooo---------------------------------------------------------------------oSo------------------------------------------------------g---------------rgr-------------k-y--g---------------------
---------------------XXXXXXX----XX---oooo----------ooooooo-------------------------------------------XXXXX---oo------oooooo----------------XXXXXXXXX-----XXXXXXXX----oooo-XXXXXXXXXX-ooooooo--XXXXX-----
----------XXXXXXXXX--XXXXXXX----XX-y----g---XXXXXX----r-R-k----------ooo-------k---ooooooo-XXX--oo---XXXXX--g-K------------k---------------XXXXXXXXXXXXXXXXXXXXXX-Y-Kky---XXXXXXXXXX---Y------XXXXX-----
XXXXXXXXXXXXXXXXXXX--XXXXXXXXXXXXXXXXXXXXXXXXXXXXXXXXXXXXXXX--------YY-----XXXXXX------G---XXX----y--XXXXXXXXXXX----XXXXXXXXX--g--G-----XXXXXXXXXXXXXXXXXXXXXXXXXXXXXXXXXXXXXXXXXXXXXXXXXXXXXXXXXXXXXXXX
XXXXXXXXXXXXXXXXXXXXXXXXXXXXXXXXXXXXXXXXXXXXXXXXXXXXXXXXXXXXXXXXXXXXXXXXXXXXXXXXXXXXXXXXXXXXXXXXXXXXXXXXXXXXXXXXXXXXXXXXXXXXXXXXXXXXXXXXXXXXXXXXXXXXXXXXXXXXXXXXXXXXXXXXXXXXXXXXXXXXXXXXXXXXXXXXXXXXXXXX

