--------------------------------------------------------------------------------------------------------------------------------------------------------------------------------------------------------
--------------------------------------------------------------------------------------------------------------------------------------------------------------------------------------------------------
--------------------------------------------------------------------------------------------------------------------------------------------------------------------------------------------------------
--------------------------------------------------------------------------------------------------------------------------------------------------------------------------------------------------------
--------------------------------------------------------------------------------------------------------------------------------------------------------------------------------------------------------
--------------------------------------------------------------------------------------------------------------------------------------------------------------------------------------------------------
--------------------------------------------------------------------------------------------------------------------------------------------------------------------------------------------------------
--------------------------------------------------------------------------------------------------------------------------------------------------------------------------------------------------------
--------------------------------------------------------------------------------------------------------------------------------------------------------------------------------------------------------
--------------------------------------------------------------------------------------------------------------------------------------------------------------------------------------------------------
--------------------------------------------------------------------------------------------------------------------------------------------------------------------------------------------------------
--------------------------------------------------------------------------------------------------------------------------------------------------------------------------------------------------------
------------oSooo--------------------------------------------------------------------------------------------------------------------------------SSoo------------------------oooo-----------------------
--------------------------------------------------------------------ooooo----------------------------------------Soo----oSoooS--------------------------------------------------------------------------
-----------ooooo---------------------------------ooooo------ooooo----------------------------------------------------------------oooo------------ooo------------------------oooo----oooooS--------------
-------------k-Y-------------------ooooooSo---------------------------ooo--------------Sooo----------------------ooooo---ooo-------G-yg--------g-K---r---oooSoSooo----------gy--r-----------------------
----------XXXXXXXXXX-gy--------------------------oooo--XXXX------------k-gr-------------------------------------y-------------g-XXXXXXXX------XXXXXXXXXX-------------------XXXXXXXX----ooooo------------
XXXXXXXXXXXXXXXXXXXXXXXXXX-ooo------oooooooo----R--y---XXXX-------XXXXXXXXXX------XX--ooooo------ooooo--oooooo-XXXXXXXXXXXXXXXXXXXXXXXXX------XXXXXXXXXX--ooooo------------XXXXXXXX-----y-GG---oooo-----
XXXXXXXXXXXXXXXXXXXXXXXXXX----------Kgg--rGK-XXXXXXXXXXXXXXXXXXXXXXXXXXXXXXX------XX-krR--G--k-----yY-----K----XXXXXXXXXXXXXXXXXXXXXXXXX-k-y--XXXXXXXXXX-k-gr-------g---y--XXXXXXXXXXXXXXXXXXX--Gy---XXX
XXXXXXXXXXXXXXXXXXXXXXXXXXXXXXXXXXXXXXXXXXXXXXXXXXXXXXXXXXXXXXXXXXXXXXXXXXXXXXXXXXXXXXXXXXXXXXXXXXXXXXXXXXXXXXXXXXXXXXXXXXXXXXXXXXXXXXXXXXXXXXXXXXXXXXXXXXXXXXXXXXXXXXXXXXXXXXXXXXXXXXXXXXXXXXXXXXXXXXXX

