--------------------------------------------------------------------------------------------------------------------------------------------------------------------------------------------------------
--------------------------------------------------------------------------------------------------------------------------------------------------------------------------------------------------------
--------------------------------------------------------------------------------------------------------------------------------------------------------------------------------------------------------
--------------------------------------------------------------------------------------------------------------------------------------------------------------------------------------------------------
--------------------------------------------------------------------------------------------------------------------------------------------------------------------------------------------------------
--------------------------------------------------------------------------------------------------------------------------------------------------------------------------------------------------------
--------------------------------------------------------------------------------------------------------------------------------------------------------------------------------------------------------
--------------------------------------------------------------------------------------------------------------------------------------------------------------------------------------------------------
--------------------------------------------------------------------------------------------------------------------------------------------------------------------------------------------------------
--------------------------------------------------------------------------------------------------------------------------------------------------------------------------------------------------------
--------------------------------------------------------------------------------------------------------------------------------------------------------------------------------------------------------
--------------------------------------------------------------------------------------------------------------------------------------------------------------------------------------------------------
-----------------------ooo-------------------------------------------------------------------------------------Soo--------------------------------------------------------------------------------------
----------------------------------------------------------------------------------------------------------------------------------------------------------------------ooSSoo----------------------------
------------------------ooooo-----------------SooSoSo----------------ooSS--------------------------------------ooooo-----SoooS--------ooooo-------------------------------------oo----------------------
---------------------y-----k----oo---------------------ooooooS---------------------ooooo--------------Sooo-----yY-k-----------------------YgY----Soo-------------------oooo---g-k----oSooo--------------
--------------XXXX--XXXXXXXXXX-y----XXXXX------ooo--------------------ooooo-XXXXX---g-g--------------------XXXXXXXXXXX----ooo--------XXXXXXXXX--------------------------kr---XXXXXX----------K----------
XXXXXXXXXXXXXXXXXX--XXXXXXXXXXXXXXXXXXXXXXX---------g---oooooo-----g--ykr---XXXXXXXXXXXXX---------------oo-XXXXXXXXXXX-k-------k-XXXXXXXXXXXXX----ooo---XXXXXX---XXXXXXXXXXXXXXXXXX-ooooo---XXXXXX--ooo-
XXXXXXXXXXXXXXXXXXXXXXXXXXXXXXXXXXXXXXXXXXXXXXXXXXXXXX-r---g----XXXXXXXXXXXXXXXXXXXXXXXXX-------XXXX--r----XXXXXXXXXXXXXXXXXXXXXXXXXXXXXXXXXXX----------XXXXXX---XXXXXXXXXXXXXXXXXX-R--gk---XXXXXX----K-
XXXXXXXXXXXXXXXXXXXXXXXXXXXXXXXXXXXXXXXXXXXXXXXXXXXXXXXXXXXXXXXXXXXXXXXXXXXXXXXXXXXXXXXXXXXXXXXXXXXXXXXXXXXXXXXXXXXXXXXXXXXXXXXXXXXXXXXXXXXXXXXXXXXXXXXXXXXXXXXXXXXXXXXXXXXXXXXXXXXXXXXXXXXXXXXXXXXXXXXX

