--------------------------------------------------------------------------------------------------------------------------------------------------------------------------------------------------------
--------------------------------------------------------------------------------------------------------------------------------------------------------------------------------------------------------
--------------------------------------------------------------------------------------------------------------------------------------------------------------------------------------------------------
--------------------------------------------------------------------------------------------------------------------------------------------------------------------------------------------------------
--------------------------------------------------------------------------------------------------------------------------------------------------------------------------------------------------------
--------------------------------------------------------------------------------------------------------------------------------------------------------------------------------------------------------
--------------------------------------------------------------------------------------------------------------------------------------------------------------------------------------------------------
--------------------------------------------------------------------------------------------------------------------------------------------------------------------------------------------------------
--------------------------------------------------------------------------------------------------------------------------------------------------------------------------------------------------------
--------------------------------------------------------------------------------------------------------------------------------------------------------------------------------------------------------
--------------------------------------------------------------------------------------------------------------------------------------------------------------------------------------------------------
-----------------------------------------------------------------------------------------------------------------------oooooo---------------------------------------------------------------------------
--------------------------oSo------------------------------------------------------------SoSoS----------SSo------------g-kg-----------------------------------------------------------------------------
----------------oSSoo----------------------------oooSo-----------------------------------------------------------------%%%%%%%------------------------ooSo----------ooooooo-----------------------------
------------------------------------------------------------oSoSo-------------------------oooo-------ooooooo-----------|||||||---oSoSoSo----------------------------------------------------------------
----------------ooo-----K-----------------------ooooooo---------------------------------g-r-------------gk-------------|||||||--------------oooS--------------------oooo----------y-----oSoSoSo---------
-----------XXXX-g------XXXXXXXXXXXX--------g----------RG----ooooooo----ooo---XXXXXXXX--XXXXXXXXXX---XXXXXXXXXX---------y|||||g---oooo------------------------------g----Y--------XXXXXX-------------XXXX
-----------XXXXXXXXXXXXXXXXXXXXXXXX----XXXXXXXXXXXXXXXXXX-Y--kgg--Y--------R-XXXXXXXX--XXXXXXXXXXXXXXXXXXXXXXXXXXXXXXXXXXXXXXXXX------k------oo----XXXXXXXX---oo-XXXXXXXXXXX-----XXXXXX-ooooooo-----XXXX
XXXXXXXXXXXXXXXXXXXXXXXXXXXXXXXXXXXXXXXXXXXXXXXXXXXXXXXXXXXXXXXXXXXXXXXXXXXXXXXXXXXXXXXXXXXXXXXXXXXXXXXXXXXXXXXXXXXXXXXXXXXXXXXXXXXXXXXXX----y-G---XXXXXXXX-ryR--XXXXXXXXXXXXXXXXXXXXXX--y-rY-------XXXX
XXXXXXXXXXXXXXXXXXXXXXXXXXXXXXXXXXXXXXXXXXXXXXXXXXXXXXXXXXXXXXXXXXXXXXXXXXXXXXXXXXXXXXXXXXXXXXXXXXXXXXXXXXXXXXXXXXXXXXXXXXXXXXXXXXXXXXXXXXXXXXXXXXXXXXXXXXXXXXXXXXXXXXXXXXXXXXXXXXXXXXXXXXXXXXXXXXXXXXXX

