--------------------------------------------------------------------------------------------------------------------------------------------------------------------------------------------------------
--------------------------------------------------------------------------------------------------------------------------------------------------------------------------------------------------------
--------------------------------------------------------------------------------------------------------------------------------------------------------------------------------------------------------
--------------------------------------------------------------------------------------------------------------------------------------------------------------------------------------------------------
--------------------------------------------------------------------------------------------------------------------------------------------------------------------------------------------------------
--------------------------------------------------------------------------------------------------------------------------------------------------------------------------------------------------------
--------------------------------------------------------------------------------------------------------------------------------------------------------------------------------------------------------
--------------------------------------------------------------------------------------------------------------------------------------------------------------------------------------------------------
--------------------------------------------------------------------------------------------------------------------------------------------------------------------------------------------------------
--------------------------------------------------------------------------------------------------------------------------------------------------------------------------------------------------------
--------------------------------------------------------------------------------------------------------------------------------------------------------------------------------------------------------
--------------------------------------------------------------------------------------------------------------------------------------------------------------------------------------------------------
-------------------------oooSoo----------------------Sooo-------ooo--------------------------------------------------------oSoo-------------------SoSS---------------oSo--------------------------------
---------------------------------------ooo--------------------------------------------------SoSSSoSo--------------------------------------------------------------------------ooSooo--------------------
--------------------------oooooo---------------------ooo--------ooo---------------------------------------ooo--------------oooo-----ooSoSoo------oooooo-----------ooooo------------------oooo-----------
--------------ooSoSo-----g-k----kk------oooo---------------------y-k-------------------------ooooooo------r------------------y-----------------rY--k-K-------------Y----------ooooo---------------------
------------------------XXXXXXXXXXX-----rR--------XXXXXXXXX----XXXXXXXX------------XXXXX-------y-------XXXXXXXXXXXXXXXXXXXXXXXXXXXX----oooooo-XXXXXXXXXX----XXXXXXXXXXXXX-----k---y-----oooo------------
----------------ooooo---XXXXXXXXXXX---XXXXXXX-----XXXXXXXXX----XXXXXXXX------------XXXXX--XXXXXXXXXXX--XXXXXXXXXXXXXXXXXXXXXXXXXXXX---y-Yyg---XXXXXXXXXX----XXXXXXXXXXXXX----XXXXXXXXXX------------XXXXX
XXXXXXXXXXXXX---ry---y--XXXXXXXXXXX---XXXXXXXXXXXXXXXXXXXXX----XXXXXXXX--XXXXXXXXXXXXXXXXXXXXXXXXXXXX--XXXXXXXXXXXXXXXXXXXXXXXXXXXXXXXXXXXXXXXXXXXXXXXXX----XXXXXXXXXXXXX----XXXXXXXXXXXXXXXXXXX---XXXXX
XXXXXXXXXXXXXXXXXXXXXXXXXXXXXXXXXXXXXXXXXXXXXXXXXXXXXXXXXXXXXXXXXXXXXXXXXXXXXXXXXXXXXXXXXXXXXXXXXXXXXXXXXXXXXXXXXXXXXXXXXXXXXXXXXXXXXXXXXXXXXXXXXXXXXXXXXXXXXXXXXXXXXXXXXXXXXXXXXXXXXXXXXXXXXXXXXXXXXXXX

