--------------------------------------------------------------------------------------------------------------------------------------------------------------------------------------------------------
--------------------------------------------------------------------------------------------------------------------------------------------------------------------------------------------------------
--------------------------------------------------------------------------------------------------------------------------------------------------------------------------------------------------------
--------------------------------------------------------------------------------------------------------------------------------------------------------------------------------------------------------
--------------------------------------------------------------------------------------------------------------------------------------------------------------------------------------------------------
--------------------------------------------------------------------------------------------------------------------------------------------------------------------------------------------------------
--------------------------------------------------------------------------------------------------------------------------------------------------------------------------------------------------------
--------------------------------------------------------------------------------------------------------------------------------------------------------------------------------------------------------
--------------------------------------------------------------------------------------------------------------------------------------------------------------------------------------------------------
--------------------------------------------------------------------------------------------------------------------------------------------------------------------------------------------------------
--------------------------------------------------------------------------------------------------------------------------------------------------------------------------------------------------------
--------------------------------------------------------------------------------------------------------------------------------------------------------------------------------------------------------
------------------------------------------------oooSo------------------------------------------------------------------------------------------oSoS-----------------------------------------------------
--------------oSSo------------------------------------------ooSSoo-----------------------------------------------------------------------------------------------------------------------oSoooo---------
------------------------------oooo------------oooooo-------------------oo----oSooo---------------------------------------------------------------ooo--------------oSo-----------------------------------
----------------oooo------------Y-------------K---k--------ooooo----k-----------------oooS-----------------------------oooooo-------------------R-------oSSSoo----------------oooooS-----oooo-------ooo-
----------------g---------K-XXXXXXX---------XXXXXXXXXX-----r-g---k-XXXXXXXX-oooo--------------------------------Kk------G--rg---------XXXXXXXXXXXXXXX-----------------------------------kk-kY-----rY----
------------XXXXXXXXXXXXXXXXXXXXXXX-oooooo--XXXXXXXXXXXXXXXXXXXXXXXXXXXXXXX------k----ooooo---XXX------ooooo-XXXXXXXXXXXXXXXXX-oooooo-XXXXXXXXXXXXXXX------oo-------R----------ooooo--XXXXXXXXXXXXXXXXXX
XXXXXXXXXXXXXXXXXXXXXXXXXXXXXXXXXXX-y---k---XXXXXXXXXXXXXXXXXXXXXXXXXXXXXXXXXXXXXXX-K---rrR---XXXXXXXX-K-----XXXXXXXXXXXXXXXXX----gk--XXXXXXXXXXXXXXX---kY-----XXXXXXXXXXXX-----gr----XXXXXXXXXXXXXXXXXX
XXXXXXXXXXXXXXXXXXXXXXXXXXXXXXXXXXXXXXXXXXXXXXXXXXXXXXXXXXXXXXXXXXXXXXXXXXXXXXXXXXXXXXXXXXXXXXXXXXXXXXXXXXXXXXXXXXXXXXXXXXXXXXXXXXXXXXXXXXXXXXXXXXXXXXXXXXXXXXXXXXXXXXXXXXXXXXXXXXXXXXXXXXXXXXXXXXXXXXXX

