--------------------------------------------------------------------------------------------------------------------------------------------------------------------------------------------------------
--------------------------------------------------------------------------------------------------------------------------------------------------------------------------------------------------------
--------------------------------------------------------------------------------------------------------------------------------------------------------------------------------------------------------
--------------------------------------------------------------------------------------------------------------------------------------------------------------------------------------------------------
--------------------------------------------------------------------------------------------------------------------------------------------------------------------------------------------------------
--------------------------------------------------------------------------------------------------------------------------------------------------------------------------------------------------------
--------------------------------------------------------------------------------------------------------------------------------------------------------------------------------------------------------
--------------------------------------------------------------------------------------------------------------------------------------------------------------------------------------------------------
--------------------------------------------------------------------------------------------------------------------------------------------------------------------------------------------------------
--------------------------------------------------------------------------------------------------------------------------------------------------------------------------------------------------------
--------------------------------------------------------------------------------------------------------------------------------------------------------------------------------------------------------
--------------------------------------------------------------------------------------------------------------------------------------------------------------------------------------------------------
------------------------------------------------------------------oooo---------------------------------------------------------------------------------------------------------------------ooS----------
------------------------------------------------------------------------------------ooS----------------------------------Soo-------------------------------oSSo---------oSo-----------------------------
-------------------------oooooo-------------------------oooo----ooooo----------------------------oooSSSoo-------------------------------SSooSo---------------------------------------------oooo---------
-------------------G-k----k------------------oooSoo----------------G-------------------------g---------------ooSooo-----oooo-----------------------ooS-----ooo---------oooo---------------------g-------
XXXXXXXXXX-------XXXXXXXXXXXXXXXXXXXX-----------------ooooooo-XXXXXXXXX---------------R--XXXXXX-ooooooo----------------G-----------G-----ooooo-------------r-RR-XXXXX----Y--XXX----------XXXXXXXXX------
XXXXXXXXXX---XXXXXXXXXXXXXXXXXXXXXXXX--------oooooo---Ry---gg-XXXXXXXXX------------XXXXXXXXXXXX-rk-g-------oooooooo--XXXXXXXXXXXXXXXXX-g-R---r-----oo---XXXXXXXXXXXXXXXXXXXXXXXXX--------XXXXXXXXXXXXXXX
XXXXXXXXXX---XXXXXXXXXXXXXXXXXXXXXXXX--K------Kk--K-XXXXXXXXXXXXXXXXXXX--XXXXX-----XXXXXXXXXXXXXXXXXXXXXXX-g--y-Yrg--XXXXXXXXXXXXXXXXXXXXXXXXXXX---rkr--XXXXXXXXXXXXXXXXXXXXXXXXX---R----XXXXXXXXXXXXXXX
XXXXXXXXXXXXXXXXXXXXXXXXXXXXXXXXXXXXXXXXXXXXXXXXXXXXXXXXXXXXXXXXXXXXXXXXXXXXXXXXXXXXXXXXXXXXXXXXXXXXXXXXXXXXXXXXXXXXXXXXXXXXXXXXXXXXXXXXXXXXXXXXXXXXXXXXXXXXXXXXXXXXXXXXXXXXXXXXXXXXXXXXXXXXXXXXXXXXXXXX

