--------------------------------------------------------------------------------------------------------------------------------------------------------------------------------------------------------
--------------------------------------------------------------------------------------------------------------------------------------------------------------------------------------------------------
--------------------------------------------------------------------------------------------------------------------------------------------------------------------------------------------------------
--------------------------------------------------------------------------------------------------------------------------------------------------------------------------------------------------------
--------------------------------------------------------------------------------------------------------------------------------------------------------------------------------------------------------
--------------------------------------------------------------------------------------------------------------------------------------------------------------------------------------------------------
--------------------------------------------------------------------------------------------------------------------------------------------------------------------------------------------------------
--------------------------------------------------------------------------------------------------------------------------------------------------------------------------------------------------------
--------------------------------------------------------------------------------------------------------------------------------------------------------------------------------------------------------
--------------------------------------------------------------------------------------------------------------------------------------------------------------------------------------------------------
--------------------------------------------------------------------------------------------------------------------------------------------------------------------------------------------------------
--------------------------------------------------------------------------------------------------------------------------------------------------------------------------------------------------------
-------------ooSo------------------SSoSoo-------------------------------------oooSoS------------------------------------oooSooo-------------------------------------------------------------------------
-------------------------------------------------------------------------------------------------------------------------------------------------------Sooo-----oooo----ooSo--ooSSo----------------oSo--
--------------------oo-----------ooooo-----------------------ooS---------------oooooo-----------------------------------oooooo-------------------------------------------------------------SSo----------
-------------k-----y-g-----------g-kkk-------SSSoS-------------------SoSS-----------r-----------------------SSooo--------R-Ryg----SoSSo----g-----------oooo-----oooo-----oo---oooooo--------------------
------------XXXXXXXXXXXX-------XXXXXXXXXXX-------------K-----ooooo-----------XXXXXXXXX-------XXXXX-Y-------------------XXXXXXXXX--------XXXXXX-------g-y--G--YRrgKG------r-Y---ry-y-y---ooo-----RKr-y---
------------XXXXXXXXXXXX-------XXXXXXXXXXX---oooo----XXXXXX----gk----oooo----XXXXXXXXXXXXX---XXXXXXXXXXXX--oooo--------XXXXXXXXX-ooo----XXXXXXXXXXXXXXXXXXXXXXXXXXXXXXXXXXXXXXXXXXXXXXX--------XXXXXXXXX
XXXXXXXXXXXXXXXXXXXXXXXXXXXXXXXXXXXXXXXXXX----gRr----XXXXXXXXXXXXXX----------XXXXXXXXXXXXXXXXXXXXXXXXXXXX-Kr--kG--XXX--XXXXXXXXX-y------XXXXXXXXXXXXXXXXXXXXXXXXXXXXXXXXXXXXXXXXXXXXXXXXXXXXXXXXXXXXXXXX
XXXXXXXXXXXXXXXXXXXXXXXXXXXXXXXXXXXXXXXXXXXXXXXXXXXXXXXXXXXXXXXXXXXXXXXXXXXXXXXXXXXXXXXXXXXXXXXXXXXXXXXXXXXXXXXXXXXXXXXXXXXXXXXXXXXXXXXXXXXXXXXXXXXXXXXXXXXXXXXXXXXXXXXXXXXXXXXXXXXXXXXXXXXXXXXXXXXXXXXX

