--------------------------------------------------------------------------------------------------------------------------------------------------------------------------------------------------------
--------------------------------------------------------------------------------------------------------------------------------------------------------------------------------------------------------
--------------------------------------------------------------------------------------------------------------------------------------------------------------------------------------------------------
--------------------------------------------------------------------------------------------------------------------------------------------------------------------------------------------------------
--------------------------------------------------------------------------------------------------------------------------------------------------------------------------------------------------------
--------------------------------------------------------------------------------------------------------------------------------------------------------------------------------------------------------
--------------------------------------------------------------------------------------------------------------------------------------------------------------------------------------------------------
--------------------------------------------------------------------------------------------------------------------------------------------------------------------------------------------------------
--------------------------------------------------------------------------------------------------------------------------------------------------------------------------------------------------------
--------------------------------------------------------------------------------------------------------------------------------------------------------------------------------------------------------
--------------------------------------------------------------------------------------------------------------------------------------------------------------------------------------------------------
--------------------------------------------------------------------------------------------------------------------------------------------------------------------------------------------------------
---------------------ooooSoS--------------oSooo--------------------------------------------ooo----------------------------------------------------------------------------------------------------------
-------------------------------------------------------------------------------------------------oSo-------------------------------------------------------------------------------------------oSSSooSo-
----------------------ooooo-----------------oooo-----------------oSooSo-----------------------------------------ooooooo---------------------------------------------------------------------------------
-----------ooooo------------g--------ooo----Yy---------------------------------------------Y-----oooo------ooo--------------ooooSo------------------oSooS-------------------oSo-------Soooo-------ooo---
--------------------XXXXXXXXXX------g----XXXXXXXXXX-------------ooooooo------oo---XXX-----XXXXXX-----yY---kg-------oo-----------------------------------------------XXXXXXX--------------------r-r------
-------------ooooo--XXXXXXXXXX-----XXXXXXXXXXXXXXXX---------XXX-r----rk------Ky---XXX-----XXXXXXXXXXXXXXXXXXXXX-r-rrG----XX---oooo------------XXXXX-oooooooo--------XXXXXXX---oo------ooooooo-XXXXXXXXXX
XXXXXXXXXX-r-----yG-XXXXXXXXXX-----XXXXXXXXXXXXXXXX---k--r--XXXXXXXXXXXXXXXXXXXXXXXXX-----XXXXXXXXXXXXXXXXXXXXXXXXXXXXXXXXX-------------XXXX--XXXXX--g-r-gr-----XXXXXXXXXXX--gR--g--k-k-y-----XXXXXXXXXX
XXXXXXXXXXXXXXXXXXXXXXXXXXXXXXXXXXXXXXXXXXXXXXXXXXXXXXXXXXXXXXXXXXXXXXXXXXXXXXXXXXXXXXXXXXXXXXXXXXXXXXXXXXXXXXXXXXXXXXXXXXXXXXXXXXXXXXXXXXXXXXXXXXXXXXXXXXXXXXXXXXXXXXXXXXXXXXXXXXXXXXXXXXXXXXXXXXXXXXXX

