--------------------------------------------------------------------------------------------------------------------------------------------------------------------------------------------------------
--------------------------------------------------------------------------------------------------------------------------------------------------------------------------------------------------------
--------------------------------------------------------------------------------------------------------------------------------------------------------------------------------------------------------
--------------------------------------------------------------------------------------------------------------------------------------------------------------------------------------------------------
--------------------------------------------------------------------------------------------------------------------------------------------------------------------------------------------------------
--------------------------------------------------------------------------------------------------------------------------------------------------------------------------------------------------------
--------------------------------------------------------------------------------------------------------------------------------------------------------------------------------------------------------
--------------------------------------------------------------------------------------------------------------------------------------------------------------------------------------------------------
--------------------------------------------------------------------------------------------------------------------------------------------------------------------------------------------------------
--------------------------------------------------------------------------------------------------------------------------------------------------------------------------------------------------------
--------------------------------------------------------------------------------------------------------------------------------------------------------------------------------------------------------
--------------------------------------------------------------------------------------------------------------------------------------------------------------------------------------------------------
-------------------------------------------------SSSo---oooooS--------------oSoSoS-------------------------------------ooooo----------ooS---------------------------------------------------------oSo---
------------------------------------------------------------------ooooo---------------------------Sooo------oSoooSooo---------------------------------------------------ooSoo---------------------------
-----------oSoo-------------------------ooooo--ooooooo----ooo----------------oooooo---oooooSo---------------------------ooooooo------ooooo--------------------------------------------------------oooo--
---------------------------------------r-r-----g--k--y--r-----r-----oooo---r----k--r------------oooooooo----ooooooooo--yRy-r-rr-----K--YYr------------------------------oooooooo----------ooo------yK---
------------------XXXX----------------XXXXXXXXXXXXXXXXXXXXXXXXXX--r-----G-XXXXXXXXXXX---ooooo----k---g---XX-----------XXXXXXXXXXXXXXXXXXXXXXXXX------------------------------gg--XX--------------XXXXXXX
----------------XXXXXX---ooo-XXXXX----XXXXXXXXXXXXXXXXXXXXXXXXXXXXXXXXXXXXXXXXXXXXXXX-kRr------XXXXXXXXXXXXXXXXXXXXXXXXXXXXXXXXXXXXXXXXXXXXXXXX-------------------g----XXXXXXXXXXXX--------oooo--XXXXXXX
XXXXXXXXXXXXXXXXXXXXXX---rG--XXXXX----XXXXXXXXXXXXXXXXXXXXXXXXXXXXXXXXXXXXXXXXXXXXXXXXXXXXXXXXXXXXXXXXXXXXXXXXXXXXXXXXXXXXXXXXXXXXXXXXXXXXXXXXX--r-y-G------XXXXXXXXXXXXXXXXXXXXXXX-------yY-----XXXXXXX
XXXXXXXXXXXXXXXXXXXXXXXXXXXXXXXXXXXXXXXXXXXXXXXXXXXXXXXXXXXXXXXXXXXXXXXXXXXXXXXXXXXXXXXXXXXXXXXXXXXXXXXXXXXXXXXXXXXXXXXXXXXXXXXXXXXXXXXXXXXXXXXXXXXXXXXXXXXXXXXXXXXXXXXXXXXXXXXXXXXXXXXXXXXXXXXXXXXXXXXX

