--------------------------------------------------------------------------------------------------------------------------------------------------------------------------------------------------------
--------------------------------------------------------------------------------------------------------------------------------------------------------------------------------------------------------
--------------------------------------------------------------------------------------------------------------------------------------------------------------------------------------------------------
--------------------------------------------------------------------------------------------------------------------------------------------------------------------------------------------------------
--------------------------------------------------------------------------------------------------------------------------------------------------------------------------------------------------------
--------------------------------------------------------------------------------------------------------------------------------------------------------------------------------------------------------
--------------------------------------------------------------------------------------------------------------------------------------------------------------------------------------------------------
--------------------------------------------------------------------------------------------------------------------------------------------------------------------------------------------------------
--------------------------------------------------------------------------------------------------------------------------------------------------------------------------------------------------------
--------------------------------------------------------------------------------------------------------------------------------------------------------------------------------------------------------
--------------------------------------------------------------------------------------------------------------------------------------------------------------------------------------------------------
--------------------------------------------------------------------------------------------------------------------------------------------------------------------------------------------------------
--------------------------------------oSoooo-----------------------------------------------oSSSSS----------------------------------------------------------------------oSo------------------------------
------------------------------------------------ooo----------oooSooo--------------------------------------------oSSo------------------------------------ooooo----------------------oooSSSoo-------------
--------------------------------------oooo---------------oo-------------Soo-----------------ooo-----------------------------------------------------------------------ooo-------------------------------
------------oSoS---------ooo---------Kk--y--R---ooooo--------oooooo----------------oo------Rk--r-r------------ooooooo-----------------oSSS------SoS-------ooo----------R-------------oooo---------------
------------------------------------XXXXXXXXXX-Y------XXXXXX-Rr---Y-r--ooooo-------k----XXXXXXXXXXX-----XXXXX----r--y-------oo----XXX---------------------yg-------XXXXXXXXXXXXXX-yr-r--y-------XX--G-g-
XXXXXXXXXX----ooo--------------XXXXXXXXXXXXXXXXXXXXXXXXXXXXXXXXXXXXXXX---kr----XXXXXXXXXXXXXXXXXXXX-----XXXXXXXXXXXXXX---------r--XXX--oooo-----oooo---XXXXXXXX----XXXXXXXXXXXXXXXXXXXXXXXXXXXXXXXXXXXXX
XXXXXXXXXX-yg------XXXXX-R--G--XXXXXXXXXXXXXXXXXXXXXXXXXXXXXXXXXXXXXXXXXXXXXXXXXXXXXXXXXXXXXXXXXXXX-----XXXXXXXXXXXXXXXXXXXXXXXXXXXXX--gG--Y--------k--XXXXXXXXXXXXXXXXXXXXXXXXXXXXXXXXXXXXXXXXXXXXXXXXX
XXXXXXXXXXXXXXXXXXXXXXXXXXXXXXXXXXXXXXXXXXXXXXXXXXXXXXXXXXXXXXXXXXXXXXXXXXXXXXXXXXXXXXXXXXXXXXXXXXXXXXXXXXXXXXXXXXXXXXXXXXXXXXXXXXXXXXXXXXXXXXXXXXXXXXXXXXXXXXXXXXXXXXXXXXXXXXXXXXXXXXXXXXXXXXXXXXXXXXXX

