--------------------------------------------------------------------------------------------------------------------------------------------------------------------------------------------------------
--------------------------------------------------------------------------------------------------------------------------------------------------------------------------------------------------------
--------------------------------------------------------------------------------------------------------------------------------------------------------------------------------------------------------
--------------------------------------------------------------------------------------------------------------------------------------------------------------------------------------------------------
--------------------------------------------------------------------------------------------------------------------------------------------------------------------------------------------------------
--------------------------------------------------------------------------------------------------------------------------------------------------------------------------------------------------------
--------------------------------------------------------------------------------------------------------------------------------------------------------------------------------------------------------
--------------------------------------------------------------------------------------------------------------------------------------------------------------------------------------------------------
--------------------------------------------------------------------------------------------------------------------------------------------------------------------------------------------------------
--------------------------------------------------------------------------------------------------------------------------------------------------------------------------------------------------------
--------------------------------------------------------------------------------------------------------------------------------------------------------------------------------------------------------
--------------------------------------------------------------------------------------------------------------------------------------------------------------------------------------------------------
--------------------------------------------------ooooS-----------------------oSoo---oSoooS-----------------------------------------------------------------------ooS-----------------------------------
-------------------------------------------------------------------------------------------------------------oSoSSSo------------------------------------------------------------------------------------
-------------------------------------------------ooooo-----------------------oooo---oooooo---------X---X------------------------------oSoS-----------------------ooooo-------------------SoSSoo---------
-------------------------SoooSo----------oSoSo---k--yk----oooo-----------------k-y------kG--------XX---XX-----ooo----------ooo----------------------------------K--r----oSoo----------------------------
----------XXXXXXX------------------------------XXXXXXXXXX---yk------------XXXXXXXXXXXXXXXXXXX----XXX---XXX---yY---gR-----r-Rkr--XXX---ooooooo------ooo---------XXXXXXXX---------y--k----ooooooo--------X
----------XXXXXXX---Y-----ooooo---------oooooo-XXXXXXXXXXXXXXXX-----------XXXXXXXXXXXXXXXXXXX--XXXXX---XXXXXXXXXXXXXX---XXXXXXXXXXX-kRy--k-r--XXXX---g--XXXXX--XXXXXXXX--oooo--XXXXXXXX----------------X
XXXXXXXXXXXXXXXXXXXXXXX-K-kg-g--K------------r-XXXXXXXXXXXXXXXX------gg-y-XXXXXXXXXXXXXXXXXXXXXXXXXX---XXXXXXXXXXXXXXXXXXXXXXXXXXXXXXXXXXXXXXXXXXXXXXXXXXXXXX--XXXXXXXX--------XXXXXXXXXXXXXXXXXXXXXXXXX
XXXXXXXXXXXXXXXXXXXXXXXXXXXXXXXXXXXXXXXXXXXXXXXXXXXXXXXXXXXXXXXXXXXXXXXXXXXXXXXXXXXXXXXXXXXXXXXXXXXX---XXXXXXXXXXXXXXXXXXXXXXXXXXXXXXXXXXXXXXXXXXXXXXXXXXXXXXXXXXXXXXXXXXXXXXXXXXXXXXXXXXXXXXXXXXXXXXXXX

