--------------------------------------------------------------------------------------------------------------------------------------------------------------------------------------------------------
--------------------------------------------------------------------------------------------------------------------------------------------------------------------------------------------------------
--------------------------------------------------------------------------------------------------------------------------------------------------------------------------------------------------------
--------------------------------------------------------------------------------------------------------------------------------------------------------------------------------------------------------
--------------------------------------------------------------------------------------------------------------------------------------------------------------------------------------------------------
--------------------------------------------------------------------------------------------------------------------------------------------------------------------------------------------------------
--------------------------------------------------------------------------------------------------------------------------------------------------------------------------------------------------------
--------------------------------------------------------------------------------------------------------------------------------------------------------------------------------------------------------
--------------------------------------------------------------------------------------------------------------------------------------------------------------------------------------------------------
--------------------------------------------------------------------------------------------------------------------------------------------------------------------------------------------------------
--------------------------------------------------------------------------------------------------------------------------------------------------------------------------------------------------------
--------------------------------------------------------------------------------------------------------------------------------------------------------------------------------------------------------
-------------------------------------------------------------------------------------------------------------------------oSSooo-----------------------------------ooooSooo--------SSo-------------------
--------------------------------------------------------------------------------------Soo---------------oSoo----SoSo---------------ooo-------------------oSSoooo----------------------------------------
--------------------------------------------------ooo---------------------------SSo-----------------------------------ooooooooo--------------------------------------oooo------------------------oSo----
--------------------------------------------------K---------------oooo-----------------oooo-----ooo----oooo------------------g----ooooooo------------------oooo------k-----------y----------------------
XXXXXXXXXXX-----------y-KY--gk---XXXXX---------XXXXXXXX---------------------------------rYy---k---Y--y---y-R---ry----XXXXXXXXXXX---G-------ooo------XXX-Gk---K---XXXXXXXXXX----XXXXXXXXXXXX-------------
XXXXXXXXXXX------YY-XXXXXXXXXXXXXXXXXX---ooooo-XXXXXXXX------------oooo-XXXX--------XXXXXXXXXXXXXXXXXXXXXXXXXXXXXXXXXXXXXXXXXXXXXXXXXXXXXX----------XXXXXXXXXXXXXXXXXXXXXXXXXXXXXXXXXXXXXXXXXXXX--K-----
XXXXXXXXXXX---XXXXXXXXXXXXXXXXXXXXXXXX--k--rrK-XXXXXXXX-----XXXX---r--r-XXXXXXXXXXXXXXXXXXXXXXXXXXXXXXXXXXXXXXXXXXXXXXXXXXXXXXXXXXXXXXXXXXXXXXXX----XXXXXXXXXXXXXXXXXXXXXXXXXXXXXXXXXXXXXXXXXXXXXXXXXXX-
XXXXXXXXXXXXXXXXXXXXXXXXXXXXXXXXXXXXXXXXXXXXXXXXXXXXXXXXXXXXXXXXXXXXXXXXXXXXXXXXXXXXXXXXXXXXXXXXXXXXXXXXXXXXXXXXXXXXXXXXXXXXXXXXXXXXXXXXXXXXXXXXXXXXXXXXXXXXXXXXXXXXXXXXXXXXXXXXXXXXXXXXXXXXXXXXXXXXXXXX

