--------------------------------------------------------------------------------------------------------------------------------------------------------------------------------------------------------
--------------------------------------------------------------------------------------------------------------------------------------------------------------------------------------------------------
--------------------------------------------------------------------------------------------------------------------------------------------------------------------------------------------------------
--------------------------------------------------------------------------------------------------------------------------------------------------------------------------------------------------------
--------------------------------------------------------------------------------------------------------------------------------------------------------------------------------------------------------
--------------------------------------------------------------------------------------------------------------------------------------------------------------------------------------------------------
--------------------------------------------------------------------------------------------------------------------------------------------------------------------------------------------------------
--------------------------------------------------------------------------------------------------------------------------------------------------------------------------------------------------------
--------------------------------------------------------------------------------------------------------------------------------------------------------------------------------------------------------
--------------------------------------------------------------------------------------------------------------------------------------------------------------------------------------------------------
--------------------------------------------------------------------------------------------------------------------------------------------------------------------------------------------------------
--------------------------------------------------------------------------------------------------------------------------------------------------------------------------------------------------------
---------------------------------------------------------------------oSSS------oSoS----------------------oooo-------------------------------------------------------------------------------------------
------------------oSoSoo-----ooooo------------------------oSSSo-----------------------------Sooooo----------------------oSoS--------------------------------------------------------ooSoo---------------
--------------------------------------------------------------------oooooo-----oooo---------------------------------------------------------SoSoS--------------------oSo--------------------------------
---------------------oooooo--oooo----------------oSo----------------rY----------y---------oooooo----------y-------oo----oo-----------G-----------------------K-k----------------------oooo--------------
-------------------------yY---k--R-----oooo----------XXXX-r--------XXXXXXXXXXXXXXXXXXX----K-y---------XXXXXXXX-y----g------kG-XXXXXXXXXXXX--ooooooo------XXXXXXXX-ooooooo-----------yrg-----------ooooo-
XXXXXXXXXXXXXXXXXXXXXXXXXXXXXXXXXXX-----------ooooo--XXXXXXXXXXXX--XXXXXXXXXXXXXXXXXXX---XXXXXXXXXX---XXXXXXXXXXXXXXXXXXXXXXXXXXXXXXXXXXXX-r--------XXX--XXXXXXXX--kg-------ooo----XXXXXXXX-------------
XXXXXXXXXXXXXXXXXXXXXXXXXXXXXXXXXXXXXXXXXXXXX----ky--XXXXXXXXXXXXXXXXXXXXXXXXXXXXXXXXXXXXXXXXXXXXXXXXXXXXXXXXXXXXXXXXXXXXXXXXXXXXXXXXXXXXXXXXXXXXXXXXXXXXXXXXXXXXXXXXXXXXXX--r---Y-XXXXXXXX-----XXXXXXXX
XXXXXXXXXXXXXXXXXXXXXXXXXXXXXXXXXXXXXXXXXXXXXXXXXXXXXXXXXXXXXXXXXXXXXXXXXXXXXXXXXXXXXXXXXXXXXXXXXXXXXXXXXXXXXXXXXXXXXXXXXXXXXXXXXXXXXXXXXXXXXXXXXXXXXXXXXXXXXXXXXXXXXXXXXXXXXXXXXXXXXXXXXXXXXXXXXXXXXXXX

