--------------------------------------------------------------------------------------------------------------------------------------------------------------------------------------------------------
--------------------------------------------------------------------------------------------------------------------------------------------------------------------------------------------------------
--------------------------------------------------------------------------------------------------------------------------------------------------------------------------------------------------------
--------------------------------------------------------------------------------------------------------------------------------------------------------------------------------------------------------
--------------------------------------------------------------------------------------------------------------------------------------------------------------------------------------------------------
--------------------------------------------------------------------------------------------------------------------------------------------------------------------------------------------------------
--------------------------------------------------------------------------------------------------------------------------------------------------------------------------------------------------------
--------------------------------------------------------------------------------------------------------------------------------------------------------------------------------------------------------
--------------------------------------------------------------------------------------------------------------------------------------------------------------------------------------------------------
--------------------------------------------------------------------------------------------------------------------------------------------------------------------------------------------------------
--------------------------------------------------------------------------------------------------------------------------------------------------------------------------------------------------------
--------------------------------------------------------------------------------------------------------------------------------------------------------------------------------------------------------
--------------------------------Soooo----------------------oSo---------SoooSSS---------------------------------------------------------------------oooSoo-------------------oooSo-----------------------
-----------------------------------------------------------------------------------------------------------------oooSoooo-------------------------------------------------------------------------------
----------------------ooooo---ooooo----oooo-----------------ooo--------ooooooo----------oooo--------------------------------------------oooSoo------ooooo------------------oooooo-----------------------
--------------------------------y--------------SSooo-----k--y----------ykr--yk---------Y---kK---ooS-------oo-----oooooooo------------------------k--y----------------------rGK--------------------------
-----------------------oo---XXXXXXXXXX---oo-------------XXXXXXXXX----XXXXXXXXXXX---XXXXXXXXXXX------------r--------Kr------------------oooooooo-XXXXXXXXXXXXXXX----------XXXXXXXXXXX--------------------
---------------------K--R-k-XXXXXXXXXX---krg-----ooo----XXXXXXXXX----XXXXXXXXXXX---XXXXXXXXXXX---ooooo-XXXXXXXXXXXXXXXXXXXX-oooo----------------XXXXXXXXXXXXXXXXXX-ooooo-XXXXXXXXXXX----------ooo--XXXXX
-------------XXXXXXXXXXXXXXXXXXXXXXXXXXXXXXXX--Y---Kky--XXXXXXXXX----XXXXXXXXXXXXXXXXXXXXXXXXX--rg-----XXXXXXXXXXXXXXXXXXXX-----------XXXXXXXXXXXXXXXXXXXXXXXXXXXX-----g-XXXXXXXXXXX----G--R--y----XXXXX
XXXXXXXXXXXXXXXXXXXXXXXXXXXXXXXXXXXXXXXXXXXXXXXXXXXXXXXXXXXXXXXXXXXXXXXXXXXXXXXXXXXXXXXXXXXXXXXXXXXXXXXXXXXXXXXXXXXXXXXXXXXXXXXXXXXXXXXXXXXXXXXXXXXXXXXXXXXXXXXXXXXXXXXXXXXXXXXXXXXXXXXXXXXXXXXXXXXXXXXX

