--------------------------------------------------------------------------------------------------------------------------------------------------------------------------------------------------------
--------------------------------------------------------------------------------------------------------------------------------------------------------------------------------------------------------
--------------------------------------------------------------------------------------------------------------------------------------------------------------------------------------------------------
--------------------------------------------------------------------------------------------------------------------------------------------------------------------------------------------------------
--------------------------------------------------------------------------------------------------------------------------------------------------------------------------------------------------------
--------------------------------------------------------------------------------------------------------------------------------------------------------------------------------------------------------
--------------------------------------------------------------------------------------------------------------------------------------------------------------------------------------------------------
--------------------------------------------------------------------------------------------------------------------------------------------------------------------------------------------------------
--------------------------------------------------------------------------------------------------------------------------------------------------------------------------------------------------------
--------------------------------------------------------------------------------------------------------------------------------------------------------------------------------------------------------
--------------------------------------------------------------------------------------------------------------------------------------------------------------------------------------------------------
--------------------------------------------------------------------------------------------------------------------------------------------------------------------------------------------------------
------------------------------------------------------------------------------------------------ooSo----------------------------------------------------------------------------------------------------
------------------------------------------------------------------------oSS--------------------------------------------------------------------ooSoSooo--------------------------------------oSoooSo----
-------------------ooo-----------------------ooo------------------------------------------------ooo-----------------------------------------------------------------oooo------SSooooo-------------------
---------------------------ooo---------oSo-------------SooSo---------oooooo--------------------r-------------------------------oSoSo----rRy-----ooooooo-----oooo-------------------------------oooooo---
------------------oooo-----g-k----------------ooooo-------------XX----G---r-k---------------XXXXXXXXXX----rg-------G-------------------XXXXXXX-Y-k-R-gr------------ooooo------ooooo------------gRk------
XXXXXXXXXXX-------Gr-Y---XXXXXXXXXX----oo------------oooooo-----XX--XXXXXXXXXX---oooo-------XXXXXXXXXX---XXXXXXXXXXXXXXXXXXXXX----ooo--XXXXXXXXXXXXXXXXX--oooooo--rg---yK-------GYy---------XXXXXXXXXXX-
XXXXXXXXXXX-----XXXXXXXXXXXXXXXXXXX---ggr--XXXXXXXXX-Y--y--y----XX--XXXXXXXXXX-YY--K---XXXXXXXXXXXXXXX---XXXXXXXXXXXXXXXXXXXXX--k-k--g-XXXXXXXXXXXXXXXXX-gk------XXXXXXXXXXXXXXXXXXXXXX-----XXXXXXXXXXX-
XXXXXXXXXXXXXXXXXXXXXXXXXXXXXXXXXXXXXXXXXXXXXXXXXXXXXXXXXXXXXXXXXXXXXXXXXXXXXXXXXXXXXXXXXXXXXXXXXXXXXXXXXXXXXXXXXXXXXXXXXXXXXXXXXXXXXXXXXXXXXXXXXXXXXXXXXXXXXXXXXXXXXXXXXXXXXXXXXXXXXXXXXXXXXXXXXXXXXXXX

