--------------------------------------------------------------------------------------------------------------------------------------------------------------------------------------------------------
--------------------------------------------------------------------------------------------------------------------------------------------------------------------------------------------------------
--------------------------------------------------------------------------------------------------------------------------------------------------------------------------------------------------------
--------------------------------------------------------------------------------------------------------------------------------------------------------------------------------------------------------
--------------------------------------------------------------------------------------------------------------------------------------------------------------------------------------------------------
--------------------------------------------------------------------------------------------------------------------------------------------------------------------------------------------------------
--------------------------------------------------------------------------------------------------------------------------------------------------------------------------------------------------------
--------------------------------------------------------------------------------------------------------------------------------------------------------------------------------------------------------
--------------------------------------------------------------------------------------------------------------------------------------------------------------------------------------------------------
--------------------------------------------------------------------------------------------------------------------------------------------------------------------------------------------------------
--------------------------------------------------------------------------------------------------------------------------------------------------------------------------------------------------------
--------------------------------------------------------------------------------------------------------------------------------------------------------------------------------------------------------
-------------------------------------------------------------------------------------oSoSSooo----------------ooSoooo------------------------------------------------------------------------------------
-------------SoSS-------------------------oSSo------------------------------ooSoS----------------------------------------------------------------------------------------oSoSSoSo-----------------------
-----------------------------------------------------ooSoo---ooooo--ooo---------------oooooo---------oSSoSo--oooooooo-------------SSSo---------------SooSo----------------------------------------------
--------------oooo----Gr---oooooo---oo-----ooo-----------------------g----ooooooo-------r-KR-----------------rY-k-YK-----ooSo-----------------------------------------------ooooo---------ooSo-----oSS--
XXXXXXXXXX-----y---XXXXXX-rg--R----y-k-------G------oooo------oooo-XXXXXX--Y----K-R-XXXXXXXXXX-----oooooooo-XXXXXXXXXX----------oooooo---XXXXX-------oooooooo--oooo-XXXX---gk-R-R--XXXXX----------------
XXXXXXXXXXXXXXXXXXXXXXXXXXXXXXXXXXXXXXXXXXXXXXXXX------k--------k--XXXXXXXXXXXXXXXXXXXXXXXXXXXXXXX---rG--r--XXXXXXXXXX--ooooo----r---yyy-XXXXX---------g--------y---XXXXXXXXXXXXXXXXXXXX-oooooooo--oooo-
XXXXXXXXXXXXXXXXXXXXXXXXXXXXXXXXXXXXXXXXXXXXXXXXXXXXXXXXXXXXXXXXXXXXXXXXXXXXXXXXXXXXXXXXXXXXXXXXXXXXXXXXXXXXXXXXXXXXXX---gyy--XXXXXXXXXXXXXXXX-----XXXXXXXXXXXXXXXXXXXXXXXXXXXXXXXXXXXXX-k-----R----g---
XXXXXXXXXXXXXXXXXXXXXXXXXXXXXXXXXXXXXXXXXXXXXXXXXXXXXXXXXXXXXXXXXXXXXXXXXXXXXXXXXXXXXXXXXXXXXXXXXXXXXXXXXXXXXXXXXXXXXXXXXXXXXXXXXXXXXXXXXXXXXXXXXXXXXXXXXXXXXXXXXXXXXXXXXXXXXXXXXXXXXXXXXXXXXXXXXXXXXXXX

