--------------------------------------------------------------------------------------------------------------------------------------------------------------------------------------------------------
--------------------------------------------------------------------------------------------------------------------------------------------------------------------------------------------------------
--------------------------------------------------------------------------------------------------------------------------------------------------------------------------------------------------------
--------------------------------------------------------------------------------------------------------------------------------------------------------------------------------------------------------
--------------------------------------------------------------------------------------------------------------------------------------------------------------------------------------------------------
--------------------------------------------------------------------------------------------------------------------------------------------------------------------------------------------------------
--------------------------------------------------------------------------------------------------------------------------------------------------------------------------------------------------------
--------------------------------------------------------------------------------------------------------------------------------------------------------------------------------------------------------
--------------------------------------------------------------------------------------------------------------------------------------------------------------------------------------------------------
--------------------------------------------------------------------------------------------------------------------------------------------------------------------------------------------------------
--------------------------------------------------------------------------------------------------------------------------------------------------------------------------------------------------------
--------------------------------------------------------------------------------------------------------------------------------------------------------------------------------------------------------
-------------------------------------------------------------ooo----------------------------------------------ooooS----------Sooooo-----------------oooSoo------------oooSooSS--------------------------
-----------------------------oSooSo-----------------------------------------------------------------------------------------------------------oSo--------------------------------------oSSoSoSo---------
-------------ooooooo-----------------------------------------ooo--------------------------------ooooo---------ooooooo------oooooo--------------------ooooooo-------------oooooo-------------------Soooo-
-------------k---K-K-------oooooooo--ooSSoo-----oSo------------gyy---oSSooooo-----oSo----------k---k----------Gg---g-------Rr-rY--r-----------oo------kyGkg-----------r-g----------------oooo-----------
------------XXXXXXXXX-------gy-Yy---------------------------XXXXXXXX--------------------------XXXXXXXX--ooo--XXXXXXXXXXXXXXXXXXXXXXX-ooooo---y--r-XXXXXXXXXXX------XXXXXXXXXXXXXXXXXXX-RG-gg-------oooo-
XXXXXXXXXXXXXXXXXXXXX----XXXXXXXXXXX----oo-------oooo-------XXXXXXXX---oooooo--ooooooo--------XXXXXXXX--k--G-XXXXXXXXXXXXXXXXXXXXXXX--Rrr---XXXXXXXXXXXXXXXXXXX----XXXXXXXXXXXXXXXXXXXXXXXXXXXXX---Y----
XXXXXXXXXXXXXXXXXXXXXXXXXXXXXXXXXXXX---k------G------G-XXXXXXXXXXXXX--y-Rr-------Y----r--XXXXXXXXXXXXXXXXXXXXXXXXXXXXXXXXXXXXXXXXXXXXXXXXXXXXXXXXXXXXXXXXXXXXXX----XXXXXXXXXXXXXXXXXXXXXXXXXXXXXXXXXXXXX
XXXXXXXXXXXXXXXXXXXXXXXXXXXXXXXXXXXXXXXXXXXXXXXXXXXXXXXXXXXXXXXXXXXXXXXXXXXXXXXXXXXXXXXXXXXXXXXXXXXXXXXXXXXXXXXXXXXXXXXXXXXXXXXXXXXXXXXXXXXXXXXXXXXXXXXXXXXXXXXXXXXXXXXXXXXXXXXXXXXXXXXXXXXXXXXXXXXXXXXX

