--------------------------------------------------------------------------------------------------------------------------------------------------------------------------------------------------------
--------------------------------------------------------------------------------------------------------------------------------------------------------------------------------------------------------
--------------------------------------------------------------------------------------------------------------------------------------------------------------------------------------------------------
--------------------------------------------------------------------------------------------------------------------------------------------------------------------------------------------------------
--------------------------------------------------------------------------------------------------------------------------------------------------------------------------------------------------------
--------------------------------------------------------------------------------------------------------------------------------------------------------------------------------------------------------
--------------------------------------------------------------------------------------------------------------------------------------------------------------------------------------------------------
--------------------------------------------------------------------------------------------------------------------------------------------------------------------------------------------------------
--------------------------------------------------------------------------------------------------------------------------------------------------------------------------------------------------------
--------------------------------------------------------------------------------------------------------------------------------------------------------------------------------------------------------
--------------------------------------------------------------------------------------------------------------------------------------------------------------------------------------------------------
--------------------------------------------------------------------------------------------------------------------------------------------------------------------------------------------------------
-------------------------------------------------------------------------------------------------------------------SoSooo----------------SoSooo---------------------------------------------Sooo--------
------------------------------------------------------------------oSSSooSS--------------------------------------------------------------------------------------------------ooooo-----------------------
--------------------------------------oooooooo---------------------------------oSS---------ooSo-----ooo------------oooooo---------------oooooo----------------------------------------------------------
----------------------ooooo-----------r-k-k--k---------oSSoooSoo----ooooo-------------------------gk-r---oSSoS---------------ooo---------k------R---------------ooSoSSo-----ooo-------------k---y-------
---------------------g--Gk-----------XXXXXXXXXX--------------------R-----k-----ooo--------oooo--XXXXXXXX---------XXXXXXXXX-------------XXXXXXXXXXX------k----XX-------------Y-r-----------XXXXXXXX------
XXXXXXXXXXX--oooooo-XXXXXXXX-oooo----XXXXXXXXXXXXXXXXX-oooooo----XXXXXXXXXXX--kyk---------------XXXXXXXX----oooo-XXXXXXXXX-------------XXXXXXXXXXX-----XXXXXXXX---ooooooo-XXXXXXXX--------XXXXXXXX---XX-
XXXXXXXXXXX-krkgr-y-XXXXXXXX-g-Y-----XXXXXXXXXXXXXXXXX-Gk-k--Y---XXXXXXXXXXXXXXXXXXXXXXXXXXXXXXXXXXXXXXX-yk------XXXXXXXXX--K----------XXXXXXXXXXXXXXXXXXXXXXXX-Y----K--r-XXXXXXXXXXXXXXXXXXXXXXXX---XXX
XXXXXXXXXXXXXXXXXXXXXXXXXXXXXXXXXXXXXXXXXXXXXXXXXXXXXXXXXXXXXXXXXXXXXXXXXXXXXXXXXXXXXXXXXXXXXXXXXXXXXXXXXXXXXXXXXXXXXXXXXXXXXXXXXXXXXXXXXXXXXXXXXXXXXXXXXXXXXXXXXXXXXXXXXXXXXXXXXXXXXXXXXXXXXXXXXXXXXXXX

