--------------------------------------------------------------------------------------------------------------------------------------------------------------------------------------------------------
--------------------------------------------------------------------------------------------------------------------------------------------------------------------------------------------------------
--------------------------------------------------------------------------------------------------------------------------------------------------------------------------------------------------------
--------------------------------------------------------------------------------------------------------------------------------------------------------------------------------------------------------
--------------------------------------------------------------------------------------------------------------------------------------------------------------------------------------------------------
--------------------------------------------------------------------------------------------------------------------------------------------------------------------------------------------------------
--------------------------------------------------------------------------------------------------------------------------------------------------------------------------------------------------------
--------------------------------------------------------------------------------------------------------------------------------------------------------------------------------------------------------
--------------------------------------------------------------------------------------------------------------------------------------------------------------------------------------------------------
--------------------------------------------------------------------------------------------------------------------------------------------------------------------------------------------------------
--------------------------------------------------------------------------------------------------------------------------------------------------------------------------------------------------------
--------------------------------------------------------------------------------------------------------------------------------------------------------------------------------------------------------
--------------------------------------------------ooo----------Soooo------------------------------------------------------------------------------------------------------------ooS---------------ooS---
------------------------------------------------------------------------------------------------------------------------Sooooo----ooSoo-------------------------SooooS---ooo----------------------------
-----------------------ooSSo-----------------------ooooo-------ooooooo----------------Sooo---------------------ooo----------------------------------------------------------------------SoooSS------oo--
-------------oSoSoSo-------------------------------------------y----------------------------------------------r---------ooooo----oooooo-----ooS----oSSo---oo---oooooo----ooo----k-KK--------------gr----
------------------------------XX--R--------------XXXXXXXX---XXXXXXXXXXX---------------ooo----------------k--XXXXXXXX--y---Y------g-----------------------Y--k--rYG--gk--------XXXXXXXX---oooooo-XXXXXXX-
-------------ooooooo----------XXXXXXXXXXXXX---kk-XXXXXXXX---XXXXXXXXXXX----------------r-----ooo------XXXXXXXXXXXXXXXXXXXXXXXXXXXXXXXXXX-oooooo---------XXXXXXXXXXXXXXXXXXXXXXXXXXXXXX----rk----XXXXXXXX
--------------k--y----XXXXXXXXXXXXXXXXXXXXXXXXXXXXXXXXXXX---XXXXXXXXXXX-----Y------XXXXXXXX---R---XXXXXXXXXXXXXXXXXXXXXXXXXXXXXXXXXXXXXX------ky--------XXXXXXXXXXXXXXXXXXXXXXXXXXXXXXXXXXXXXXXXXXXXXXXX
XXXXXXXXXXXXXXXXXXXXXXXXXXXXXXXXXXXXXXXXXXXXXXXXXXXXXXXXXXXXXXXXXXXXXXXXXXXXXXXXXXXXXXXXXXXXXXXXXXXXXXXXXXXXXXXXXXXXXXXXXXXXXXXXXXXXXXXXXXXXXXXXXXXXXXXXXXXXXXXXXXXXXXXXXXXXXXXXXXXXXXXXXXXXXXXXXXXXXXXX

