--------------------------------------------------------------------------------------------------------------------------------------------------------------------------------------------------------
--------------------------------------------------------------------------------------------------------------------------------------------------------------------------------------------------------
--------------------------------------------------------------------------------------------------------------------------------------------------------------------------------------------------------
--------------------------------------------------------------------------------------------------------------------------------------------------------------------------------------------------------
--------------------------------------------------------------------------------------------------------------------------------------------------------------------------------------------------------
--------------------------------------------------------------------------------------------------------------------------------------------------------------------------------------------------------
--------------------------------------------------------------------------------------------------------------------------------------------------------------------------------------------------------
--------------------------------------------------------------------------------------------------------------------------------------------------------------------------------------------------------
--------------------------------------------------------------------------------------------------------------------------------------------------------------------------------------------------------
--------------------------------------------------------------------------------------------------------------------------------------------------------------------------------------------------------
--------------------------------------------------------------------------------------------------------------------------------------------------------------------------------------------------------
--------------------------------------------------------------------------------------------------------------------------------------------------------------------------------------------------------
------------------------------------------------------------------------------------------------------------------oSo----------------------------------------------------------Sooo---------------------
--------------------------------------------------------------------------------------------------------------------------------------------------------------------------------------------------------
------------------oooSo-------------------oo-------ooSo------------------------------------------ooSSoo----oo----ooooo---------------------------oSS----------------------------------------------------
------------------------------------------yR--------------------oSoo------oooS-----------------------------r-------k-g-y---oSoSo----------g-r---------------ooooo------ooS----g-----------------oooo----
------------------ooooo--ooooo-XXXXX-----XXXXXXX-ooo-------k------------------------------------ooooo---XXXXXXXXXXXXXXXXX----------oooo-XXXXXX-oooooooo-------Y-y------------XXXXXXX-------------k------
--------------------Kg---------XXXXXXXXXXXXXXXXX-g-r--K-XXXXXX--ooo-------oooo------------------g--Y----XXXXXXXXXXXXXXXXX-oooooo----g---XXXXXX----G--rr-XXXXXXXXXXXX-oooooo--XXXXXXX-----------XXXXXXXXX
-------------XXXXXXXXXXXXXXXXXXXXXXXXXXXXXXXXXXXXXXXXXXXXXXXXX-----k-------g---r----r---XXXXXXXXXXXXXXXXXXXXXXXXXXXXXXXXX---gg---XXXXXXXXXXXXXXXXXXXXXXXXXXXXXXXXXXX-k--y-G--XXXXXXXXXXX-Y-k---XXXXXXXXX
XXXXXXXXXXXXXXXXXXXXXXXXXXXXXXXXXXXXXXXXXXXXXXXXXXXXXXXXXXXXXXXXXXXXXXXXXXXXXXXXXXXXXXXXXXXXXXXXXXXXXXXXXXXXXXXXXXXXXXXXXXXXXXXXXXXXXXXXXXXXXXXXXXXXXXXXXXXXXXXXXXXXXXXXXXXXXXXXXXXXXXXXXXXXXXXXXXXXXXXX

