--------------------------------------------------------------------------------------------------------------------------------------------------------------------------------------------------------
--------------------------------------------------------------------------------------------------------------------------------------------------------------------------------------------------------
--------------------------------------------------------------------------------------------------------------------------------------------------------------------------------------------------------
--------------------------------------------------------------------------------------------------------------------------------------------------------------------------------------------------------
--------------------------------------------------------------------------------------------------------------------------------------------------------------------------------------------------------
--------------------------------------------------------------------------------------------------------------------------------------------------------------------------------------------------------
--------------------------------------------------------------------------------------------------------------------------------------------------------------------------------------------------------
--------------------------------------------------------------------------------------------------------------------------------------------------------------------------------------------------------
--------------------------------------------------------------------------------------------------------------------------------------------------------------------------------------------------------
--------------------------------------------------------------------------------------------------------------------------------------------------------------------------------------------------------
--------------------------------------------------------------------------------------------------------------------------------------------------------------------------------------------------------
--------------------------------------------------------------------------------------------------------------------------------------------------------------------------------------------------------
-----------------------------------------------------------------------ooo------------------------------------oSo-----------------oSoSSo---------------SoS----------------------------------------------
------------------------------------------Sooo----------------------------------------------------------------------------------------------------------------------------------------------------------
-------------------------------------------------------ooo---------------ooo---------------------------------oooo-----oo---------oooooooo------------oooooo--------ooo-------------Sooooo---------------
---------------------------------------ooooo--------------------ooo-----k--------ooooo---------------------Y--Y-----y----g-------Rg------Y--oSoo---------Y----------y-----------------------------------
XXXXXXXXXXXXXX-------------------XXXXX--r-r--------------ooo----------XXXXXXX--R--k-G---------------------XXXXXXXXXXXXXXXXXXXXXXXXXXXXXXXXX---------XXXXXXXXX----XXXXXXXXXX-------oooooo---------oooooo-
XXXXXXXXXXXXXX----XXXX------oo---XXXXXXXXXXXXXXXXXXX------G----oooo---XXXXXXXXXXXXXXXXX---------g-k-g-----XXXXXXXXXXXXXXXXXXXXXXXXXXXXXXXXX-ooooo---XXXXXXXXX----XXXXXXXXXXXXXXXX-K---------------r-R---
XXXXXXXXXXXXXX----XXXXXXXX-----y-XXXXXXXXXXXXXXXXXXXXXXXXXXXX-gKR-g---XXXXXXXXXXXXXXXXXXX-----XXXXXXXX----XXXXXXXXXXXXXXXXXXXXXXXXXXXXXXXXX-k-ky----XXXXXXXXX----XXXXXXXXXXXXXXXXXXXXXXXXXXXXXXXXXXXXXXX
XXXXXXXXXXXXXXXXXXXXXXXXXXXXXXXXXXXXXXXXXXXXXXXXXXXXXXXXXXXXXXXXXXXXXXXXXXXXXXXXXXXXXXXXXXXXXXXXXXXXXXXXXXXXXXXXXXXXXXXXXXXXXXXXXXXXXXXXXXXXXXXXXXXXXXXXXXXXXXXXXXXXXXXXXXXXXXXXXXXXXXXXXXXXXXXXXXXXXXXX

