--------------------------------------------------------------------------------------------------------------------------------------------------------------------------------------------------------
--------------------------------------------------------------------------------------------------------------------------------------------------------------------------------------------------------
--------------------------------------------------------------------------------------------------------------------------------------------------------------------------------------------------------
--------------------------------------------------------------------------------------------------------------------------------------------------------------------------------------------------------
--------------------------------------------------------------------------------------------------------------------------------------------------------------------------------------------------------
--------------------------------------------------------------------------------------------------------------------------------------------------------------------------------------------------------
--------------------------------------------------------------------------------------------------------------------------------------------------------------------------------------------------------
--------------------------------------------------------------------------------------------------------------------------------------------------------------------------------------------------------
--------------------------------------------------------------------------------------------------------------------------------------------------------------------------------------------------------
--------------------------------------------------------------------------------------------------------------------------------------------------------------------------------------------------------
--------------------------------------------------------------------------------------------------------------------------------------------------------------------------------------------------------
--------------------------------------------------------------------------------------------------------------------------------------------------------------------------------------------------------
--------------------------------------------------------------------------------------------------------ooo---oSooSo----------------------------------------------------------------------------oooo----
------------oSooSo--------------------ooooSoo-----------------------------------------------------------------------------------------------------------------------------------------------------------
------------------------oSoS-----------------------------------------------------------------------------------oo----------------------------------------oooo-----------------------------------oooo----
-------------oooooo-------------------ooooo------------------------------oSSSooo-----------------------K-KR--r--------ooo-----------------------------------------------------------------------y-------
---------------YyG-------ooo----------r---g-------XXXXXXXXXXXXXX----------------------------------XXXXXXXXXXXXXXXXXXX-y--g---ooooooo-------ooo----------------------oooo------------XXXXXX----XXXXXXX---
----------XXXXXXXXXXXX------G---XXXXXXXXXXXXXXX---XXXXXXXXXXXXXX----------ooo----XXXX----------oo-XXXXXXXXXXXXXXXXXXXXXXXXXX--g----R-XXXXX---------oooo-----K---XX----G-------------XXXXXXXXXXXXXXXXX---
XXXXXXXXXXXXXXXXXXXXXXXXXXXXXXXXXXXXXXXXXXXXXXXXXXXXXXXXXXXXXXXXXXXXXXX---g--G---XXXX--------R--y-XXXXXXXXXXXXXXXXXXXXXXXXXXXXXXXXXXXXXXXXXXXXXXX-G---g-XXXXXXXXXXXXXXXXXXXXXX---K--XXXXXXXXXXXXXXXXX---
XXXXXXXXXXXXXXXXXXXXXXXXXXXXXXXXXXXXXXXXXXXXXXXXXXXXXXXXXXXXXXXXXXXXXXXXXXXXXXXXXXXXXXXXXXXXXXXXXXXXXXXXXXXXXXXXXXXXXXXXXXXXXXXXXXXXXXXXXXXXXXXXXXXXXXXXXXXXXXXXXXXXXXXXXXXXXXXXXXXXXXXXXXXXXXXXXXXXXXXX

