--------------------------------------------------------------------------------------------------------------------------------------------------------------------------------------------------------
--------------------------------------------------------------------------------------------------------------------------------------------------------------------------------------------------------
--------------------------------------------------------------------------------------------------------------------------------------------------------------------------------------------------------
--------------------------------------------------------------------------------------------------------------------------------------------------------------------------------------------------------
--------------------------------------------------------------------------------------------------------------------------------------------------------------------------------------------------------
--------------------------------------------------------------------------------------------------------------------------------------------------------------------------------------------------------
--------------------------------------------------------------------------------------------------------------------------------------------------------------------------------------------------------
--------------------------------------------------------------------------------------------------------------------------------------------------------------------------------------------------------
--------------------------------------------------------------------------------------------------------------------------------------------------------------------------------------------------------
--------------------------------------------------------------------------------------------------------------------------------------------------------------------------------------------------------
--------------------------------------------------------------------------------------------------------------------------------------------------------------------------------------------------------
--------------------------------------------------------------------------------------------------------------------------------------------------------------------------------------------------------
----------------------------------------------------------------------------------------------oSSoooo---oSo---------Soo---------------------------------------------------------------------------------
--------------------------------------------------------------------------oSoSoSoo-------------------------------------------------oSo------SoooS------------------ooS------ooSSo----oSoooooo-----------
------------------ooo----------------------ooSSo--------------------------------------------oooooo------------------oo----------------------------------------------------------------------------------
-----------------K-------------y-R------------------ooooooo------------------ooo-------------g-k---Ky-----------------------oooS---oooo------ooooo---Soo-----------------------ooo----oooooo---------R--
--------------XXXXXXXX-------XXXXXX-----------oo-----------------------g--y------------y---XXXXXXXXXXXXXXXXX----XXXXXXXX------------Y---g-----------------------XX-k-r------R--g---------r----XXXXXXXXXX
--------------XXXXXXXX---XXXXXXXXXXXXXXX-------------oooooooo-----XXXXXXXXXXXXXXXXXXXXXXXXXXXXXXXXXXXXXXXXXXXXXXXXXXXXXX-ooooooo--XXXXXXXXXXXXXXXXX-------------XXXXXXXXXXXXXXXXXXXXXXXXXXXXXXXXXXXXXXXX
--------------XXXXXXXX---XXXXXXXXXXXXXXX--XXXXXXXXX-K-g-yk----XXXXXXXXXXXXXXXXXXXXXXXXXXXXXXXXXXXXXXXXXXXXXXXXXXXXXXXXXX-r-----r--XXXXXXXXXXXXXXXXX-------R-XXXXXXXXXXXXXXXXXXXXXXXXXXXXXXXXXXXXXXXXXXXX
XXXXXXXXXXXXXXXXXXXXXXXXXXXXXXXXXXXXXXXXXXXXXXXXXXXXXXXXXXXXXXXXXXXXXXXXXXXXXXXXXXXXXXXXXXXXXXXXXXXXXXXXXXXXXXXXXXXXXXXXXXXXXXXXXXXXXXXXXXXXXXXXXXXXXXXXXXXXXXXXXXXXXXXXXXXXXXXXXXXXXXXXXXXXXXXXXXXXXXXX

