--------------------------------------------------------------------------------------------------------------------------------------------------------------------------------------------------------
--------------------------------------------------------------------------------------------------------------------------------------------------------------------------------------------------------
--------------------------------------------------------------------------------------------------------------------------------------------------------------------------------------------------------
--------------------------------------------------------------------------------------------------------------------------------------------------------------------------------------------------------
--------------------------------------------------------------------------------------------------------------------------------------------------------------------------------------------------------
--------------------------------------------------------------------------------------------------------------------------------------------------------------------------------------------------------
--------------------------------------------------------------------------------------------------------------------------------------------------------------------------------------------------------
--------------------------------------------------------------------------------------------------------------------------------------------------------------------------------------------------------
--------------------------------------------------------------------------------------------------------------------------------------------------------------------------------------------------------
--------------------------------------------------------------------------------------------------------------------------------------------------------------------------------------------------------
--------------------------------------------------------------------------------------------------------------------------------------------------------------------------------------------------------
--------------------------------------------------------------------------------------------------------------------------------------------------------------------------------------------------------
---------------------------------------------------------------------oSo--------------------------------------------------------------------------------------------------------------------------------
-----------------------------oSo------oooSooo-----------------------------------------------------------------------------------------------------------------------------------------------------------
------------------------ooo-----------------------------------Sooo--oooo---oooo--------------------------oooSoo-----------------------------------------------------------------------------------------
------------------------y-----oooo-----ooooo---ooo------------------Y---------------Y--g--------------------------oo---------y-k---------------oooo--------SSo------------------------------------------
XXXXXXXXXXX-------XXXXXXXXXX--r--k---YG--k-yk--ry-y--------ooooo---XXXXXXX---oo----XXXXXX--------XX------ooooo----R-------XXXXXXX---------------k-G--------------ooo----------XXXX--------------ooooo--X
XXXXXXXXXXX-------XXXXXXXXXXXXXXXXXXXXXXXXXXXXXXXXXX-g-kg--K-Y--y--XXXXXXX---ky-XXXXXXXXX--ooooo-XX----K-------Y-XXXXXXXXXXXXXXXX-----oooo----XXXXXXXX-------------------XXXXXXXXXXXXXX---XXXX----kRk--X
XXXXXXXXXXX--Gk---XXXXXXXXXXXXXXXXXXXXXXXXXXXXXXXXXXXXXXXXXXXXXXXXXXXXXXXXXXXXXXXXXXXXXXX------K-XX---XXXXXXXXXXXXXXXXXXXXXXXXXXX------K-k----XXXXXXXX-------Rk-XXXXXXXXXXXXXXXXXXXXXXXXXXXXXXXXXXXXXXXX
XXXXXXXXXXXXXXXXXXXXXXXXXXXXXXXXXXXXXXXXXXXXXXXXXXXXXXXXXXXXXXXXXXXXXXXXXXXXXXXXXXXXXXXXXXXXXXXXXXXXXXXXXXXXXXXXXXXXXXXXXXXXXXXXXXXXXXXXXXXXXXXXXXXXXXXXXXXXXXXXXXXXXXXXXXXXXXXXXXXXXXXXXXXXXXXXXXXXXXXX

