--------------------------------------------------------------------------------------------------------------------------------------------------------------------------------------------------------
--------------------------------------------------------------------------------------------------------------------------------------------------------------------------------------------------------
--------------------------------------------------------------------------------------------------------------------------------------------------------------------------------------------------------
--------------------------------------------------------------------------------------------------------------------------------------------------------------------------------------------------------
--------------------------------------------------------------------------------------------------------------------------------------------------------------------------------------------------------
--------------------------------------------------------------------------------------------------------------------------------------------------------------------------------------------------------
--------------------------------------------------------------------------------------------------------------------------------------------------------------------------------------------------------
--------------------------------------------------------------------------------------------------------------------------------------------------------------------------------------------------------
--------------------------------------------------------------------------------------------------------------------------------------------------------------------------------------------------------
--------------------------------------------------------------------------------------------------------------------------------------------------------------------------------------------------------
--------------------------------------------------------------------------------------------------------------------------------------------------------------------------------------------------------
--------------------------------------------------------------------------------------------------------------------------------------------------------------------------------------------------------
-----------------------------oooS-----------------------------------------------------------------------------------------------------------------------------------------------------------------------
---------------------------------------------------oSoo------------------------------------------------------------ooSo----------------------SSSoo------------------------------------------------------
-----------------------------ooo-----------------------------------------------------SSo-----------------------------------------------ooo-------------------------ooSoSSSSo----------------------------
--------------oooSoo-----------RrG--------oooSoSo----ooo-----------------oooo----------------ooo-----------------ooooooo-----oSo--------------oooo------------ooo--------------------ooo----oo----------
-----------------------oooo-XXXXXXX--------------------r------XXXXXXXXXX------------oooooo---------------oooo------k-G----------------oooo--gkg-y----XXXXX----gky---ooooooo---------------rrg-----------
XXXXXXXXXXX----oooo-------y-XXXXXXX--oo------oooo-XXXXXXXXXXXXXXXXXXXXXX--ooooo---k--k--Y----ooo----------G-yG-XXXXXXXXXXX----oooo---------XXXXXXXXXXXXXXXXXXXXXXX-------Y-G----g----ooo-XXXXXX-rR------
XXXXXXXXXXX---yg----g-XXXXXXXXXXXXX-K-----------k-XXXXXXXXXXXXXXXXXXXXXX--Y---r--XXXXXXXXXXX-k--gg------XXXXXXXXXXXXXXXXXX-G-y--YGY-XXXXXXXXXXXXXXXXXXXXXXXXXXXXXXXXXXXXXXXXXXXXXXX-k-y--XXXXXXXXXXXX---
XXXXXXXXXXXXXXXXXXXXXXXXXXXXXXXXXXXXXXXXXXXXXXXXXXXXXXXXXXXXXXXXXXXXXXXXXXXXXXXXXXXXXXXXXXXXXXXXXXXXXXXXXXXXXXXXXXXXXXXXXXXXXXXXXXXXXXXXXXXXXXXXXXXXXXXXXXXXXXXXXXXXXXXXXXXXXXXXXXXXXXXXXXXXXXXXXXXXXXXX

