--------------------------------------------------------------------------------------------------------------------------------------------------------------------------------------------------------
--------------------------------------------------------------------------------------------------------------------------------------------------------------------------------------------------------
--------------------------------------------------------------------------------------------------------------------------------------------------------------------------------------------------------
--------------------------------------------------------------------------------------------------------------------------------------------------------------------------------------------------------
--------------------------------------------------------------------------------------------------------------------------------------------------------------------------------------------------------
--------------------------------------------------------------------------------------------------------------------------------------------------------------------------------------------------------
--------------------------------------------------------------------------------------------------------------------------------------------------------------------------------------------------------
--------------------------------------------------------------------------------------------------------------------------------------------------------------------------------------------------------
--------------------------------------------------------------------------------------------------------------------------------------------------------------------------------------------------------
--------------------------------------------------------------------------------------------------------------------------------------------------------------------------------------------------------
--------------------------------------------------------------------------------------------------------------------------------------------------------------------------------------------------------
--------------------------------------------------------------------------------------------------------------------------------------------------------------------------------------------------------
---------------------------------------------------------oSSoS----------------------------------------------oooo------------------------------------ooo-------------------------------------------------
-------------------oooo----------------------------------------------------------------------------------------------------------ooSoSooS---------------------------------------------------------------
----------------------------------------------------------ooo-----ooSSoooo----------------oSoSooo---------------------------------------------------oo------oo---------ooooSooo-------------------------
---------------------oooo--ooSoSSoo--------------------kg---g------------------------------------------------krgG---gk--------------ooooo---------gr------y-----------------------ooSoSo----------------
---------------kr----kkk------------------XXXX----XXXXXXXXXXXXXXX-ooooo---------------------ooooo----------XXXXXXXXXXXXXX----oo-------YG---------XXXXXXXXXXXXXXXXXXXX---ooooo---------------XXXXX---XX--
------------XXXXXXXXXXXXXX--ooooooo-------XXXX----XXXXXXXXXXXXXXX------rrr------k----------Y----g----------XXXXXXXXXXXXXX-y-RK--XXXXXXXXXXX------XXXXXXXXXXXXXXXXXXXX-k-k-g-r-g---oooo---XXXXXXXXXXXXX--
------------XXXXXXXXXXXXXX--K-r---y-------XXXXXXXXXXXXXXXXXXXXXXXXXXXXXXXXXXXXXXXXX------XXXXXXXXXXXXXXXXXXXXXXXXXXXXXXXXXXXXXXXXXXXXXXXXXX---XXXXXXXXXXXXXXXXXXXXXXXXXXXXXXXXXX---g-----XXXXXXXXXXXXXXX
XXXXXXXXXXXXXXXXXXXXXXXXXXXXXXXXXXXXXXXXXXXXXXXXXXXXXXXXXXXXXXXXXXXXXXXXXXXXXXXXXXXXXXXXXXXXXXXXXXXXXXXXXXXXXXXXXXXXXXXXXXXXXXXXXXXXXXXXXXXXXXXXXXXXXXXXXXXXXXXXXXXXXXXXXXXXXXXXXXXXXXXXXXXXXXXXXXXXXXXX

