--------------------------------------------------------------------------------------------------------------------------------------------------------------------------------------------------------
--------------------------------------------------------------------------------------------------------------------------------------------------------------------------------------------------------
--------------------------------------------------------------------------------------------------------------------------------------------------------------------------------------------------------
--------------------------------------------------------------------------------------------------------------------------------------------------------------------------------------------------------
--------------------------------------------------------------------------------------------------------------------------------------------------------------------------------------------------------
--------------------------------------------------------------------------------------------------------------------------------------------------------------------------------------------------------
--------------------------------------------------------------------------------------------------------------------------------------------------------------------------------------------------------
--------------------------------------------------------------------------------------------------------------------------------------------------------------------------------------------------------
--------------------------------------------------------------------------------------------------------------------------------------------------------------------------------------------------------
--------------------------------------------------------------------------------------------------------------------------------------------------------------------------------------------------------
--------------------------------------------------------------------------------------------------------------------------------------------------------------------------------------------------------
--------------------------------------------------------------------------------------------------------------------------------------------------------------------------------------------------------
----------------------------------------------------ooo---------------------------------------------------------------------------------ooooS----------------------------------------------oooo---------
---------------------------oSo--------------------------------SoS---------------------------------------------------------------------------------------ooo---------------------------------------------
------------------ooooo-----------------------------oooooo-----------------------------oooS----------------------------------------------oooo-----------------------------------------------oo----------
------------------G-k-----oo-----oSo----------oo-------gg------oooo---------oSooSS------------------------------------------------------K---------------ooooo---oooo----------------------gk-------Sooo-
-----------------XXXXXXXX----G---------XXXXX-y-k-r-XXXXXXXX---yr---------------------oooooo------------------ooo---------------------XXXXXXXXXXXXXXX---ygg--k----------------------------XXXXXXX--------
-----------------XXXXXXXXXXXXXX--ooo---XXXXXXXXXXXXXXXXXXXXXXXXXXXXXXXXXXXX-oooooo-------grk---------------Gr-rG-------y-y-----------XXXXXXXXXXXXXXXXXXXXXXXXX--oooo----oo----oo----XXXXXXXXXXXX--ooo---
-----------------XXXXXXXXXXXXXX--------XXXXXXXXXXXXXXXXXXXXXXXXXXXXXXXXXXXX-----g---XXXXXXXXXXXXXXXX-----XXXXXXXXXXXXXXXXXXXX----XXXXXXXXXXXXXXXXXXXXXXXXXXXXX---gy----------rg---XXXXXXXXXXXXXX-g------
XXXXXXXXXXXXXXXXXXXXXXXXXXXXXXXXXXXXXXXXXXXXXXXXXXXXXXXXXXXXXXXXXXXXXXXXXXXXXXXXXXXXXXXXXXXXXXXXXXXXXXXXXXXXXXXXXXXXXXXXXXXXXXXXXXXXXXXXXXXXXXXXXXXXXXXXXXXXXXXXXXXXXXXXXXXXXXXXXXXXXXXXXXXXXXXXXXXXXXXX

