--------------------------------------------------------------------------------------------------------------------------------------------------------------------------------------------------------
--------------------------------------------------------------------------------------------------------------------------------------------------------------------------------------------------------
--------------------------------------------------------------------------------------------------------------------------------------------------------------------------------------------------------
--------------------------------------------------------------------------------------------------------------------------------------------------------------------------------------------------------
--------------------------------------------------------------------------------------------------------------------------------------------------------------------------------------------------------
--------------------------------------------------------------------------------------------------------------------------------------------------------------------------------------------------------
--------------------------------------------------------------------------------------------------------------------------------------------------------------------------------------------------------
--------------------------------------------------------------------------------------------------------------------------------------------------------------------------------------------------------
--------------------------------------------------------------------------------------------------------------------------------------------------------------------------------------------------------
--------------------------------------------------------------------------------------------------------------------------------------------------------------------------------------------------------
--------------------------------------------------------------------------------------------------------------------------------------------------------------------------------------------------------
--------------------------------------------------------------------------------------------------------------------------------------------------------------------------------------------------------
------------------ooS----------------------------------------oooSo----------------------------------------ooSSo-----------------------------------------------------------------------------------------
------------------------------------------------------------------------------------------SSS-------------------------ooS----------------ooSoSSoo-------------------------------------SoooSSo-----------
-------------------------oSoSo----------------------------oooooooo----oSoSS---------------------------------ooo------------------ooooo-------------------------------------ooooSS----------------oooo---
--------------------rK----------------------------------------ry-------------------------oooooo----G-r---g---r-------ooo-----------g-rG--oooooooo----------SoSo-----oooo---------------oooo-------------
XXXXXXXXXXXXX----XXXXXX------------oooo-------------XXXXXXXXXXXXXXXX-oooooooo------XXXXX-gR-Y--g-XXXXXXXXXXXXXXXXX----G-r-------XXXXXXXX--K---Yg----------------------y----ooooooo---rg-K-yy------ooooo-
XXXXXXXXXXXXX----XXXXXX-ky--KG------K--R----oo--XXXXXXXXXXXXXXXXXXXX--gy--kkk--XXXXXXXXXXXXXXXXXXXXXXXXXXXXXXXXXXXXXXXXXXXX-----XXXXXXXXXXXXXXXXXX-----XX--ooooo---XXXXXXX---------XXXXXXXXXXX----kry---
XXXXXXXXXXXXX----XXXXXXXXXXXXXXXXXXXXXXXX-----r-XXXXXXXXXXXXXXXXXXXXXXXXXXXXXXXXXXXXXXXXXXXXXXXXXXXXXXXXXXXXXXXXXXXXXXXXXXX-----XXXXXXXXXXXXXXXXXXXXXXXXX---rg-----XXXXXXXXXXXXXXXXXXXXXXXXXXXXXXXXXXXXX
XXXXXXXXXXXXXXXXXXXXXXXXXXXXXXXXXXXXXXXXXXXXXXXXXXXXXXXXXXXXXXXXXXXXXXXXXXXXXXXXXXXXXXXXXXXXXXXXXXXXXXXXXXXXXXXXXXXXXXXXXXXXXXXXXXXXXXXXXXXXXXXXXXXXXXXXXXXXXXXXXXXXXXXXXXXXXXXXXXXXXXXXXXXXXXXXXXXXXXXX

