--------------------------------------------------------------------------------------------------------------------------------------------------------------------------------------------------------
--------------------------------------------------------------------------------------------------------------------------------------------------------------------------------------------------------
--------------------------------------------------------------------------------------------------------------------------------------------------------------------------------------------------------
--------------------------------------------------------------------------------------------------------------------------------------------------------------------------------------------------------
--------------------------------------------------------------------------------------------------------------------------------------------------------------------------------------------------------
--------------------------------------------------------------------------------------------------------------------------------------------------------------------------------------------------------
--------------------------------------------------------------------------------------------------------------------------------------------------------------------------------------------------------
--------------------------------------------------------------------------------------------------------------------------------------------------------------------------------------------------------
--------------------------------------------------------------------------------------------------------------------------------------------------------------------------------------------------------
--------------------------------------------------------------------------------------------------------------------------------------------------------------------------------------------------------
--------------------------------------------------------------------------------------------------------------------------------------------------------------------------------------------------------
--------------------------------------------------------------------------------------------------------------------------------------------------------------------------------------------------------
--------------------------------------------------------------------------------oooooo-----oooSo----------------ooo--------------ooo-----------------------------------------------oSoo-----------------
----------------------------------------------------oSooooo----------------------------------------------------------------------------------SSSSS------------------------------------------------------
--------------------------------------------------------------oSS------oSSSo-----oooo------ooooo----------------ooo-------------oo----------------------------------oSooSoooo-------oo------------------
--------------ooo------------ooSoSo------------------ooooooo---------------------GG--------k-rg--------------rg-----R--------------g---------ooo---------oooSoo--------------------k-KkY----------------
--------------Y-G-y------XXX------------------------y---g-----oooo-----ooo----XXXXXXXXXXXXXXXXXXX--------XXXXXXXXXXXXX---------XXXXXX---------r--y--XXXX-------------oooooo---XXXXXXXXXXXX-oo------XXXXX
-------------XXXXXXXXXXXXXXX-ooooooo----------oooo-XXXXXXXXXX--------------rg-XXXXXXXXXXXXXXXXXXX--------XXXXXXXXXXXXX---XXXXXXXXXXXX----XXXXXXXXXXXXXXX--oooooo-XX-----------XXXXXXXXXXXX------XXXXXXXX
XXXXXXXXXX---XXXXXXXXXXXXXXX-g----Y-y--------------XXXXXXXXXXXXXXXXXXXXXXXXXXXXXXXXXXXXXXXXXXXXXXXXXXXXXXXXXXXXXXXXXXX---XXXXXXXXXXXXXXXXXXXXXXXXXXXXXXX---------XXXXXXXXXXXXXXXXXXXXXXXXXXXXXXXXXXXXXXX
XXXXXXXXXXXXXXXXXXXXXXXXXXXXXXXXXXXXXXXXXXXXXXXXXXXXXXXXXXXXXXXXXXXXXXXXXXXXXXXXXXXXXXXXXXXXXXXXXXXXXXXXXXXXXXXXXXXXXXXXXXXXXXXXXXXXXXXXXXXXXXXXXXXXXXXXXXXXXXXXXXXXXXXXXXXXXXXXXXXXXXXXXXXXXXXXXXXXXXXX

