--------------------------------------------------------------------------------------------------------------------------------------------------------------------------------------------------------
--------------------------------------------------------------------------------------------------------------------------------------------------------------------------------------------------------
--------------------------------------------------------------------------------------------------------------------------------------------------------------------------------------------------------
--------------------------------------------------------------------------------------------------------------------------------------------------------------------------------------------------------
--------------------------------------------------------------------------------------------------------------------------------------------------------------------------------------------------------
--------------------------------------------------------------------------------------------------------------------------------------------------------------------------------------------------------
--------------------------------------------------------------------------------------------------------------------------------------------------------------------------------------------------------
--------------------------------------------------------------------------------------------------------------------------------------------------------------------------------------------------------
--------------------------------------------------------------------------------------------------------------------------------------------------------------------------------------------------------
--------------------------------------------------------------------------------------------------------------------------------------------------------------------------------------------------------
--------------------------------------------------------------------------------------------------------------------------------------------------------------------------------------------------------
--------------------------------------------------------------------------------------------------------------------------------------------------------------------------------------------------------
----------------------------------------------------------------------------------------------------------------------------------------ooo---------------------------------------SooooS----------------
----------------------------------------------------------SoSSS-----------------------------------------------------------------------------------------------------------------------------------------
---------------------------------ooSoSSo-----------------------------------------------------------------------oooo----------------------------------------------------------------oooo-----------------
---------------ooooS------------------------oSoSS--------oooooo-------------------oo-----------------------------------------------------------------------------ooo---------------r--------------------
---------------------------XXXXX--ooooo-------------------R------R-----------------g-r------------------oo-----ooo------------XXXXX---XXXXXX----------XXX-----------------------XXXXXXXXXXX---r---oo----
XXXXXXXXXXXXXX-ooooo-------XXXXX---KKk-gy---oooo--------XXXXXXXXXXX-ooooo------g-XXXXXXX-----------------r--------------------XXXXXXXXXXXXXX----ooo---XXX-------oooooo----------XXXXXXXXXXXXXXXXX---kGk-
XXXXXXXXXXXXXX----GR---XXXXXXXXXXXXXXXXXXXX---kgyg------XXXXXXXXXXX----gR--XXXXXXXXXXXXXXXXXX-----XXXXXXXXXXXXXXXXXXXXXXXXXXXXXXXXXXXXXXXXXXXXX-yG----XXXXXXX-k--kg--k---XXXX---XXXXXXXXXXXXXXXXXXXXXXXX
XXXXXXXXXXXXXXXXXXXXXXXXXXXXXXXXXXXXXXXXXXXXXXXXXXXXXXXXXXXXXXXXXXXXXXXXXXXXXXXXXXXXXXXXXXXXXXXXXXXXXXXXXXXXXXXXXXXXXXXXXXXXXXXXXXXXXXXXXXXXXXXXXXXXXXXXXXXXXXXXXXXXXXXXXXXXXXXXXXXXXXXXXXXXXXXXXXXXXXXX

