--------------------------------------------------------------------------------------------------------------------------------------------------------------------------------------------------------
--------------------------------------------------------------------------------------------------------------------------------------------------------------------------------------------------------
--------------------------------------------------------------------------------------------------------------------------------------------------------------------------------------------------------
--------------------------------------------------------------------------------------------------------------------------------------------------------------------------------------------------------
--------------------------------------------------------------------------------------------------------------------------------------------------------------------------------------------------------
--------------------------------------------------------------------------------------------------------------------------------------------------------------------------------------------------------
--------------------------------------------------------------------------------------------------------------------------------------------------------------------------------------------------------
--------------------------------------------------------------------------------------------------------------------------------------------------------------------------------------------------------
--------------------------------------------------------------------------------------------------------------------------------------------------------------------------------------------------------
--------------------------------------------------------------------------------------------------------------------------------------------------------------------------------------------------------
--------------------------------------------------------------------------------------------------------------------------------------------------------------------------------------------------------
--------------------------------------------------------------------------------------------------------------------------------------------------------------------------------------------------------
------------------------------------------------------------------------------------------oooS----------------------------------------------------------------------------------------------------------
-----------------oSooo-----------------oSS-----------------oSooSo--ooSSoooo---------------------------oSoS--------ooooo-------------------------------------------------------------------ooooS---------
--------------------------ooSo----------------SoSo----------------------------------------ooooo-------------------------------------oSSoo---------------------------------------------------------------
---------------oooooo----------------oooo-----------------oooo-----oooooo-----------------r-K-y--------ooooo----ooooooo-----------------------------oooSoo-------------------------------oooooo-----R---
---------------kgy--------oooooo----r----R-----ooooo-------kKr-r---r----K---XX-----------XXXXXXXXXXX-r---------Yk----k--------------ooooo------------------XXXXX-----------------------------ry---XXXXXX
--------------XXXXXXXXXXX---gk---XXXXXXXXXXX-y---Y------XXXXXXXXXXXXXXXXXXXXXX----r--r---XXXXXXXXXXXXXXXXXXXXXXXXXXXXXXX----oooo----y-------XXXXX---ooo----XXXXX--XXXXX-----XXX--------XXXXXXXXXXXXXXXXX
XXXXXXXXXXXXXXXXXXXXXXXXXXXXXXXXXXXXXXXXXXXXXXXXXXXXXX--XXXXXXXXXXXXXXXXXXXXXX---XXXXXXXXXXXXXXXXXXXXXXXXXXXXXXXXXXXXXXX---------XXXXXXXXXXXXXXXX---Gr-----XXXXX--XXXXX-----XXXXXXXXXXXXXXXXXXXXXXXXXXXX
XXXXXXXXXXXXXXXXXXXXXXXXXXXXXXXXXXXXXXXXXXXXXXXXXXXXXXXXXXXXXXXXXXXXXXXXXXXXXXXXXXXXXXXXXXXXXXXXXXXXXXXXXXXXXXXXXXXXXXXXXXXXXXXXXXXXXXXXXXXXXXXXXXXXXXXXXXXXXXXXXXXXXXXXXXXXXXXXXXXXXXXXXXXXXXXXXXXXXXXX

