--------------------------------------------------------------------------------------------------------------------------------------------------------------------------------------------------------
--------------------------------------------------------------------------------------------------------------------------------------------------------------------------------------------------------
--------------------------------------------------------------------------------------------------------------------------------------------------------------------------------------------------------
--------------------------------------------------------------------------------------------------------------------------------------------------------------------------------------------------------
--------------------------------------------------------------------------------------------------------------------------------------------------------------------------------------------------------
--------------------------------------------------------------------------------------------------------------------------------------------------------------------------------------------------------
--------------------------------------------------------------------------------------------------------------------------------------------------------------------------------------------------------
--------------------------------------------------------------------------------------------------------------------------------------------------------------------------------------------------------
--------------------------------------------------------------------------------------------------------------------------------------------------------------------------------------------------------
--------------------------------------------------------------------------------------------------------------------------------------------------------------------------------------------------------
--------------------------------------------------------------------------------------------------------------------------------------------------------------------------------------------------------
--------------------------------------------------------------------------------------------------------------------------------------------------------------------------------------------------------
-----------------SoSo----------------------------------------------------------------ooS------------------------------------------------ooS-------------------------------------------------------------
-------------------------------------------------------------------------------------------------------------------------------------------------------------oSSoo--------------------Sooo----oSoSooo---
----------------oooo---------------oooooSo------------------------ooSo-------oSo----oooo----------------------------ooSSo-----oo------ooooo-----------oo------------------------------------------------
---------------y-------------oo--------------------gkY-----------------------------y--r------ooooooo------------------------k-------------------ky----y--rk--oooo----------------G-----oo--------oo-----
--------------XXXXXXXX------y------ooooooo-----XXXXXXXXXXXXXXXXXX--ooooo--ooooo---XXXXXXXX-----------------------oooooo----XXXXXXXXXXXXXXXXXXXXXXXXXXXXXXXXX---kG-------XXXXXXXXXXX-r-G----y---kK--kg---
--------------XXXXXXXX-----XXXXXX--R-----Y-----XXXXXXXXXXXXXXXXXX-r--yr-----K---R-XXXXXXXX----oooooo-------XXXXX----kk--gg-XXXXXXXXXXXXXXXXXXXXXXXXXXXXXXXXXXXXXXXXX----XXXXXXXXXXXXXXXXXXXXXXXXXXXXXXXX
--------------XXXXXXXXXXXXXXXXXXXXXXXXXXXXXX---XXXXXXXXXXXXXXXXXXXXXXXXXXXXXXXXXXXXXXXXXXX---K-gg--y-XXXXXXXXXXXXXXXXXXXXXXXXXXXXXXXXXXXXXXXXXXXXXXXXXXXXXXXXXXXXXXXXXXXXXXXXXXXXXXXXXXXXXXXXXXXXXXXXXXX
XXXXXXXXXXXXXXXXXXXXXXXXXXXXXXXXXXXXXXXXXXXXXXXXXXXXXXXXXXXXXXXXXXXXXXXXXXXXXXXXXXXXXXXXXXXXXXXXXXXXXXXXXXXXXXXXXXXXXXXXXXXXXXXXXXXXXXXXXXXXXXXXXXXXXXXXXXXXXXXXXXXXXXXXXXXXXXXXXXXXXXXXXXXXXXXXXXXXXXXX

