--------------------------------------------------------------------------------------------------------------------------------------------------------------------------------------------------------
--------------------------------------------------------------------------------------------------------------------------------------------------------------------------------------------------------
--------------------------------------------------------------------------------------------------------------------------------------------------------------------------------------------------------
--------------------------------------------------------------------------------------------------------------------------------------------------------------------------------------------------------
--------------------------------------------------------------------------------------------------------------------------------------------------------------------------------------------------------
--------------------------------------------------------------------------------------------------------------------------------------------------------------------------------------------------------
--------------------------------------------------------------------------------------------------------------------------------------------------------------------------------------------------------
--------------------------------------------------------------------------------------------------------------------------------------------------------------------------------------------------------
--------------------------------------------------------------------------------------------------------------------------------------------------------------------------------------------------------
--------------------------------------------------------------------------------------------------------------------------------------------------------------------------------------------------------
--------------------------------------------------------------------------------------------------------------------------------------------------------------------------------------------------------
--------------------------------------------------------------------------------------------------------------------------------------------------------------------------------------------------------
-------------------------------------------------------------------ooSSoooSo----------------------------------------------------------------------------------------------------------------------------
---------------------------------oooo-------------ooo-----Soooo-----------------------------------------------------------------------------------------------------------------------------------------
---------------------------------------------------------------------oooooo----------------------ooo-------------------------------------------------------------------oSoooooS-------------------------
-------------------------------oooooooo--oSSo-------ooo-----oo-------KGG---y---G----------------------------------------ooo------------------------------------oSooSo-------------------------y--oSooSo-
XXXXXXXXXXXXXX---oo---XXX--------rg---G------------KY-----Y---y-g-XXXXXXXXXXXXXXXXXX----------oooooo--------k--r-------------------XXX--ooo-----------XXXXX---------------oooo------------XXXXXX--------
XXXXXXXXXXXXXXXX-y--Y-XXX----XXXXXXXXXXX---ooo---XXXXXXXXXXXXXXXXXXXXXXXXXXXXXXXXXXX---------------y--XXXXXXXXXXXXXXXX-ooooooo-XXXXXXX-r-y-g-XX--Y-y--XXXXX----oooo------G----yG--ooo-----XXXXXX-ooooo--
XXXXXXXXXXXXXXXXXXXXXXXXXXXXXXXXXXXXXXXX----g-kK-XXXXXXXXXXXXXXXXXXXXXXXXXXXXXXXXXXXXXXXXXXXXXXXXXXXXXXXXXXXXXXXXXXXXX---------XXXXXXXXXXXXXXXXXXXXXXXXXXXXXXX--------XXXXXXXXXXX------XXXXXXXXX--------
XXXXXXXXXXXXXXXXXXXXXXXXXXXXXXXXXXXXXXXXXXXXXXXXXXXXXXXXXXXXXXXXXXXXXXXXXXXXXXXXXXXXXXXXXXXXXXXXXXXXXXXXXXXXXXXXXXXXXXXXXXXXXXXXXXXXXXXXXXXXXXXXXXXXXXXXXXXXXXXXXXXXXXXXXXXXXXXXXXXXXXXXXXXXXXXXXXXXXXXX

