--------------------------------------------------------------------------------------------------------------------------------------------------------------------------------------------------------
--------------------------------------------------------------------------------------------------------------------------------------------------------------------------------------------------------
--------------------------------------------------------------------------------------------------------------------------------------------------------------------------------------------------------
--------------------------------------------------------------------------------------------------------------------------------------------------------------------------------------------------------
--------------------------------------------------------------------------------------------------------------------------------------------------------------------------------------------------------
--------------------------------------------------------------------------------------------------------------------------------------------------------------------------------------------------------
--------------------------------------------------------------------------------------------------------------------------------------------------------------------------------------------------------
--------------------------------------------------------------------------------------------------------------------------------------------------------------------------------------------------------
--------------------------------------------------------------------------------------------------------------------------------------------------------------------------------------------------------
--------------------------------------------------------------------------------------------------------------------------------------------------------------------------------------------------------
--------------------------------------------------------------------------------------------------------------------------------------------------------------------------------------------------------
--------------------------------------------------------------------------------------------------------------------------------------------------------------------------------------------------------
---------------------------------------------------------------------------------------------------oSooSoo---------------oooSoSS------------------------------------------------------------------------
----------------Sooooo-----------------------------ooooooo----------------------------------oSooo---------------------------------------------------ooo---------oSoSoo----------------------------------
----------------------------------------------------------------------------------------------------oooooo-------oooo-----oooooooo----------------------------------------------------------------------
----------------ooooooo--------------ooSoo----------ooooooo-----------------ooSSo------------ooo------g-------------------k-kY---------------------------------oooooooo---------oSoSo-------------------
-------------------grR--------------------------XX-G----y-y---------------------------------Gg-yy-XXXXXXXXX-------ooo---XXXXXXXXXXX-ooooo---ooo-------------y----YY-----XX-------------------oo---------
XXXXXXXXXXXXXXXXXXXXXXXX---oo-----------ooo--XXXXXXXXXXXXXXX----XXXX------ooooooo---------XXXXXXXXXXXXXXXXX-------k-----XXXXXXXXXXX-r-g-y--ryy--XXXXXXXXXXXXXXXXXXXXXXXXXX--------ooo-----k--k-r-XXXX---
XXXXXXXXXXXXXXXXXXXXXXXX-k--G---XX----y-yg---XXXXXXXXXXXXXXX----XXXX---XX---kK--rkr---yr--XXXXXXXXXXXXXXXXXXXXXXXXXXXXXXXXXXXXXXXXXXXXXXXXXXXXXXXXXXXXXXXXXXXXXXXXXXXXXXXX-------r-----R-XXXXXXXXXXXXXXX
XXXXXXXXXXXXXXXXXXXXXXXXXXXXXXXXXXXXXXXXXXXXXXXXXXXXXXXXXXXXXXXXXXXXXXXXXXXXXXXXXXXXXXXXXXXXXXXXXXXXXXXXXXXXXXXXXXXXXXXXXXXXXXXXXXXXXXXXXXXXXXXXXXXXXXXXXXXXXXXXXXXXXXXXXXXXXXXXXXXXXXXXXXXXXXXXXXXXXXXX

