--------------------------------------------------------------------------------------------------------------------------------------------------------------------------------------------------------
--------------------------------------------------------------------------------------------------------------------------------------------------------------------------------------------------------
--------------------------------------------------------------------------------------------------------------------------------------------------------------------------------------------------------
--------------------------------------------------------------------------------------------------------------------------------------------------------------------------------------------------------
--------------------------------------------------------------------------------------------------------------------------------------------------------------------------------------------------------
--------------------------------------------------------------------------------------------------------------------------------------------------------------------------------------------------------
--------------------------------------------------------------------------------------------------------------------------------------------------------------------------------------------------------
--------------------------------------------------------------------------------------------------------------------------------------------------------------------------------------------------------
--------------------------------------------------------------------------------------------------------------------------------------------------------------------------------------------------------
--------------------------------------------------------------------------------------------------------------------------------------------------------------------------------------------------------
--------------------------------------------------------------------------------------------------------------------------------------------------------------------------------------------------------
--------------------------------------------------------------------------------------------------------------------------------------------------------------------------------------------------------
------------------------------------------SoSSo--------------oSoo----------------------------------------------------------------------oSS-------------oSooo-----oSo------------------------------------
-------------------------------ooo-------------------------------------------------ooooooSoo------------------------------------------------------------------------------------------------------------
-------------SooSS------------------------ooo------SooS---------------------------------------------------------------------------------oooo-------------ooo----ooo-------------------------------------
-------------------------------ooooo---r-y-g----------------GG-k--k------------------ooooo----------k-y-y---------------------------------y---------------k---y----kk----ooo----------------------------
-------------oooooo---XXXXXX-----gy---XXXXXXXXXXX---ooo----XXXXXXXXX----------XXXX----Gky-----oooo-XXXXXXX----------oo----oooo-------XXXXXXXX----XXXXXXXXXXXXXXXXXXXXX------------------------------XXXX
----------------r-r---XXXXXXXXXXXXXXXXXXXXXXXXXXX----------XXXXXXXXX-------kr-XXXXXXXXXXXXXXX---y--XXXXXXXXXXXXXX-r-R-k---g--KR-XXXXXXXXXXXXX----XXXXXXXXXXXXXXXXXXXXX-----------ooo-----------XXXXXXXXX
XXXXXXXXXXXXXXXXXXXXXXXXXXXXXXXXXXXXXXXXXXXXXXXXXXXXXXXXXXXXXXXXXXXX----XXXXXXXXXXXXXXXXXXXXXXXXXXXXXXXXXXXXXXXXXXXXXXXXXXXXXXXXXXXXXXXXXXXXXXXXXXXXXXXXXXXXXXXXXXXXXX-R------yyy--y-XXXXX-----XXXXXXXXX
XXXXXXXXXXXXXXXXXXXXXXXXXXXXXXXXXXXXXXXXXXXXXXXXXXXXXXXXXXXXXXXXXXXXXXXXXXXXXXXXXXXXXXXXXXXXXXXXXXXXXXXXXXXXXXXXXXXXXXXXXXXXXXXXXXXXXXXXXXXXXXXXXXXXXXXXXXXXXXXXXXXXXXXXXXXXXXXXXXXXXXXXXXXXXXXXXXXXXXXX

