--------------------------------------------------------------------------------------------------------------------------------------------------------------------------------------------------------
--------------------------------------------------------------------------------------------------------------------------------------------------------------------------------------------------------
--------------------------------------------------------------------------------------------------------------------------------------------------------------------------------------------------------
--------------------------------------------------------------------------------------------------------------------------------------------------------------------------------------------------------
--------------------------------------------------------------------------------------------------------------------------------------------------------------------------------------------------------
--------------------------------------------------------------------------------------------------------------------------------------------------------------------------------------------------------
--------------------------------------------------------------------------------------------------------------------------------------------------------------------------------------------------------
--------------------------------------------------------------------------------------------------------------------------------------------------------------------------------------------------------
--------------------------------------------------------------------------------------------------------------------------------------------------------------------------------------------------------
--------------------------------------------------------------------------------------------------------------------------------------------------------------------------------------------------------
--------------------------------------------------------------------------------------------------------------------------------------------------------------------------------------------------------
--------------------------------------------------------------------------------------------------------------------------------------------------------------------------------------------------------
-------------------------------------------------------------------------------------------------------------Sooooo-------------------------------------------------------------------------------------
--------------------------------------oSoS-------------------------------------------------------------------------------------------------oSoooo----------------------------------------oooSSo---------
-----------ooSoo--------------oo-------------------------------------------ooS---------------------------------ooooo--------------------------------oooo--------------------------------------------ooo-
------------------------------k------ooooooo--------------oooo-----------------------SSoo---oo--------------y----r-Y-----Sooo----oooSo-----oooo-----------------------------oo--------oooooo------------
------------ooo-------------XXXXXX---kg--y-K--------------------------XXX-oooooo---------------g-----oo----XXXXXXXXXX---------------------r-R-yy----ooo-----XX-----------gr-----------k--r-------ooo----
------------yk--y--XXXXX----XXXXXXXXXXXXXXXXX------oo----ooo----oooo--XXX---K-y--XX-------XXXXXXX---r--g---XXXXXXXXXX--oooooo------oooo--XXXXXXXXX-----G----XXXXXXXXXXXXXXXXXXX------XXXXXXXXXXX-----g--
XXXXXXXXXXXXXXXXXXXXXXXX----XXXXXXXXXXXXXXXXX----------------r--r-----XXXXXXXXXXXXX---R---XXXXXXXXXXXXXXXXXXXXXXXXXXX-----------------rr-XXXXXXXXXXXXXXXXXXXXXXXXXXXXXXXXXXXXXX---k--XXXXXXXXXXXXXXXXXXX
XXXXXXXXXXXXXXXXXXXXXXXXXXXXXXXXXXXXXXXXXXXXXXXXXXXXXXXXXXXXXXXXXXXXXXXXXXXXXXXXXXXXXXXXXXXXXXXXXXXXXXXXXXXXXXXXXXXXXXXXXXXXXXXXXXXXXXXXXXXXXXXXXXXXXXXXXXXXXXXXXXXXXXXXXXXXXXXXXXXXXXXXXXXXXXXXXXXXXXXX

