--------------------------------------------------------------------------------------------------------------------------------------------------------------------------------------------------------
--------------------------------------------------------------------------------------------------------------------------------------------------------------------------------------------------------
--------------------------------------------------------------------------------------------------------------------------------------------------------------------------------------------------------
--------------------------------------------------------------------------------------------------------------------------------------------------------------------------------------------------------
--------------------------------------------------------------------------------------------------------------------------------------------------------------------------------------------------------
--------------------------------------------------------------------------------------------------------------------------------------------------------------------------------------------------------
--------------------------------------------------------------------------------------------------------------------------------------------------------------------------------------------------------
--------------------------------------------------------------------------------------------------------------------------------------------------------------------------------------------------------
--------------------------------------------------------------------------------------------------------------------------------------------------------------------------------------------------------
--------------------------------------------------------------------------------------------------------------------------------------------------------------------------------------------------------
--------------------------------------------------------------------------------------------------------------------------------------------------------------------------------------------------------
--------------------------------------------------------------------------------------------------------------------------------------------------------------------------------------------------------
---------------------SSo--------------------------------------------ooSoo----------------------------------SoSooSo------oSo-------------------------------ooSSoo----------------------------------------
----------------------------------------------oooooS------------------------ooo-------------------------------------------------------------------------------------------------------------------------
---------------------oooo--------------------------------------------ooo------------------------------------ooooo-----ooooooo--------SoSo-------------------ooooo-------oSo-----ooooo----------ooooo----
---------------------y-----------oooooo-------ooooooo-----Soo-------g-k------oo--------------r-------------r------------y-y-------------------------------y-g----r--------------------------------------
-----------------XXXXXXXXXXX-----Yyr---------r----y--K------------XXXXXXXX---g---------XXXXXXXXXXX-------XXXXXXXXXXXXXXXXXXXXXXXXX--oooo-----------------XXXXXXXXXXX-oooooooo----------y-----oooooooo-XX
----------XXXXXXXXXXXXXXXXXX---XXXXXXXXX----XXXXXXXXXXX--oo---XXXXXXXXXXXXXXXXXXXX-----XXXXXXXXXXX-----XXXXXXXXXXXXXXXXXXXXXXXXXXX-y--------------ooo----XXXXXXXXXXX-y---k-gk-----r---XXXXXX----------XX
----------XXXXXXXXXXXXXXXXXXXXXXXXXXXXXXXXXXXXXXXXXXXXX----gG-XXXXXXXXXXXXXXXXXXXXXXXXXXXXXXXXXXXX-----XXXXXXXXXXXXXXXXXXXXXXXXXXXXXXXXXXXXXXXXXX-----g--XXXXXXXXXXXXXXXXXXXXXXXXXXXXXXXXXXXXXXXXXXXXXXX
XXXXXXXXXXXXXXXXXXXXXXXXXXXXXXXXXXXXXXXXXXXXXXXXXXXXXXXXXXXXXXXXXXXXXXXXXXXXXXXXXXXXXXXXXXXXXXXXXXXXXXXXXXXXXXXXXXXXXXXXXXXXXXXXXXXXXXXXXXXXXXXXXXXXXXXXXXXXXXXXXXXXXXXXXXXXXXXXXXXXXXXXXXXXXXXXXXXXXXXX

