--------------------------------------------------------------------------------------------------------------------------------------------------------------------------------------------------------
--------------------------------------------------------------------------------------------------------------------------------------------------------------------------------------------------------
--------------------------------------------------------------------------------------------------------------------------------------------------------------------------------------------------------
--------------------------------------------------------------------------------------------------------------------------------------------------------------------------------------------------------
--------------------------------------------------------------------------------------------------------------------------------------------------------------------------------------------------------
--------------------------------------------------------------------------------------------------------------------------------------------------------------------------------------------------------
--------------------------------------------------------------------------------------------------------------------------------------------------------------------------------------------------------
--------------------------------------------------------------------------------------------------------------------------------------------------------------------------------------------------------
--------------------------------------------------------------------------------------------------------------------------------------------------------------------------------------------------------
--------------------------------------------------------------------------------------------------------------------------------------------------------------------------------------------------------
--------------------------------------------------------------------------------------------------------------------------------------------------------------------------------------------------------
--------------------------------------------------------------------------------------------------------------------------------------------------------------------------------------------------------
----------------------------------------------------------------------------------------------oSooSoS---------------------------------------------------------------------------------------------------
---------------oooo-------------------------------------------------oSo---------------------------------------------------------------------------------------------------------------------------------
-------------------------------------------------------oooo-------------------------------------oooo---------Sooooo--------------------------------ooooo----------------oo----------------oSooooS-------
---------------oooo-------------SoooSo------------------------------oo-----SSoSoo-----ooooo----R-----g------------------Soo-------------ooo------------g-----oooSoo------k-----Soooo--------------------
XXXXXXXXXXXX------yg----------------------------------XXXXXX-----------------------XX--------XXXXXXXXXX------oooooo-------------oooo--------------XXXXXXXX-----------XXXXXX---------------ooooooo-------
XXXXXXXXXXXXXXXXXXXXXX----------ooooo-----------------XXXXXX--rK--XXXXXX----ooo----XX-oooo---XXXXXXXXXX---G-----y------------------gg---ooo-------XXXXXXXX----ooooo--XXXXXX--oooooooo---------rr--------
XXXXXXXXXXXXXXXXXXXXXX-----XXX-k--Y--y--------XXXXX---XXXXXXXXXXXXXXXXXX-----g--yk-XX--Y-Kg--XXXXXXXXXXXXXXXXXXXXXXX---yk-g-XXXXXXXXXX----k-------XXXXXXXX---K--yK---XXXXXX----Rk-----XXXXXXXXXXXXXXXXXX
XXXXXXXXXXXXXXXXXXXXXXXXXXXXXXXXXXXXXXXXXXXXXXXXXXXXXXXXXXXXXXXXXXXXXXXXXXXXXXXXXXXXXXXXXXXXXXXXXXXXXXXXXXXXXXXXXXXXXXXXXXXXXXXXXXXXXXXXXXXXXXXXXXXXXXXXXXXXXXXXXXXXXXXXXXXXXXXXXXXXXXXXXXXXXXXXXXXXXXXX

