--------------------------------------------------------------------------------------------------------------------------------------------------------------------------------------------------------
--------------------------------------------------------------------------------------------------------------------------------------------------------------------------------------------------------
--------------------------------------------------------------------------------------------------------------------------------------------------------------------------------------------------------
--------------------------------------------------------------------------------------------------------------------------------------------------------------------------------------------------------
--------------------------------------------------------------------------------------------------------------------------------------------------------------------------------------------------------
--------------------------------------------------------------------------------------------------------------------------------------------------------------------------------------------------------
--------------------------------------------------------------------------------------------------------------------------------------------------------------------------------------------------------
--------------------------------------------------------------------------------------------------------------------------------------------------------------------------------------------------------
--------------------------------------------------------------------------------------------------------------------------------------------------------------------------------------------------------
--------------------------------------------------------------------------------------------------------------------------------------------------------------------------------------------------------
--------------------------------------------------------------------------------------------------------------------------------------------------------------------------------------------------------
--------------------------------------------------------------------------------------------------------------------------------------------------------------------------------------------------------
-------------------------------------------------oooSSoo------------------------------------------------------------------------------------------------------------------------------------------------
--------------------------------------------------------------------------------------------------------ooSo----------------------------------------------------------oSooS-----------------------------
-------------------------------------------Soo-----ooooo------------------------oSooo----------------------------------SoSoo-----ooooooo----------------------------------------------------------------
-------------ooSS--------------------------------gy----rY---oooo----oo---------------------------oSo----------------------------------------ooSoo-----------------------ooooo--oooSo---------ooooSo-----
XXXXXXXXXXXX-------XX-------------------ooooooo-XXXXXXXXXX-yk--------k---oo------oooooo------------------r-------------ooooo---oooooooo-------------------ooo----------r--ky----------------------------
XXXXXXXXXXXX--oooo-XX-ooo---------------R--Y--k-XXXXXXXXXXXXXXXXXXXXXXX-yg-----------k---XXXXX----oooo-XXXXXXXXX-----g----G-g--r-k--R--y--oooo----XXXXXXX------------XXXXXXXXX-ooooo-----gk---------XXXX
XXXXXXXXXXXX-------XX----y-XXXXXXXXXXXXXXXXXXXXXXXXXXXXXXXXXXXXXXXXXXXXXXXXXXXXXXXXXXXXXXXXXXX-yy--g---XXXXXXXXXXXXXXXXXXXXXXXXXXXXXXXXXX----Y----XXXXXXXXXXXXXX-----XXXXXXXXX--krK--XXXXXXX--k-g-K-XXXX
XXXXXXXXXXXXXXXXXXXXXXXXXXXXXXXXXXXXXXXXXXXXXXXXXXXXXXXXXXXXXXXXXXXXXXXXXXXXXXXXXXXXXXXXXXXXXXXXXXXXXXXXXXXXXXXXXXXXXXXXXXXXXXXXXXXXXXXXXXXXXXXXXXXXXXXXXXXXXXXXXXXXXXXXXXXXXXXXXXXXXXXXXXXXXXXXXXXXXXXX

