--------------------------------------------------------------------------------------------------------------------------------------------------------------------------------------------------------
--------------------------------------------------------------------------------------------------------------------------------------------------------------------------------------------------------
--------------------------------------------------------------------------------------------------------------------------------------------------------------------------------------------------------
--------------------------------------------------------------------------------------------------------------------------------------------------------------------------------------------------------
--------------------------------------------------------------------------------------------------------------------------------------------------------------------------------------------------------
--------------------------------------------------------------------------------------------------------------------------------------------------------------------------------------------------------
--------------------------------------------------------------------------------------------------------------------------------------------------------------------------------------------------------
--------------------------------------------------------------------------------------------------------------------------------------------------------------------------------------------------------
--------------------------------------------------------------------------------------------------------------------------------------------------------------------------------------------------------
--------------------------------------------------------------------------------------------------------------------------------------------------------------------------------------------------------
--------------------------------------------------------------------------------------------------------------------------------------------------------------------------------------------------------
--------------------------------------------------------------------------------------------------------------------------------------------------------------------------------------------------------
-----------------------------------------------------------oSSSooo-----------------------------------ooSo-----------oooo---------------------------oSo--------------------------------------------------
-----------------------------------------------------------------------------SooSS-----------------------------------------------oSoSoSo---oSo--------------------------------------------------Soo-----
---------------------------------oo--------------------------ooooo---------------------------------------------------oooo------------------------oooooo-------------------------------------------------
-------------------------------Rg--------------------ooo---y---Rg------------oooo---------------------g--G--------r-G------------ooooo-----oooo--k-rg--------------oSSooSoo--oSSooSo---------ooo--------
-----------XXXX---------------XXXXXX---------oo----------XXXXXXXXXXX-G------R---Kg-k---------ooooo-XXXXXXXX------XXXXXXXXXXX-------k-------r-rk-XXXXXXXXX-----------------------------------------------
XXXXXXXXXXXXXXX-----oo--------XXXXXX-----------gk-XXXXXXXXXXXXXXXXXXXXXXXXXXXXXXXXXXX-------R------XXXXXXXX----XXXXXXXXXXXXX----XXXXXXXXXXXXXXXXXXXXXXXXX-----------ooooooo---oooo----------XXXXXXXX----
XXXXXXXXXXXXXXX-------kY------XXXXXX--------XXXXXXXXXXXXXXXXXXXXXXXXXXXXXXXXXXXXXXXXX---y--XXXXXXXXXXXXXXXX----XXXXXXXXXXXXXXXXXXXXXXXXXXXXXXXXXXXXXXXXXXXXXXX-----Gg---Gy----k-g------r-ry-XXXXXXXXXXXX
XXXXXXXXXXXXXXXXXXXXXXXXXXXXXXXXXXXXXXXXXXXXXXXXXXXXXXXXXXXXXXXXXXXXXXXXXXXXXXXXXXXXXXXXXXXXXXXXXXXXXXXXXXXXXXXXXXXXXXXXXXXXXXXXXXXXXXXXXXXXXXXXXXXXXXXXXXXXXXXXXXXXXXXXXXXXXXXXXXXXXXXXXXXXXXXXXXXXXXXX

