--------------------------------------------------------------------------------------------------------------------------------------------------------------------------------------------------------
--------------------------------------------------------------------------------------------------------------------------------------------------------------------------------------------------------
--------------------------------------------------------------------------------------------------------------------------------------------------------------------------------------------------------
--------------------------------------------------------------------------------------------------------------------------------------------------------------------------------------------------------
--------------------------------------------------------------------------------------------------------------------------------------------------------------------------------------------------------
--------------------------------------------------------------------------------------------------------------------------------------------------------------------------------------------------------
--------------------------------------------------------------------------------------------------------------------------------------------------------------------------------------------------------
--------------------------------------------------------------------------------------------------------------------------------------------------------------------------------------------------------
--------------------------------------------------------------------------------------------------------------------------------------------------------------------------------------------------------
--------------------------------------------------------------------------------------------------------------------------------------------------------------------------------------------------------
--------------------------------------------------------------------------------------------------------------------------------------------------------------------------------------------------------
--------------------------------------------------------------------------------------------------------------------------------------------------------------------------------------------------------
--------------------------------------------------------------------------------------------------------------------------oooooo------------------------------------------------------------------------
------------------------------------------------------------------------------------------------------------------------------------------ooo---------ooSoooo---ooooooSo--------------------------------
----------------------ooSS--------------------------SoSoo-------------------------------------------------ooSSoSoo---------oooo-------------------------------------------------------------------------
--------------oSSooo-----------oooSo-------ooo--------------------yk------------ooo------------------------------------------G-r---------oooo----------oooo-----ooooooo---------------------------------
----------------------ooooooo---------XXXX--------ooooooooo-XXXXXXXXXXX----------------------oo------------ooooooo------XXXXXXXXX--ooo---Y-R-------------k------G----gg----------------------XXXXX-ry---
XXXXXXXXXX---oooooo----yr-y------ooo--XXXX--------y-------Y-XXXXXXXXXXX--y--r---oo----XXXX-y-R-k-y------------g---------XXXXXXXXX-------XXXXXXX-oooo-XXXXXXXXXXXXXXXXXXXXXXXXX---------------XXXXXXXXXXX
XXXXXXXXXX---k-----y-XXXXXXXXX-----r--XXXX-gr----XXXXXXXXXXXXXXXXXXXXXXXXXXXXX-----r--XXXXXXXXXXXXX-g----XXXXXXXXXX-----XXXXXXXXXXXXXXXXXXXXXXX-Y----XXXXXXXXXXXXXXXXXXXXXXXXXXXXXXXXXXXXXXXXXXXXXXXXXXX
XXXXXXXXXXXXXXXXXXXXXXXXXXXXXXXXXXXXXXXXXXXXXXXXXXXXXXXXXXXXXXXXXXXXXXXXXXXXXXXXXXXXXXXXXXXXXXXXXXXXXXXXXXXXXXXXXXXXXXXXXXXXXXXXXXXXXXXXXXXXXXXXXXXXXXXXXXXXXXXXXXXXXXXXXXXXXXXXXXXXXXXXXXXXXXXXXXXXXXXX

