--------------------------------------------------------------------------------------------------------------------------------------------------------------------------------------------------------
--------------------------------------------------------------------------------------------------------------------------------------------------------------------------------------------------------
--------------------------------------------------------------------------------------------------------------------------------------------------------------------------------------------------------
--------------------------------------------------------------------------------------------------------------------------------------------------------------------------------------------------------
--------------------------------------------------------------------------------------------------------------------------------------------------------------------------------------------------------
--------------------------------------------------------------------------------------------------------------------------------------------------------------------------------------------------------
--------------------------------------------------------------------------------------------------------------------------------------------------------------------------------------------------------
--------------------------------------------------------------------------------------------------------------------------------------------------------------------------------------------------------
--------------------------------------------------------------------------------------------------------------------------------------------------------------------------------------------------------
--------------------------------------------------------------------------------------------------------------------------------------------------------------------------------------------------------
--------------------------------------------------------------------------------------------------------------------------------------------------------------------------------------------------------
--------------------------------------------------------------------------------------------------------------------------------------------------------------------------------------------------------
---------------------------------------------ooooooo------------------------------------------------------oooS------------------------------------------------------------------------------oSooooo-----
--------------------------------------------------------------------------------------------------------------------oSSoo-----------------oSSooo---------SSSo--------------------oooo-------------------
---------------------------------------------ooooooo------------------------------Sooooo-------------------oo--------------------------------------------------------oooooo-------------------ooooo-----
--------------ooo--------------SSooo---oSoo---g-K----------------------oSoSoooo-----------------ooooo-----yy---------oo---------------------oooo-------ooooo----yrr-----Gy-----ooo----------Kk-g--Gr----
XXXXXXXXXXXX-gKkY---------------------------XXXXXXXXX----XXXXX--XXXXX------------oooo-------------------XXXXXXXX-----G-k-g-XXX--------XX-------G-XXXXX--y-----XXXXXXXXXXXXXXX---Ryk--------XXXXXXXXXX---
XXXXXXXXXXXXXXXXXXXX-ooooo---oooooo---ooo---XXXXXXXXX----XXXXXXXXXXXX--oooooooo----rgrk--XXXX----ooo----XXXXXXXXXXXXXXXXXXXXXX--------XXXXXXXXXXXXXXXXXXXXXXXXXXXXXXXXXXXXXXXXXXXXXXXX-----XXXXXXXXXX---
XXXXXXXXXXXXXXXXXXXX-y--k-k----r---g--gk----XXXXXXXXX----XXXXXXXXXXXX-rg---r----XXXXXXXXXXXXX---g-------XXXXXXXXXXXXXXXXXXXXXX----R-XXXXXXXXXXXXXXXXXXXXXXXXXXXXXXXXXXXXXXXXXXXXXXXXXXXXXXXXXXXXXXXXXXXX
XXXXXXXXXXXXXXXXXXXXXXXXXXXXXXXXXXXXXXXXXXXXXXXXXXXXXXXXXXXXXXXXXXXXXXXXXXXXXXXXXXXXXXXXXXXXXXXXXXXXXXXXXXXXXXXXXXXXXXXXXXXXXXXXXXXXXXXXXXXXXXXXXXXXXXXXXXXXXXXXXXXXXXXXXXXXXXXXXXXXXXXXXXXXXXXXXXXXXXXX

