--------------------------------------------------------------------------------------------------------------------------------------------------------------------------------------------------------
--------------------------------------------------------------------------------------------------------------------------------------------------------------------------------------------------------
--------------------------------------------------------------------------------------------------------------------------------------------------------------------------------------------------------
--------------------------------------------------------------------------------------------------------------------------------------------------------------------------------------------------------
--------------------------------------------------------------------------------------------------------------------------------------------------------------------------------------------------------
--------------------------------------------------------------------------------------------------------------------------------------------------------------------------------------------------------
--------------------------------------------------------------------------------------------------------------------------------------------------------------------------------------------------------
--------------------------------------------------------------------------------------------------------------------------------------------------------------------------------------------------------
--------------------------------------------------------------------------------------------------------------------------------------------------------------------------------------------------------
--------------------------------------------------------------------------------------------------------------------------------------------------------------------------------------------------------
--------------------------------------------------------------------------------------------------------------------------------------------------------------------------------------------------------
--------------------------------------------------------------------------------------------------------------------------------------------------------------------------------------------------------
----------------------------------------------------------------------------oSo--------------------------------------------------------Sooo-------------------------------------------------------oSooo-
--------------------------------------------------------------------------------------------------------------------------------------------------------------------------------------------------------
-----------------------SoSS------oSSo-----------------------------------------ooo--ooooo-----------------------------------------------oooo-------------------------------------------------------oooo--
--------------------------------------------oSo------ooSooSo----------------kG-KY----------------------------------------------------k---------------ooo-------ooo-----------------oooS----oooo---------
XXXXXXXXXXX----g-G------ooooo----oooo----------------------------oo---XXX--XXXXXXX---oo---------XXXXX-------------------------------XXXXXXXXX----------------Rg--K--------ooo----------------rKy-XXXXXXX
XXXXXXXXXXX---XXXXXXX--k---y--------------------------ooooo--XX-----k-XXXXXXXXXXXX--k---g-------XXXXX-oooo---XX------oo-----ooooo---XXXXXXXXX--XXX----ooooo-XXXXXXXXXXX-----g-XXXX-oooooo-XXXXXXXXXXXXXX
XXXXXXXXXXXXXXXXXXXXXXXXXXXXXXXXXXXXXXXXX-Grgk-G-XXX-----Gg--XXXXXXXXXXXXXXXXXXXXXXXXXXXXXXXXXXXXXXXX--Yk----XX-----k--G----K--r----XXXXXXXXXXXXXX----G-r---XXXXXXXXXXXXXXXXXXXXXX---g----XXXXXXXXXXXXXX
XXXXXXXXXXXXXXXXXXXXXXXXXXXXXXXXXXXXXXXXXXXXXXXXXXXXXXXXXXXXXXXXXXXXXXXXXXXXXXXXXXXXXXXXXXXXXXXXXXXXXXXXXXXXXXXXXXXXXXXXXXXXXXXXXXXXXXXXXXXXXXXXXXXXXXXXXXXXXXXXXXXXXXXXXXXXXXXXXXXXXXXXXXXXXXXXXXXXXXXX

