--------------------------------------------------------------------------------------------------------------------------------------------------------------------------------------------------------
--------------------------------------------------------------------------------------------------------------------------------------------------------------------------------------------------------
--------------------------------------------------------------------------------------------------------------------------------------------------------------------------------------------------------
--------------------------------------------------------------------------------------------------------------------------------------------------------------------------------------------------------
--------------------------------------------------------------------------------------------------------------------------------------------------------------------------------------------------------
--------------------------------------------------------------------------------------------------------------------------------------------------------------------------------------------------------
--------------------------------------------------------------------------------------------------------------------------------------------------------------------------------------------------------
--------------------------------------------------------------------------------------------------------------------------------------------------------------------------------------------------------
--------------------------------------------------------------------------------------------------------------------------------------------------------------------------------------------------------
--------------------------------------------------------------------------------------------------------------------------------------------------------------------------------------------------------
--------------------------------------------------------------------------------------------------------------------------------------------------------------------------------------------------------
--------------------------------------------------------------------------------------------------------------------------------------------------------------------------------------------------------
------------------------------------------------------SSSo------------------------------------------SSo--------------------------------------------------oooo-------------------------------------------
---------------------------------------------------------------------------------------------------------------------------------------------------------------------------------*-------------ooo------
------------------------------------------------------oooooo-----ooooSoo-------------------------ooooooooo-------------------------------------oSo--------oo---------------------*----------------------
------------------oSoSo---------oSooooo-----------------KY--y-------------ooSSooo------------------r-r--------SoS-----ooo------ooooo----------------------------r----------------*------ooo--oooooo-----
----------------------------------------------XXX---XXXXXXXXXX---oooo---------------------------XXXXXXXXXXX------------------------------------ooo------XXXXXXXXXXXXXXXXX--------*-----------k----------
XXXXXXXXXXX----r----oooo-------oooooo----y--r-XXX---XXXXXXXXXX--------y------oooo----------XX---XXXXXXXXXXX--oooo-----ooooo---ooooooo--ooo---------XXXXXXXXXXXXXXXXXXXXXX--ooo--XXX---------XXXXXXXXX---
XXXXXXXXXXXXXXXXX----R---XXXXX-----g----XXXXXXXXX---XXXXXXXXXXXXXXXXXXXXX-k------G-XXXXXXXXXX---XXXXXXXXXXX-y---------Gkg-R---k-k-r--------y-XXXXXXXXXXXXXXXXXXXXXXXXXXXX--yy-g-XXX---G---k-XXXXXXXXX---
XXXXXXXXXXXXXXXXXXXXXXXXXXXXXXXXXXXXXXXXXXXXXXXXXXXXXXXXXXXXXXXXXXXXXXXXXXXXXXXXXXXXXXXXXXXXXXXXXXXXXXXXXXXXXXXXXXXXXXXXXXXXXXXXXXXXXXXXXXXXXXXXXXXXXXXXXXXXXXXXXXXXXXXXXXXXXXXXXXXXXXXXXXXXXXXXXXXXXXXX

