--------------------------------------------------------------------------------------------------------------------------------------------------------------------------------------------------------
--------------------------------------------------------------------------------------------------------------------------------------------------------------------------------------------------------
--------------------------------------------------------------------------------------------------------------------------------------------------------------------------------------------------------
--------------------------------------------------------------------------------------------------------------------------------------------------------------------------------------------------------
--------------------------------------------------------------------------------------------------------------------------------------------------------------------------------------------------------
--------------------------------------------------------------------------------------------------------------------------------------------------------------------------------------------------------
--------------------------------------------------------------------------------------------------------------------------------------------------------------------------------------------------------
--------------------------------------------------------------------------------------------------------------------------------------------------------------------------------------------------------
--------------------------------------------------------------------------------------------------------------------------------------------------------------------------------------------------------
--------------------------------------------------------------------------------------------------------------------------------------------------------------------------------------------------------
--------------------------------------------------------------------------------------------------------------------------------------------------------------------------------------------------------
--------------------------------------------------------------------------------------------------------------------------------------------------------------------------------------------------------
--------------------------ooooSS-----------------------------SooSo------------oooooSo----------------oooooS---oSooo-------------------------------------------------------------------------------------
--------------------------------------------------------------------------------------------------------------------------------------------------------------------------------------------ooSoo-------
----------------Sooo-----oooooooo---------------------------ooooooo-----------oooooo----ooooo---------oooo------ooo------------------------------------ooo--oSSoooo-------------------------------------
---------------------------r-gGY------------------------------r---------------Y-rKG-G-------------------Gr-----K-r-R-----oooo----------------------------------------------------------------oo---------
XXXXXXXXXXXXXX-oo-------XXXXXXXXXXX--Y---------------------XXXXXXXXX-------XXXXXXXXXXX--ooooooo-----XXXXXXXXXXXXXXXXX------------y-r---------------------------ooo----------ooo----ooooooo--k-Y----XXXXX
XXXXXXXXXXXXXX---g-y----XXXXXXXXXXXXXXXXX--------oooo-XX---XXXXXXXXX--XXX--XXXXXXXXXXX---K--y-R-XXXXXXXXXXXXXXXXXXXXX----oooooo-XXXXXXX---------------------krK-g-k----XXXX-----------yg-R-XXXXXXXXXXXXX
XXXXXXXXXXXXXXXXXXXXXXXXXXXXXXXXXXXXXXXXX--------y-r--XX---XXXXXXXXXXXXXXXXXXXXXXXXXXXXXXXXXXXXXXXXXXXXXXXXXXXXXXXXXX---yr-k----XXXXXXX--G--k-XXXXXXXXXXXXXXXXXXXXXXXXXXXXXXXXXXXXXXXXXXXXXXXXXXXXXXXXXX
XXXXXXXXXXXXXXXXXXXXXXXXXXXXXXXXXXXXXXXXXXXXXXXXXXXXXXXXXXXXXXXXXXXXXXXXXXXXXXXXXXXXXXXXXXXXXXXXXXXXXXXXXXXXXXXXXXXXXXXXXXXXXXXXXXXXXXXXXXXXXXXXXXXXXXXXXXXXXXXXXXXXXXXXXXXXXXXXXXXXXXXXXXXXXXXXXXXXXXXX

