--------------------------------------------------------------------------------------------------------------------------------------------------------------------------------------------------------
--------------------------------------------------------------------------------------------------------------------------------------------------------------------------------------------------------
--------------------------------------------------------------------------------------------------------------------------------------------------------------------------------------------------------
--------------------------------------------------------------------------------------------------------------------------------------------------------------------------------------------------------
--------------------------------------------------------------------------------------------------------------------------------------------------------------------------------------------------------
--------------------------------------------------------------------------------------------------------------------------------------------------------------------------------------------------------
--------------------------------------------------------------------------------------------------------------------------------------------------------------------------------------------------------
--------------------------------------------------------------------------------------------------------------------------------------------------------------------------------------------------------
--------------------------------------------------------------------------------------------------------------------------------------------------------------------------------------------------------
--------------------------------------------------------------------------------------------------------------------------------------------------------------------------------------------------------
--------------------------------------------------------------------------------------------------------------------------------------------------------------------------------------------------------
--------------------------------------------------------------------------------------------------------------------------------------------------------------------------------------------------------
-----------------------------------oooS--------oooooo----ooSSSS-------------------------------oSoo------------------------------------------------------------------------------------------------------
----------------------------------------------------------------------------------------------------------------------------------------------------------------------------------------oooo------------
-------------------------------------ooooo------oooo--------oo--------------------------------oooooo-------------Soooo--------------------------------------------------------------------------ooSo----
------------------------------------Rk----------r---G----rY--k--Y-----ooSo--------oooooo----------K-R-------------------------------------ooooo----------------------------oSSSoo-----oooooo------------
--------------------------------XXXXXXXXXXX---XXXXXXXXXXXXXXXXXXXX---------------------------XXXXXXXXX-y-Yk--------oooooo-XX--------oo-----------oo------ooo-XXXXXXXXXXXX------------g--Yy--y---oo------
--------------------------------XXXXXXXXXXX---XXXXXXXXXXXXXXXXXXXX----ooo--------ooooooo--XXXXXXXXXXXXXXXXXXX------K------XX-r-k-----K----ooo----G------Ky---XXXXXXXXXXXX----oooooo-XXXXXXXXXXX--gR--XXX
XXXXXXXXXXXXXX-------------kyk--XXXXXXXXXXX---XXXXXXXXXXXXXXXXXXXX-yY-y-gk---------y------XXXXXXXXXXXXXXXXXXXXXXXXXXXXXXXXXXXXXXXXXXXXXX-g------XXXXXXXXXXXXXXXXXXXXXXXXX-k--ky-----XXXXXXXXXXXXXXXXXXXX
XXXXXXXXXXXXXXXXXXXXXXXXXXXXXXXXXXXXXXXXXXXXXXXXXXXXXXXXXXXXXXXXXXXXXXXXXXXXXXXXXXXXXXXXXXXXXXXXXXXXXXXXXXXXXXXXXXXXXXXXXXXXXXXXXXXXXXXXXXXXXXXXXXXXXXXXXXXXXXXXXXXXXXXXXXXXXXXXXXXXXXXXXXXXXXXXXXXXXXXX

