--------------------------------------------------------------------------------------------------------------------------------------------------------------------------------------------------------
--------------------------------------------------------------------------------------------------------------------------------------------------------------------------------------------------------
--------------------------------------------------------------------------------------------------------------------------------------------------------------------------------------------------------
--------------------------------------------------------------------------------------------------------------------------------------------------------------------------------------------------------
--------------------------------------------------------------------------------------------------------------------------------------------------------------------------------------------------------
--------------------------------------------------------------------------------------------------------------------------------------------------------------------------------------------------------
--------------------------------------------------------------------------------------------------------------------------------------------------------------------------------------------------------
--------------------------------------------------------------------------------------------------------------------------------------------------------------------------------------------------------
--------------------------------------------------------------------------------------------------------------------------------------------------------------------------------------------------------
--------------------------------------------------------------------------------------------------------------------------------------------------------------------------------------------------------
--------------------------------------------------------------------------------------------------------------------------------------------------------------------------------------------------------
--------------------------------------------------------------------------------------------------------------------------------------------------------------------------------------------------------
--------------------------------------------------------------------------------------------------------------------------------------------------------------------------------------------------------
-------------------------------------------oooSo-----------------------------oSSSoSo-------------------------------------------------ooS-----------------------------------------oooooo-----------------
--------------------------------SSo-----------------------------------------------------------------------------------------ooooooo------------------------------------------------------------oSoSSo---
----------------------------------------------oo----ooSo-----------------------oooo----------------------oooSo----ooooo-----------------oo--oSSo----------ooS----------k-----Y--ooooo-------------------
---------------------XXXXXXX--oo-----------k-g-------------------------------k--yKk--r----------y--------------------------ooooo--------------------------------------XXXXXXXXX-yY-G--y-------ooooooo---
XXXXXXXXXXXXX-----XXXXXXXXXX-rR-G---XXX---XXXXXXXXX--ooo--------------------XXXXXXXXXXXXXXXXXXXXXXXXXXXX----oo--XXXXXXXXX----g---Rg-XXXXXXX---------------------------XXXXXXXXXXXXXXXXXX----k-----------
XXXXXXXXXXXXXXXXXXXXXXXXXXXXXXXXXXXXXXX---XXXXXXXXX-Ky--K--------kr-XXXXX---XXXXXXXXXXXXXXXXXXXXXXXXXXXX--R--y--XXXXXXXXXXXXXXXXXXXXXXXXXXX--g---XX---------K--r------XXXXXXXXXXXXXXXXXX---XXXXXXXXXXX--
XXXXXXXXXXXXXXXXXXXXXXXXXXXXXXXXXXXXXXXXXXXXXXXXXXXXXXXXXXXXXXXXXXXXXXXXXXXXXXXXXXXXXXXXXXXXXXXXXXXXXXXXXXXXXXXXXXXXXXXXXXXXXXXXXXXXXXXXXXXXXXXXXXXXXXXXXXXXXXXXXXXXXXXXXXXXXXXXXXXXXXXXXXXXXXXXXXXXXXXX

