--------------------------------------------------------------------------------------------------------------------------------------------------------------------------------------------------------
--------------------------------------------------------------------------------------------------------------------------------------------------------------------------------------------------------
--------------------------------------------------------------------------------------------------------------------------------------------------------------------------------------------------------
--------------------------------------------------------------------------------------------------------------------------------------------------------------------------------------------------------
--------------------------------------------------------------------------------------------------------------------------------------------------------------------------------------------------------
--------------------------------------------------------------------------------------------------------------------------------------------------------------------------------------------------------
--------------------------------------------------------------------------------------------------------------------------------------------------------------------------------------------------------
--------------------------------------------------------------------------------------------------------------------------------------------------------------------------------------------------------
--------------------------------------------------------------------------------------------------------------------------------------------------------------------------------------------------------
--------------------------------------------------------------------------------------------------------------------------------------------------------------------------------------------------------
--------------------------------------------------------------------------------------------------------------------------------------------------------------------------------------------------------
--------------------------------------------------------------------------------------------------------------------------------------------------------------------------------------------------------
-------------------------------------ooo----------------------------------------------------------------------------------------------------------------------------------------------------------------
-----------------------------------------------------------------------------------------------ooS--------------SSoSo---------------------------------------ooSoSS------------ooooSo-----oooSoooo-------
------------------------------------ooo------ooSo--oooo---------------oo------Soooo----------------------------------------SoSooooo---------------------------------------------------------------------
-----------------ooo-----ooSSo----kyy-R-yg---------rYk-----------------Y-----------------------oooo----------ooooooo-----------------------------------------oooooooo---------oooooo------oooo-----kykg-
---------------------------------XXXXXXXXXX-------XXXXXX-----------XXXXXXX----oooo----------kY-k-G--g-----r--gG--ky-K-XXX-ooooooooo-------------------------r-y-y-y-----------------k------r------XXXXXX
XXXXXXXXXXXXXXX-oooooo------ooo--XXXXXXXXXX-------XXXXXX------R-g--XXXXXXX----Y------ooooo-XXXXXXXXXXXXXXXXXXXXXXXXXXXXXX-gy--------XXXXXXX----------------XXXXXXXXXXX-------XXXXXXXXXXXXXXXXXXXXXXXXXXX
XXXXXXXXXXXXXXX-y--------Yk-k----XXXXXXXXXXXXXXXXXXXXXXXXXXXXXXXXXXXXXXXXXXXXXXXXXXX-G-gg--XXXXXXXXXXXXXXXXXXXXXXXXXXXXXXXXXXXXXXXXXXXXXXXXXXXXXXXXXXXXXXXXXXXXXXXXXXX-k-g---XXXXXXXXXXXXXXXXXXXXXXXXXXX
XXXXXXXXXXXXXXXXXXXXXXXXXXXXXXXXXXXXXXXXXXXXXXXXXXXXXXXXXXXXXXXXXXXXXXXXXXXXXXXXXXXXXXXXXXXXXXXXXXXXXXXXXXXXXXXXXXXXXXXXXXXXXXXXXXXXXXXXXXXXXXXXXXXXXXXXXXXXXXXXXXXXXXXXXXXXXXXXXXXXXXXXXXXXXXXXXXXXXXXX

