--------------------------------------------------------------------------------------------------------------------------------------------------------------------------------------------------------
--------------------------------------------------------------------------------------------------------------------------------------------------------------------------------------------------------
--------------------------------------------------------------------------------------------------------------------------------------------------------------------------------------------------------
--------------------------------------------------------------------------------------------------------------------------------------------------------------------------------------------------------
--------------------------------------------------------------------------------------------------------------------------------------------------------------------------------------------------------
--------------------------------------------------------------------------------------------------------------------------------------------------------------------------------------------------------
--------------------------------------------------------------------------------------------------------------------------------------------------------------------------------------------------------
--------------------------------------------------------------------------------------------------------------------------------------------------------------------------------------------------------
--------------------------------------------------------------------------------------------------------------------------------------------------------------------------------------------------------
--------------------------------------------------------------------------------------------------------------------------------------------------------------------------------------------------------
--------------------------------------------------------------------------------------------------------------------------------------------------------------------------------------------------------
--------------------------------------------------------------------------------------------------------------------------------------------------------------------------------------------------------
------------------------oSSoSS---------------------------------------------------------------------------------------------------------------------------------------------ooo------------oSooSSo-------
--------------------------------------------------SSooooo--------oooo--------------------------------------------------------------------------------------------oSooS----------------------------------
---------------------------oooooo-------ooo------------------------------oooooSS-------------------------------------------------------------------------------------------oo-------------ooooooo-------
-------------------------kk-ggy-r---------------ooooooooo----------ooo------------------------oSo----------------------------ooooo------SSo---------------------ooooo-----gk-k-------------Y--g-R-------
XXXXXXXXXXX------------XXXXXXXXXXXXXXX----oo---------------------grk-----oooooooo--------y----------------------------------------------------------------------y----Y-G-XXXXXXXX---XXXXXXXXXXXXXX------
XXXXXXXXXXX-----ooo----XXXXXXXXXXXXXXX---k-----XXXXXXXXXXX------XXXXXXX-----K---k-XXXXXXXXX--oooooo-------------G-kr-XXXXXXX---oooo-----oooo-----ooo-XXX------XXXXXXXXXXXXXXXXXXX---XXXXXXXXXXXXXX--Ryg-
XXXXXXXXXXXXXXX---kk-g-XXXXXXXXXXXXXXXXXXXXXXXXXXXXXXXXXXX-Y----XXXXXXXXXXXXXXXXXXXXXXXXXXX---G--k-k-----------XXXXXXXXXXXXX---k-rKy----kg-------Ry--XXX------XXXXXXXXXXXXXXXXXXX---XXXXXXXXXXXXXXXXXXXX
XXXXXXXXXXXXXXXXXXXXXXXXXXXXXXXXXXXXXXXXXXXXXXXXXXXXXXXXXXXXXXXXXXXXXXXXXXXXXXXXXXXXXXXXXXXXXXXXXXXXXXXXXXXXXXXXXXXXXXXXXXXXXXXXXXXXXXXXXXXXXXXXXXXXXXXXXXXXXXXXXXXXXXXXXXXXXXXXXXXXXXXXXXXXXXXXXXXXXXXX

