--------------------------------------------------------------------------------------------------------------------------------------------------------------------------------------------------------
--------------------------------------------------------------------------------------------------------------------------------------------------------------------------------------------------------
--------------------------------------------------------------------------------------------------------------------------------------------------------------------------------------------------------
--------------------------------------------------------------------------------------------------------------------------------------------------------------------------------------------------------
--------------------------------------------------------------------------------------------------------------------------------------------------------------------------------------------------------
--------------------------------------------------------------------------------------------------------------------------------------------------------------------------------------------------------
--------------------------------------------------------------------------------------------------------------------------------------------------------------------------------------------------------
--------------------------------------------------------------------------------------------------------------------------------------------------------------------------------------------------------
--------------------------------------------------------------------------------------------------------------------------------------------------------------------------------------------------------
--------------------------------------------------------------------------------------------------------------------------------------------------------------------------------------------------------
--------------------------------------------------------------------------------------------------------------------------------------------------------------------------------------------------------
--------------------------------------------------------------------------------------------------------------------------------------------------------------------------------------------------------
------------------------------------------------------------Soo------------------------------------------ooooSoSo--------------------------------------------------------------------------Soooo--------
------------------------------------------------------------------------------------------oSSoSSo-------------------------------------------------------------oSoooS--------oooo------------------------
-------------------------------------------------------------oo--------------------------------------------oooo-----------------------------oSo-----oooSSSo---------------------------------ooooo-------
--------------------------------G--k------------------------g-----------------SSSoo--------oooo---------y---g-------------------g-k------------------------------ooo-----ooooo--------------gykr--------
XXXXXXXXXXXX------------------XXXXXXX---------------------XXXXXXX--------------------XXXX---kKk-g------XXXXXXXXXXX------------XXXXXX--------ooooo--ooooooooo--G-----R-Y----k------XXXXXXXXXXXXXXXXX-----
XXXXXXXXXXXXXXX-oooooo----XXXXXXXXXXX-oooo--ooooo---------XXXXXXX--------XXX--ooo----XXXXXXXXXXXXX-----XXXXXXXXXXX-----XXXXX--XXXXXXXXXX---K---k-------y-----XXXXXXXXXXXXXXXXXXXXXXXXXXXXXXXXXXXXXX-----
XXXXXXXXXXXXXXX--k-----XXXXXXXXXXXXXX-k------g--y---------XXXXXXX--XXXXXXXXX-ry-rKY--XXXXXXXXXXXXX-----XXXXXXXXXXXXXXXXXXXXX--XXXXXXXXXXXXXXXXXXXXXXXXXXXXXXXXXXXXXXXXXXXXXXXXXXXXXXXXXXXXXXXXXXXXX-----
XXXXXXXXXXXXXXXXXXXXXXXXXXXXXXXXXXXXXXXXXXXXXXXXXXXXXXXXXXXXXXXXXXXXXXXXXXXXXXXXXXXXXXXXXXXXXXXXXXXXXXXXXXXXXXXXXXXXXXXXXXXXXXXXXXXXXXXXXXXXXXXXXXXXXXXXXXXXXXXXXXXXXXXXXXXXXXXXXXXXXXXXXXXXXXXXXXXXXXXX

