--------------------------------------------------------------------------------------------------------------------------------------------------------------------------------------------------------
--------------------------------------------------------------------------------------------------------------------------------------------------------------------------------------------------------
--------------------------------------------------------------------------------------------------------------------------------------------------------------------------------------------------------
--------------------------------------------------------------------------------------------------------------------------------------------------------------------------------------------------------
--------------------------------------------------------------------------------------------------------------------------------------------------------------------------------------------------------
--------------------------------------------------------------------------------------------------------------------------------------------------------------------------------------------------------
--------------------------------------------------------------------------------------------------------------------------------------------------------------------------------------------------------
--------------------------------------------------------------------------------------------------------------------------------------------------------------------------------------------------------
--------------------------------------------------------------------------------------------------------------------------------------------------------------------------------------------------------
--------------------------------------------------------------------------------------------------------------------------------------------------------------------------------------------------------
--------------------------------------------------------------------------------------------------------------------------------------------------------------------------------------------------------
--------------------------------------------------------------------------------------------------------------------------------------------------------------------------------------------------------
------------------------------------------------------------------------------oSSoS-------ooS--------------------------Soooo------------------------------SSooS-----------------------------------------
---------------------------------------------------------------------------------------------------------ooooSo----------------------------------------------------ooooSo-------------------------------
----------------------------------------ooooo------ooooSo--------oooSo------ooooooo-------ooooo-----------------------oooo---------------oooo---oSSoooo-----oo----------------------------------oooo----
-------------*----------------------------------------------------------------G----k-------Y-r--------------oooooo---G---R--G----------------------------yk---rY------oooooo------ooooo---------y-------
XXXXXXXXXXXXXXXXXXX-----ooo--XXX-----------oo---------oo---XXXX--oooooo----XXXXXXXXXXX---XXXXXXXXXXX-----kk-r----r-XXXXXXXXXXX-----------oooo--ooooooo--XXXXXXXXXX--g-k-KG-----------------XXXXXXXXXXXX-
XXXXXXXXXXXXXXXXXXX------Y---XXX---------kK---------y----r-XXXX-g-y-y-rk---XXXXXXXXXXXXXXXXXXXXXXXXX----XXXXXXXXXXXXXXXXXXXXXX-----y--------R----KG-----XXXXXXXXXXXXXXXXXXXXXXXXX---ooooo--XXXXXXXXXXXX-
XXXXXXXXXXXXXXXXXXXXXXXXXXXXXXXXXXX----XXXXXXXXXXXXXXXXXXXXXXXXXXXXXXXXXX--XXXXXXXXXXXXXXXXXXXXXXXXXXXXXXXXXXXXXXXXXXXXXXXXXXXXXXXXXXXXXXXXXXXXXXXXXXXXXXXXXXXXXXXXXXXXXXXXXXXXXX-----kk---XXXXXXXXXXXX-
XXXXXXXXXXXXXXXXXXXXXXXXXXXXXXXXXXXXXXXXXXXXXXXXXXXXXXXXXXXXXXXXXXXXXXXXXXXXXXXXXXXXXXXXXXXXXXXXXXXXXXXXXXXXXXXXXXXXXXXXXXXXXXXXXXXXXXXXXXXXXXXXXXXXXXXXXXXXXXXXXXXXXXXXXXXXXXXXXXXXXXXXXXXXXXXXXXXXXXXX

