--------------------------------------------------------------------------------------------------------------------------------------------------------------------------------------------------------
--------------------------------------------------------------------------------------------------------------------------------------------------------------------------------------------------------
--------------------------------------------------------------------------------------------------------------------------------------------------------------------------------------------------------
--------------------------------------------------------------------------------------------------------------------------------------------------------------------------------------------------------
--------------------------------------------------------------------------------------------------------------------------------------------------------------------------------------------------------
--------------------------------------------------------------------------------------------------------------------------------------------------------------------------------------------------------
--------------------------------------------------------------------------------------------------------------------------------------------------------------------------------------------------------
--------------------------------------------------------------------------------------------------------------------------------------------------------------------------------------------------------
--------------------------------------------------------------------------------------------------------------------------------------------------------------------------------------------------------
--------------------------------------------------------------------------------------------------------------------------------------------------------------------------------------------------------
--------------------------------------------------------------------------------------------------------------------------------------------------------------------------------------------------------
--------------------------------------------------------------------------------------------------------------------------------------------------------------------------------------------------------
------------------oSSooS----------------------------------------------------SSS--------------------------------------------------------------------------------------------------------------oooSo------
---------------------------------------------------------------------------------------oooooSSo---------------------------------------------------------------------------------------------------------
------------------oooooooo------------------ooooS----oooooo-----ooooSoo----oooo-------------------------------------------------------------------------------------oooS---------------------oo---------
-------------------kyyg--r----------oSSo-------------k-Y-gy--------------r-G-g----------oooooo-------------------oSSoSoo-------------------oooSSoo--oooo----------------------------------Y-kggK--------
----------------XXXXXXXXXXX--XXX------------ooooo---XXXXXXXX------oooo--XXXXXXXXXXX----yy-R--g---XXXXX---oo-XXX----------------------k-g------------------------XX----oo--XXXXX----------XXXXXXXXXX-----
XXXXXXXXXXXXX---XXXXXXXXXXX--XXX-oooooo---kk-R-k----XXXXXXXXXXX---------XXXXXXXXXXX---XXXXXXXXXXXXXXXX-y----XXX-ooooooo-------------XXXXXX----oo-----ooooo-XXXXXXX--------XXXXX-----XXXXXXXXXXXXXXX-----
XXXXXXXXXXXXX---XXXXXXXXXXXXXXXX---------XXXXXXXXXXXXXXXXXXXXXXXXXXXXXXXXXXXXXXXXXXXXXXXXXXXXXXXXXXXXXXXXXXXXXX-y-rk------------XXXXXXXXXX--kkg--K---kg----XXXXXXXXXXXXXXXXXXXX-----XXXXXXXXXXXXXXX---XX
XXXXXXXXXXXXXXXXXXXXXXXXXXXXXXXXXXXXXXXXXXXXXXXXXXXXXXXXXXXXXXXXXXXXXXXXXXXXXXXXXXXXXXXXXXXXXXXXXXXXXXXXXXXXXXXXXXXXXXXXXXXXXXXXXXXXXXXXXXXXXXXXXXXXXXXXXXXXXXXXXXXXXXXXXXXXXXXXXXXXXXXXXXXXXXXXXXXXXXXX

