--------------------------------------------------------------------------------------------------------------------------------------------------------------------------------------------------------
--------------------------------------------------------------------------------------------------------------------------------------------------------------------------------------------------------
--------------------------------------------------------------------------------------------------------------------------------------------------------------------------------------------------------
--------------------------------------------------------------------------------------------------------------------------------------------------------------------------------------------------------
--------------------------------------------------------------------------------------------------------------------------------------------------------------------------------------------------------
--------------------------------------------------------------------------------------------------------------------------------------------------------------------------------------------------------
--------------------------------------------------------------------------------------------------------------------------------------------------------------------------------------------------------
--------------------------------------------------------------------------------------------------------------------------------------------------------------------------------------------------------
--------------------------------------------------------------------------------------------------------------------------------------------------------------------------------------------------------
--------------------------------------------------------------------------------------------------------------------------------------------------------------------------------------------------------
--------------------------------------------------------------------------------------------------------------------------------------------------------------------------------------------------------
--------------------------------------------------------------------------------------------------------------------------------------------------------------------------------------------------------
--------------------------------------------------------------------------------------------------------------------------------------------------------------------------------------------------------
----------------------------oooS---------ooo---------------------------ooo-------------------SSoo---------------------------oSoooSo----ooooo------------------------------------------------------------
-----------------------------------------------------oSo---------------------------------------------------------oSSoooo--------------------------------------------ooS------------oooo-----------------
------------------------------oo--------oooo---SSo---------Y-----------ooooo---------ooS-----ooo---------------------------oooooooo-----oooo------------------------------------------------------oo----
------------------K---------y--RR--------y----------------XXXXXX---------grgy-----------------G----XXXXX--oo-------ooo--------R----------Y-rk-----XXXXX------------ooooooo--------XXXXXXXXXXXXXX----g---
--------------XXXXXXXXXXXXXXXXXXXXXX--XXXXXXX--oo----k-yk-XXXXXX------XXXXXXXXXXXX--------XXXXXXXXXXXXXX--K-------y-r--R--XXXXXXXXXXXXXXXXXXXXXXXXXXXXX-oooooo----------kR--ooooo-XXXXXXXXXXXXXXXXXXXX--
XXXXXXXXXXXXXXXXXXXXXXXXXXXXXXXXXXXXXXXXXXXXX-------XXXXXXXXXXXX------XXXXXXXXXXXX-----Y--XXXXXXXXXXXXXXXXXXXXXXXXXXXXXXXXXXXXXXXXXXXXXXXXXXXXXXXXXXXXX-GRGR----XXXXXXXXXXX----y--XXXXXXXXXXXXXXXXXXXXXX
XXXXXXXXXXXXXXXXXXXXXXXXXXXXXXXXXXXXXXXXXXXXXXXXXXXXXXXXXXXXXXXXXXXXXXXXXXXXXXXXXXXXXXXXXXXXXXXXXXXXXXXXXXXXXXXXXXXXXXXXXXXXXXXXXXXXXXXXXXXXXXXXXXXXXXXXXXXXXXXXXXXXXXXXXXXXXXXXXXXXXXXXXXXXXXXXXXXXXXXX

