--------------------------------------------------------------------------------------------------------------------------------------------------------------------------------------------------------
--------------------------------------------------------------------------------------------------------------------------------------------------------------------------------------------------------
--------------------------------------------------------------------------------------------------------------------------------------------------------------------------------------------------------
--------------------------------------------------------------------------------------------------------------------------------------------------------------------------------------------------------
--------------------------------------------------------------------------------------------------------------------------------------------------------------------------------------------------------
--------------------------------------------------------------------------------------------------------------------------------------------------------------------------------------------------------
--------------------------------------------------------------------------------------------------------------------------------------------------------------------------------------------------------
--------------------------------------------------------------------------------------------------------------------------------------------------------------------------------------------------------
--------------------------------------------------------------------------------------------------------------------------------------------------------------------------------------------------------
--------------------------------------------------------------------------------------------------------------------------------------------------------------------------------------------------------
--------------------------------------------------------------------------------------------------------------------------------------------------------------------------------------------------------
--------------------------------------------------------------------------------------------------------------------------------------------------------------------------------------------------------
----------------------------------------------------------------------------------------------------------------oSoSo--------------------------------ooooSo--------------ooSoo--------------------------
--------------------------------oSo--------------------------------------------Sooo-----------------------------------------------oSSoS--------------------------------------------------------SSSoSS---
----------------------------------------------oSSoooo--oooooooo--------------------------------------------------ooo---------------------------------ooooooo-------------oooooo-------------------------
-------------------------------ooooooo----------------------------------------oooooooo---------oSooo--oooSoooo-----------------------oo------------K---rK-g------oSSo----R--k--------r--------ooooooo---
XXXXXXXXXXXXX-----------XXXXXX-----gg--XXXXXX---ooooo-----ooo------k-r---------Y-------------------------------XXXXXXXXXXX---ooo---k---y-k--------XXXXXXXXXXXXXX-------XXXXXXXXXXXXXXXXXXXXX-y-g---yk--X
XXXXXXXXXXXXX-----------XXXXXXXXXXXXXXXXXXXXX---K---r-------r---XXXXXXX------XXXXXXXXXXXXXXX---ooo-----ooooooo-XXXXXXXXXXX-kg----XXXXXXXXXX----XXXXXXXXXXXXXXXXX-oooo--XXXXXXXXXXXXXXXXXXXXXXXXXXXXXXXXX
XXXXXXXXXXXXXXXXXX--y---XXXXXXXXXXXXXXXXXXXXXXXXXXXXXXXXXXXXXXXXXXXXXXX-g----XXXXXXXXXXXXXXX--k--y----YR--ry-K-XXXXXXXXXXXXXXXXXXXXXXXXXXXX----XXXXXXXXXXXXXXXXX-----R-XXXXXXXXXXXXXXXXXXXXXXXXXXXXXXXXX
XXXXXXXXXXXXXXXXXXXXXXXXXXXXXXXXXXXXXXXXXXXXXXXXXXXXXXXXXXXXXXXXXXXXXXXXXXXXXXXXXXXXXXXXXXXXXXXXXXXXXXXXXXXXXXXXXXXXXXXXXXXXXXXXXXXXXXXXXXXXXXXXXXXXXXXXXXXXXXXXXXXXXXXXXXXXXXXXXXXXXXXXXXXXXXXXXXXXXXXX

