--------------------------------------------------------------------------------------------------------------------------------------------------------------------------------------------------------
--------------------------------------------------------------------------------------------------------------------------------------------------------------------------------------------------------
--------------------------------------------------------------------------------------------------------------------------------------------------------------------------------------------------------
--------------------------------------------------------------------------------------------------------------------------------------------------------------------------------------------------------
--------------------------------------------------------------------------------------------------------------------------------------------------------------------------------------------------------
--------------------------------------------------------------------------------------------------------------------------------------------------------------------------------------------------------
--------------------------------------------------------------------------------------------------------------------------------------------------------------------------------------------------------
--------------------------------------------------------------------------------------------------------------------------------------------------------------------------------------------------------
--------------------------------------------------------------------------------------------------------------------------------------------------------------------------------------------------------
--------------------------------------------------------------------------------------------------------------------------------------------------------------------------------------------------------
--------------------------------------------------------------------------------------------------------------------------------------------------------------------------------------------------------
--------------------------------------------------------------------------------------------------------------------------------------------------------------------------------------------------------
-----------------------------oSSoo---------------------------------------------------------------------------------------------------------------------------------------------------oSSo----oSoSS------
------------------------------------------------------------oooo---oooSooooo------------------------------SSo-------------------------------------------------------------------------------------------
----------------SoSoS--------oooo------------------------------------------------oo---------------ooooo---------ooSoSo-----oo-----oooooo---oo------------Sooo----------------ooo------oo------oooo------
-------------------------------Y---------------------------ooooo----oooooooo---------------------g-------ooo--------------r-y-------------r-------------------------ooo----y-y---------------k--y-K-----
------------------oooo-XXXXXXXXXXXX-------------XX------------y-y----k-k-----XXXXXXX----XXXXXXXXXXXXXXXX--G------oooooo--XXXXXXXXXXXXXXXXXXXXXXXX-------oooo--------------XXXXXXXXXXXXXXXXXXXXXXXXXXX---
-----------------------XXXXXXXXXXXXXXXXX--------XXXXXXXXXXXXXXXXXXXXXXXXXXXXXXXXXXXX----XXXXXXXXXXXXXXXXXXXXXX---ky-rr-r-XXXXXXXXXXXXXXXXXXXXXXXXXXXXX---y----------------XXXXXXXXXXXXXXXXXXXXXXXXXXX--X
--------------XXXXXXXXXXXXXXXXXXXXXXXXXX-----XXXXXXXXXXXXXXXXXXXXXXXXXXXXXXXXXXXXXXX----XXXXXXXXXXXXXXXXXXXXXXXXXXXXXXXXXXXXXXXXXXXXXXXXXXXXXXXXXXXXXXXXXXXXXXXXXX----y-r-XXXXXXXXXXXXXXXXXXXXXXXXXXX--X
XXXXXXXXXXXXXXXXXXXXXXXXXXXXXXXXXXXXXXXXXXXXXXXXXXXXXXXXXXXXXXXXXXXXXXXXXXXXXXXXXXXXXXXXXXXXXXXXXXXXXXXXXXXXXXXXXXXXXXXXXXXXXXXXXXXXXXXXXXXXXXXXXXXXXXXXXXXXXXXXXXXXXXXXXXXXXXXXXXXXXXXXXXXXXXXXXXXXXXXX

