--------------------------------------------------------------------------------------------------------------------------------------------------------------------------------------------------------
--------------------------------------------------------------------------------------------------------------------------------------------------------------------------------------------------------
--------------------------------------------------------------------------------------------------------------------------------------------------------------------------------------------------------
--------------------------------------------------------------------------------------------------------------------------------------------------------------------------------------------------------
--------------------------------------------------------------------------------------------------------------------------------------------------------------------------------------------------------
--------------------------------------------------------------------------------------------------------------------------------------------------------------------------------------------------------
--------------------------------------------------------------------------------------------------------------------------------------------------------------------------------------------------------
--------------------------------------------------------------------------------------------------------------------------------------------------------------------------------------------------------
--------------------------------------------------------------------------------------------------------------------------------------------------------------------------------------------------------
--------------------------------------------------------------------------------------------------------------------------------------------------------------------------------------------------------
--------------------------------------------------------------------------------------------------------------------------------------------------------------------------------------------------------
--------------------------------------------------------------------------------------------------------------------------------------------------------------------------------------------------------
----------------------------------------------------------------------------------------------------------------------ooooS--------------------------------------SSoS-----------------------------------
--------------------------------ooo--------------------------------------------------------------oooo----------oooSo--------------------------------------------------------------------SooS------------
----------------------ooSoo------------------oo----------------------------ooSSS------------------------ooooo----------ooo-------------------------SoSSo---------oooo----------------------------ooooo--
-------------------------------oooo---------k-----------------------------------------------------------K--------oo----g----r------------------------------ooo------------ooo----oooo-----oooo----------
----------------------oooo-----Y-gkR------XXXXXXX--------------------XXXXX---ooooo---------------K-r-y-XXXXXXX-----r-XXXXXXXXX------------XXXXX---oooo---------XXXXXXXXX----------------y----G--XXXXXXXX
XXXXXXXXXXXXX-----XXX---y----XXXXXXXXXXXXXXXXXXXX---------oooo--XXXXXXXXXX-----------oo--------XXXXXXXXXXXXXXXXXXXXXXXXXXXXXXXXXXX---y--XXXXXXX-yy-kr--g-------XXXXXXXXX---------oo---XXXXXXXXXXXXXXXXXX
XXXXXXXXXXXXXXX---XXXXXXXXXXXXXXXXXXXXXXXXXXXXXXXXXXXXXXX---G---XXXXXXXXXXXXXXXXXXXX-----K-----XXXXXXXXXXXXXXXXXXXXXXXXXXXXXXXXXXXXXXXXXXXXXXXXXXXXXXXXXX-k----XXXXXXXXX-k-y---r-G----XXXXXXXXXXXXXXXXXX
XXXXXXXXXXXXXXXXXXXXXXXXXXXXXXXXXXXXXXXXXXXXXXXXXXXXXXXXXXXXXXXXXXXXXXXXXXXXXXXXXXXXXXXXXXXXXXXXXXXXXXXXXXXXXXXXXXXXXXXXXXXXXXXXXXXXXXXXXXXXXXXXXXXXXXXXXXXXXXXXXXXXXXXXXXXXXXXXXXXXXXXXXXXXXXXXXXXXXXXX

