--------------------------------------------------------------------------------------------------------------------------------------------------------------------------------------------------------
--------------------------------------------------------------------------------------------------------------------------------------------------------------------------------------------------------
--------------------------------------------------------------------------------------------------------------------------------------------------------------------------------------------------------
--------------------------------------------------------------------------------------------------------------------------------------------------------------------------------------------------------
--------------------------------------------------------------------------------------------------------------------------------------------------------------------------------------------------------
--------------------------------------------------------------------------------------------------------------------------------------------------------------------------------------------------------
--------------------------------------------------------------------------------------------------------------------------------------------------------------------------------------------------------
--------------------------------------------------------------------------------------------------------------------------------------------------------------------------------------------------------
--------------------------------------------------------------------------------------------------------------------------------------------------------------------------------------------------------
--------------------------------------------------------------------------------------------------------------------------------------------------------------------------------------------------------
--------------------------------------------------------------------------------------------------------------------------------------------------------------------------------------------------------
--------------------------------------------------------------------------------------------------------------------------------------------------------------------------------------------------------
-----------------------------------oSSo--------------------------------------------------------------------------------------------------------------------------oSoSSooo---ooSSoo----------------------
------------------------ooooooooo-----------ooo----------------------SooooS-----------------------------------------------------------------------------------------------------------------------------
------------------------------------oooo--------------------ooooo--------------------------------------------------Soo-----oSSooo---oooo----------------------------oooo----oooooooo----oo--------------
--------------ooooSoo------oooo-----Kk--------------------------------oooo----ooSo---------------------ooooo-------------------------------ooSS------------------r-Ky-------g---rKkg--yK----------------
------------------------r---------XXXXXXX-y---rG----------oooooo--------k----------------XXXX-ooooo----y-----K---oooo-------oo-------oo-----------------XX------XXXXXXXXXXXXXXXXXXXXXXXXXXX-------------
XXXXXXXXXXXXX---ooooo--XXXXXXXXXXXXXXXXXXXXXXXXXXX-oooo-----------XXXXXXXXXXX------------XXXX--kY---k-XXXXXXXXX------r---y--y------r---------ooooo-XXX--XX----g-XXXXXXXXXXXXXXXXXXXXXXXXXXX-------ooo--X
XXXXXXXXXXXXX--y-yG-kg-XXXXXXXXXXXXXXXXXXXXXXXXXXX--g---XXXXXXXXXXXXXXXXXXXXX-kKR---XXXXXXXXXXXXXXXXXXXXXXXXXXXXXXXXXXXXXXXXXXXXXXXXXXXXXX---------XXXXXXXXXXXXXXXXXXXXXXXXXXXXXXXXXXXXXXXX-----Y------X
XXXXXXXXXXXXXXXXXXXXXXXXXXXXXXXXXXXXXXXXXXXXXXXXXXXXXXXXXXXXXXXXXXXXXXXXXXXXXXXXXXXXXXXXXXXXXXXXXXXXXXXXXXXXXXXXXXXXXXXXXXXXXXXXXXXXXXXXXXXXXXXXXXXXXXXXXXXXXXXXXXXXXXXXXXXXXXXXXXXXXXXXXXXXXXXXXXXXXXXX

