--------------------------------------------------------------------------------------------------------------------------------------------------------------------------------------------------------
--------------------------------------------------------------------------------------------------------------------------------------------------------------------------------------------------------
--------------------------------------------------------------------------------------------------------------------------------------------------------------------------------------------------------
--------------------------------------------------------------------------------------------------------------------------------------------------------------------------------------------------------
--------------------------------------------------------------------------------------------------------------------------------------------------------------------------------------------------------
--------------------------------------------------------------------------------------------------------------------------------------------------------------------------------------------------------
--------------------------------------------------------------------------------------------------------------------------------------------------------------------------------------------------------
--------------------------------------------------------------------------------------------------------------------------------------------------------------------------------------------------------
--------------------------------------------------------------------------------------------------------------------------------------------------------------------------------------------------------
--------------------------------------------------------------------------------------------------------------------------------------------------------------------------------------------------------
--------------------------------------------------------------------------------------------------------------------------------------------------------------------------------------------------------
--------------------------------------------------------------------------------------------------------------------------------------------------------------------------------------------------------
---------------------------------------------SSoo------------------SSo----------------------------------------------------------------------------oSooSo------------------------------------------------
----------------SSoo-----------------------------------------------------------------------------------------------------------------------------------------------------ooS----------------------------
------------------------------oooo----------ooooo-------oooSo----ooooo-----ooooS-----------oo-------------------------------------------------------oooo-------------------------------------------oooo-
----------------ooooo------------------------g-y------------------kk--R--------------------R------------------ooo----------------oooS----oSSooo-----gg-r---------------ooooo-----ooSooooo------------R--
XXXXXXXXXXXXX-y--k---------oooooo----k---y-XXXXXXXX-----------XXXXXXXXXXXX--oooo--------XXXXXX---------------------------------------------------XXXXXXXX-------------------y-------------------XXXXXXXX
XXXXXXXXXXXXXXXXXXXXXXXXXX----K----XXXXXXXXXXXXXXXX-----G-k---XXXXXXXXXXXX-K----y-----XXXXXXXX------------XXXXXXXX----oooo-----oooooo---oooooooo-XXXXXXXXXXXX---------XXXXXXXXXX--oooooooo-XXXXXXXXXXXXX
XXXXXXXXXXXXXXXXXXXXXXXXXXXXXXXXXXXXXXXXXXXXXXXXXXXXXXXXXXXXXXXXXXXXXXXXXXXXXXXXXX----XXXXXXXX---Gy-------XXXXXXXX--g-------XX-------y---k---r---XXXXXXXXXXXXXXXXXX---XXXXXXXXXX--r-Yy-----XXXXXXXXXXXXX
XXXXXXXXXXXXXXXXXXXXXXXXXXXXXXXXXXXXXXXXXXXXXXXXXXXXXXXXXXXXXXXXXXXXXXXXXXXXXXXXXXXXXXXXXXXXXXXXXXXXXXXXXXXXXXXXXXXXXXXXXXXXXXXXXXXXXXXXXXXXXXXXXXXXXXXXXXXXXXXXXXXXXXXXXXXXXXXXXXXXXXXXXXXXXXXXXXXXXXXX

