--------------------------------------------------------------------------------------------------------------------------------------------------------------------------------------------------------
--------------------------------------------------------------------------------------------------------------------------------------------------------------------------------------------------------
--------------------------------------------------------------------------------------------------------------------------------------------------------------------------------------------------------
--------------------------------------------------------------------------------------------------------------------------------------------------------------------------------------------------------
--------------------------------------------------------------------------------------------------------------------------------------------------------------------------------------------------------
--------------------------------------------------------------------------------------------------------------------------------------------------------------------------------------------------------
--------------------------------------------------------------------------------------------------------------------------------------------------------------------------------------------------------
--------------------------------------------------------------------------------------------------------------------------------------------------------------------------------------------------------
--------------------------------------------------------------------------------------------------------------------------------------------------------------------------------------------------------
--------------------------------------------------------------------------------------------------------------------------------------------------------------------------------------------------------
--------------------------------------------------------------------------------------------------------------------------------------------------------------------------------------------------------
----------------------------------------------------------------%%%%%%%---------------------------------------------------------------------------------------------------------------------------------
----------------------------------------------------------------|||||||---------------------------------------------------------ooSoooo----------------------------ooo----------------------------------
---------------------------ooooooo----------------------SoS-----||||||%%%%%-----------------------------------ooSooo------------------------------------------------------------------------------------
-------------ooo------------------------------------------------|||||||||||--------------ooooo-------------------------------------ooo----------------------------ooo-----------------SoooS-------------
--------------------SooS-----oooooo-----oSSS----oo------ooo-----|||||||||||-----------------------------oo-----oooooo-------------------------------------------------------------------------ooSooSoo--
--------------oo-----------g-----------------------------g------|||||||||||-------oooo---ooo----XXXXX--------------------------XXXXXXXXXXXXXXXXXXXXXX----------XXXXXXXXXX-------------oooooo------------
-------------------ooo----XXXXXXXXXXX----oo---XXXXXXXXXXXXXXXXXXXXXXXXXXXXXXXXX------g----------XXXXXXXXXXXXXXXXXXXXXX---------XXXXXXXXXXXXXXXXXXXXXXXX--------XXXXXXXXXX----XXXXXX-g------------ooooo-X
XXXXXXXXXXXXXXXXXX--------XXXXXXXXXXX--g------XXXXXXXXXXXXXXXXXXXXXXXXXXXXXXXXXXXXXXXXXXXXXXXXXXXXXXXXXXXXXXXXXXXXXXXXXXX------XXXXXXXXXXXXXXXXXXXXXXXXXX------XXXXXXXXXXXXXXXXXXXXXXXXXXXXXX----------X
XXXXXXXXXXXXXXXXXXXXXXXXXXXXXXXXXXXXXXXXXXXXXXXXXXXXXXXXXXXXXXXXXXXXXXXXXXXXXXXXXXXXXXXXXXXXXXXXXXXXXXXXXXXXXXXXXXXXXXXXXXXXXXXXXXXXXXXXXXXXXXXXXXXXXXXXXXXXXXXXXXXXXXXXXXXXXXXXXXXXXXXXXXXXXXXXXXXXXXXX

