--------------------------------------------------------------------------------------------------------------------------------------------------------------------------------------------------------
--------------------------------------------------------------------------------------------------------------------------------------------------------------------------------------------------------
--------------------------------------------------------------------------------------------------------------------------------------------------------------------------------------------------------
--------------------------------------------------------------------------------------------------------------------------------------------------------------------------------------------------------
--------------------------------------------------------------------------------------------------------------------------------------------------------------------------------------------------------
--------------------------------------------------------------------------------------------------------------------------------------------------------------------------------------------------------
--------------------------------------------------------------------------------------------------------------------------------------------------------------------------------------------------------
--------------------------------------------------------------------------------------------------------------------------------------------------------------------------------------------------------
--------------------------------------------------------------------------------------------------------------------------------------------------------------------------------------------------------
--------------------------------------------------------------------------------------------------------------------------------------------------------------------------------------------------------
--------------------------------------------------------------------------------------------------------------------------------------------------------------------------------------------------------
--------------------------------------------------------------------------------------------------------------------------------------------------------------------------------------------------------
---------------Soo------------------------------------------------------------------------------------------------------------------------------------------------ooSoSo-----------------------oSooo----
------------------------------------ooo------------------------------------------------------------------oSooSo--ooSooooSo--------------oSooo----------------------------------oSoooo-------------------
-----------------ooo--------------------------------ooo------oSoS-------ooooSo------------oo----------------------------------------------------------------------ooooo--------------------------oo-----
----------------------------------ooo-----ooooo--------------------------------------------------------ooooooo----oooooo----------------oooo-------------oSo-------------------ooooo--------------------
XXXXXXXXXXXXXXXXXXXXXXXXXXXX------------------------oo--------oo-----XX-oooooo-----------XXXXXX----------------------------------------------------oooo---------XXXXXXXXXXX-------------------XXXXXXXXXX
XXXXXXXXXXXXXXXXXXXXXXXXXXXXXXXXXXXXXXXXX-ooooooo------------------XXXX--------g--XXXXXXXXXXXXX------XXXXXXXXXXXXXXXXXXXXXX-------ooo--XXXXXXXXXXX--------------XXXXXXXXXXXXXXXXXXXXXX--------XXXXXXXXXX
XXXXXXXXXXXXXXXXXXXXXXXXXXXXXXXXXXXXXXXXX----------XXXXXXXXXXXXXXXXXXXXXXXXXXXXXXXXXXXXXXXXXXXX------XXXXXXXXXXXXXXXXXXXXXXXXXXXX------XXXXXXXXXXXXXXXXX--------XXXXXXXXXXXXXXXXXXXXXX--------XXXXXXXXXX
XXXXXXXXXXXXXXXXXXXXXXXXXXXXXXXXXXXXXXXXXXXXXXXXXXXXXXXXXXXXXXXXXXXXXXXXXXXXXXXXXXXXXXXXXXXXXXXXXXXXXXXXXXXXXXXXXXXXXXXXXXXXXXXXXXXXXXXXXXXXXXXXXXXXXXXXXXXXXXXXXXXXXXXXXXXXXXXXXXXXXXXXXXXXXXXXXXXXXXXX

