--------------------------------------------------------------------------------------------------------------------------------------------------------------------------------------------------------
--------------------------------------------------------------------------------------------------------------------------------------------------------------------------------------------------------
--------------------------------------------------------------------------------------------------------------------------------------------------------------------------------------------------------
--------------------------------------------------------------------------------------------------------------------------------------------------------------------------------------------------------
--------------------------------------------------------------------------------------------------------------------------------------------------------------------------------------------------------
--------------------------------------------------------------------------------------------------------------------------------------------------------------------------------------------------------
--------------------------------------------------------------------------------------------------------------------------------------------------------------------------------------------------------
--------------------------------------------------------------------------------------------------------------------------------------------------------------------------------------------------------
--------------------------------------------------------------------------------------------------------------------------------------------------------------------------------------------------------
--------------------------------------------------------------------------------------------------------------------------------------------------------------------------------------------------------
--------------------------------------------------------------------------------------------------------------------------------------------------------------------------------------------------------
--------------------------------------------------------------------------------------------------------------------------------------------------------------------------------------------------------
-----------------------%%%%------------------------------------------------------------------------------------------------------------oSSoo------------------------------------------------------------
-----------------------||||-------------------SSS--------------------ooSooooSo---------------------------------------------------------------------------------SSoS------oooSo------tt----tt------------
-----------------------|%%%%%%%------Soo-------------oooooo---------------------------------oooooooo-----------------------oo--------ooooo------------------------------------------tt----tt------------
-----------------------||||g|||---------------ooo--------------oooo--oooooo----------oooSo-----------------------%%%---------------------------oSooSooSo-------ooooo-----ooooooo----tt----tt------------
--------------XXXXXXXXXXXXXXXXXXX----ooo------------XXXXXXXX-------------------------------XXXXXXXXXX------------|||----XXXXXXXXXXXXXXXXXXXXXX------------------------------------XXXXXXXXXXX-----------
--------------XXXXXXXXXXXXXXXXXXX--------XXXXXXXXXXXXXXXXXXXXXXXXXXXXXXXXXXXXXX------ooo---XXXXXXXXXX-oooo-XXXXXXXXXXXXXXXXXXXXXXXXXXXXXXXXXXX---ooooo-------XXXXXXXXXXXXXXXXXXXXXXXXXXXXXXXX-----------
--------------XXXXXXXXXXXXXXXXXXXXXXXXXXXXXXXXXXXXXXXXXXXXXXXXXXXXXXXXXXXXXXXXXXXXXX-------XXXXXXXXXX------XXXXXXXXXXXXXXXXXXXXXXXXXXXXXXXXXXX-----------XXXXXXXXXXXXXXXXXXXXXXXXXXXXXXXXXXXXXXXXXXXXXXX
XXXXXXXXXXXXXXXXXXXXXXXXXXXXXXXXXXXXXXXXXXXXXXXXXXXXXXXXXXXXXXXXXXXXXXXXXXXXXXXXXXXXXXXXXXXXXXXXXXXXXXXXXXXXXXXXXXXXXXXXXXXXXXXXXXXXXXXXXXXXXXXXXXXXXXXXXXXXXXXXXXXXXXXXXXXXXXXXXXXXXXXXXXXXXXXXXXXXXXXX

