--------------------------------------------------------------------------------------------------------------------------------------------------------------------------------------------------------
--------------------------------------------------------------------------------------------------------------------------------------------------------------------------------------------------------
--------------------------------------------------------------------------------------------------------------------------------------------------------------------------------------------------------
--------------------------------------------------------------------------------------------------------------------------------------------------------------------------------------------------------
--------------------------------------------------------------------------------------------------------------------------------------------------------------------------------------------------------
--------------------------------------------------------------------------------------------------------------------------------------------------------------------------------------------------------
--------------------------------------------------------------------------------------------------------------------------------------------------------------------------------------------------------
--------------------------------------------------------------------------------------------------------------------------------------------------------------------------------------------------------
--------------------------------------------------------------------------------------------------------------------------------------------------------------------------------------------------------
--------------------------------------------------------------------------------------------------------------------------------------------------------------------------------------------------------
--------------------------------------------------------------------------------------------------------------------------------------------------------------------------------------------------------
--------------------------------------------------------------------------------------------------------------------------------------------------------------------------------------------------------
-----------------------------------------------------------------------------------------------------------------------------------------------------------------oSoSS----------------------------------
----------------------g-g------------------------------------ooSo---------------------------------------------------------------------------------------------------------------------------------------
---------------------%%%%%--------------------------------------------------------------------------------ooo-----oooS----------------SSSoo----------ooooo-------ooooooo----SoSooo---------------ooSooo-
-----------------g---|||||---------------------ooo---------oooooooo-------oSSo----------------------ooo------------------------------------------------------------g----------------------SSS-----------
----------------XXXXXXXXXXXXXXXX---------------------------------g--XXXXX----------ooooo--XXXXXXX--------oooo-------ooo--------XXXXX--ooooooo-----XXXXXXXXXXX---XXXXXXXXX---oooo----------------oooooo--
----------------XXXXXXXXXXXXXXXX------ooo-----ooooo-------XXXXXXXXXXXXXXX----oo-----------XXXXXXXXXXXXXX------------------XXXXXXXXXX--------------XXXXXXXXXXXXXXXXXXXXXXX-----------XXXX----------------
XXXXXXXXXXXXXXXXXXXXXXXXXXXXXXXXXX---------------g--------XXXXXXXXXXXXXXX--------XXXXXXXXXXXXXXXXXXXXXXXXXXXXXXXXXXXXXXXXXXXXXXXXXXXXXXXXXXXXXXXXXXXXXXXXXXXXXXXXXXXXXXXXXXXXXXXXXXXXXXX-------XXXXXXXXX
XXXXXXXXXXXXXXXXXXXXXXXXXXXXXXXXXXXXXXXXXXXXXXXXXXXXXXXXXXXXXXXXXXXXXXXXXXXXXXXXXXXXXXXXXXXXXXXXXXXXXXXXXXXXXXXXXXXXXXXXXXXXXXXXXXXXXXXXXXXXXXXXXXXXXXXXXXXXXXXXXXXXXXXXXXXXXXXXXXXXXXXXXXXXXXXXXXXXXXXX

