--------------------------------------------------------------------------------------------------------------------------------------------------------------------------------------------------------
--------------------------------------------------------------------------------------------------------------------------------------------------------------------------------------------------------
--------------------------------------------------------------------------------------------------------------------------------------------------------------------------------------------------------
--------------------------------------------------------------------------------------------------------------------------------------------------------------------------------------------------------
--------------------------------------------------------------------------------------------------------------------------------------------------------------------------------------------------------
--------------------------------------------------------------------------------------------------------------------------------------------------------------------------------------------------------
--------------------------------------------------------------------------------------------------------------------------------------------------------------------------------------------------------
--------------------------------------------------------------------------------------------------------------------------------------------------------------------------------------------------------
--------------------------------------------------------------------------------------------------------------------------------------------------------------------------------------------------------
--------------------------------------------------------------------------------------------------------------------------------------------------------------------------------------------------------
--------------------------------------------------------------------------------------------------------------------------------------------------------------------------------------------------------
--------------------------------------------------------------------------------------------------------------------------------------------------------------------------------------------------------
--------------------ooo--------------------------------------------------------------------------------------oooSo-----------------ooo-----oooooo-------------------------------------------------------
------------------------------ooS------oooS--------ooooS----------------------------oooooSSS------------------------------------------------------------------------------------------------------------
-----------oSoS-------------------------------------------------------SoS-----------------------------------oooo---------oSSooS------------oooooo-------------------------------oooo--------------------
-------------------------------ooo------oooo----------oo----ooooo--------------------oooooo-----ooo--------------------------------------------------------ooooooSoo----------------------------oooo----
--------------oo---XXXXXXXX------------------------------------------oooo----------------------------------XXXXXXXXX-------ooooo-XXXXXXXXXXXXXXXXX----------------------------ooooooo-------------------
-------------------XXXXXXXXXXXXXXXXXXXXXXXXXX-----XXXXXXXXX-oo---------------------XXXXXXXXXXX----------oo-XXXXXXXXX-------------XXXXXXXXXXXXXXXXX-----------ooooooo-----------------------------oo-----
XXXXXXXXXXXXXXXXXXXXXXXXXXXXXXXXXXXXXXXXXXXXX-----XXXXXXXXX-------XXXXXXXXXXXXXXXXXXXXXXXXXXXX-g-----------XXXXXXXXXXXXXXXXXXXXXXXXXXXXXXXXXXXXXXX-------------------XXXX----XXXXXXXXXXX-------------XXX
XXXXXXXXXXXXXXXXXXXXXXXXXXXXXXXXXXXXXXXXXXXXXXXXXXXXXXXXXXXXXXXXXXXXXXXXXXXXXXXXXXXXXXXXXXXXXXXXXXXXXXXXXXXXXXXXXXXXXXXXXXXXXXXXXXXXXXXXXXXXXXXXXXXXXXXXXXXXXXXXXXXXXXXXXXXXXXXXXXXXXXXXXXXXXXXXXXXXXXXX

