--------------------------------------------------------------------------------------------------------------------------------------------------------------------------------------------------------
--------------------------------------------------------------------------------------------------------------------------------------------------------------------------------------------------------
--------------------------------------------------------------------------------------------------------------------------------------------------------------------------------------------------------
--------------------------------------------------------------------------------------------------------------------------------------------------------------------------------------------------------
--------------------------------------------------------------------------------------------------------------------------------------------------------------------------------------------------------
--------------------------------------------------------------------------------------------------------------------------------------------------------------------------------------------------------
--------------------------------------------------------------------------------------------------------------------------------------------------------------------------------------------------------
--------------------------------------------------------------------------------------------------------------------------------------------------------------------------------------------------------
--------------------------------------------------------------------------------------------------------------------------------------------------------------------------------------------------------
---------------------------------------------------------oooooo-----------------------------------------------------------------------------------------------------------------------------------------
--------------------------------------------------------------------------------------------------------------------------------------------------------------------------------------------------------
-----------------------------------------------------------oo-------------------------------------------------------------------------------------------------------------------------------------------
-----------------ooo---------------oooS-----------------------------------------------------------------------------------------------------------------------------------------------------------------
---------------------------------------------------------%%%%%%--------------oSoo--------------------------------------------------------------ooSoSSo-----------------------------------Soo------------
----------------oooooo---ooooo------oooo-------oooooo----||||||-----------------------------------------------------------------ooSoo------------------------------ooSoSo-------------------------------
--------------g-g-----------------------------------g----||||||----------------------------------oSo-------------ooo---------------------------ooooo-----------------------------oSSo----ooo------------
-------------XXXXXXXXXXXXXXXXXXXXXXXXXXXXXXXXXXXXXXXXXX--||||||--g------XXXX---------------------------------------------------ooooooo---XXX-----------XXXXXXXXXX----oooo--XXXX----------g------oooo----
-----------XXXXXXXXXXXXXXXXXXXXXXXXXXXXXXXXXXXXXXXXXXXXXXXXXXXXXXXXXXXXXXXXXXXXXXX--ooo-----------------XXXXXXXXXXXXXXX------------------XXXXXXXXXXXXXXXXXXXXXXXX----------XXXX--oooo-XXXXXXXX--------XX
-----------XXXXXXXXXXXXXXXXXXXXXXXXXXXXXXXXXXXXXXXXXXXXXXXXXXXXXXXXXXXXXXXXXXXXXXX-------XXX-------g----XXXXXXXXXXXXXXX-------XXXXXXXXXXXXXXXXXXXXXXXXXXXXXXXXXXXXXXXXXXXXXXXXX-------XXXXXXXXXXXXXXXXXX
XXXXXXXXXXXXXXXXXXXXXXXXXXXXXXXXXXXXXXXXXXXXXXXXXXXXXXXXXXXXXXXXXXXXXXXXXXXXXXXXXXXXXXXXXXXXXXXXXXXXXXXXXXXXXXXXXXXXXXXXXXXXXXXXXXXXXXXXXXXXXXXXXXXXXXXXXXXXXXXXXXXXXXXXXXXXXXXXXXXXXXXXXXXXXXXXXXXXXXXX

