--------------------------------------------------------------------------------------------------------------------------------------------------------------------------------------------------------
--------------------------------------------------------------------------------------------------------------------------------------------------------------------------------------------------------
--------------------------------------------------------------------------------------------------------------------------------------------------------------------------------------------------------
--------------------------------------------------------------------------------------------------------------------------------------------------------------------------------------------------------
--------------------------------------------------------------------------------------------------------------------------------------------------------------------------------------------------------
--------------------------------------------------------------------------------------------------------------------------------------------------------------------------------------------------------
--------------------------------------------------------------------------------------------------------------------------------------------------------------------------------------------------------
--------------------------------------------------------------------------------------------------------------------------------------------------------------------------------------------------------
--------------------------------------------------------------------------------------------------------------------------------------------------------------------------------------------------------
--------------------------------------------------------------------------------------------------------------------------------------------------------------------------------------------------------
--------------------------------------------------------------------------------------------------------------------------------------------------------------------------------------------------------
--------------------------------------------------------------------------------------------------------------------------------------------------------------------------------------------------------
------------------------------------------------------------------------------------------------------------oSoSoSoo---------------------------------------------ooo------------------------------------
-------------oSSSS-----ooooo------------------------------------------------------ooSSoS------------------------------------------------oooo------------------------------------------------------------
---------------------------------------oooooo------oooo--------------------------------------------------------oooooo-----------------------------ooSSSo--------oo--------------------------------------
-------------oooo--------ooo-------------------------g-----SooSoo--oSo-------------ooooooo------------------------------------------------ooo-----------------------------------------------------------
------------------------------------XX--ooooooo-XXXXXXXXX-------------------------------------XXXXXX---oo--XXXXXXXXXXX--ooooo----------------------oooo--XXXXXXXXXXXXXXXXXXX--------------oo---XX-------
-----------XXXXXXXXXXXXXXXXXXX------XX----------XXXXXXXXX--ooooo---ooo--------XXXXXXXXXXXXXXXXXXXXXX-------XXXXXXXXXXX---------ooooo--XXXXXXXXXX---------XXXXXXXXXXXXXXXXXXX-------------------XX-------
XXXXXXXXXXXXXXXXXXXXXXXXXXXXXX--XXXXXXXXXXXXXXXXXXXXXXXXX----------------XXXXXXXXXXXXXXXXXXXXXXXXXXXXXXXXXXXXXXXXXXXXXXXXXXXXX--------XXXXXXXXXXXXXXXXXXXXXXXXXXXXXXXXXXXXXX-----------XXXXXXXXXX--XXXXX
XXXXXXXXXXXXXXXXXXXXXXXXXXXXXXXXXXXXXXXXXXXXXXXXXXXXXXXXXXXXXXXXXXXXXXXXXXXXXXXXXXXXXXXXXXXXXXXXXXXXXXXXXXXXXXXXXXXXXXXXXXXXXXXXXXXXXXXXXXXXXXXXXXXXXXXXXXXXXXXXXXXXXXXXXXXXXXXXXXXXXXXXXXXXXXXXXXXXXXXX

