--------------------------------------------------------------------------------------------------------------------------------------------------------------------------------------------------------
--------------------------------------------------------------------------------------------------------------------------------------------------------------------------------------------------------
--------------------------------------------------------------------------------------------------------------------------------------------------------------------------------------------------------
--------------------------------------------------------------------------------------------------------------------------------------------------------------------------------------------------------
--------------------------------------------------------------------------------------------------------------------------------------------------------------------------------------------------------
--------------------------------------------------------------------------------------------------------------------------------------------------------------------------------------------------------
--------------------------------------------------------------------------------------------------------------------------------------------------------------------------------------------------------
--------------------------------------------------------------------------------------------------------------------------------------------------------------------------------------------------------
--------------------------------------------------------------------------------------------------------------------------------------------------------------------------------------------------------
--------------------------------------------------------------------------------------------------------------------------------------------------------------------------------------------------------
--------------------------------------------------------------------------------------------------------------------------------------------------------------------------------------------------------
--------------------------------------------------------------------------------------------------------------------------------------------------------------------------------------------------------
-----------------------------------------------------------------------------oSSooS-----------------------ooSooo--------------------------------oSoo----------------------------------------------------
---------------------------------------------------------------ooSoooo------------------------------------------------Soooo-----------SooSoo------------------------------------------------------------
--------------------------------------------------------oooo-----------------oooooo---ooS----------ooSo-----oooo----------------------------------------------------SSo---------------------------------
---------------------------------------------------------------oooooo-------------------------------------------------oooo--------------oooo-------------------------------------ooooo------------------
-------------------------------------XXXX------------------------g-------XXXXXXXXXXXX--oo----------ooooo-XXXXXXXXXX-----------XXX------------XXXXXXXX---------------ooo----------------XXXX-------------
-------------g----------------oo-----XXXXXXXXXXX--------------XXXXXXXXXXXXXXXXXXXXXXX-------XXXX---------XXXXXXXXXXXXXXXXXXXXXXXX---XXXXXXXXXXXXXXXXXXXX--ooooo----------------XXXXXXXXXXXX---XXXX------
XXXXXXXXXXXXXXXX----XXXXXXX-------XXXXXXXXXXXXXXXXXXXXXXXXXXXXXXXXXXXXXXXXXXXXXXXXXXXXXXXXXXXXXXXXXXXXXXXXXXXXXXXXXXXXXXXXXXXXXXXXXXXXXXXXXXXXXXXXXXXXXX--------XXXXXXXXXXXXXXXXXXXXXXXXXXXXXXXXXX-g----
XXXXXXXXXXXXXXXXXXXXXXXXXXXXXXXXXXXXXXXXXXXXXXXXXXXXXXXXXXXXXXXXXXXXXXXXXXXXXXXXXXXXXXXXXXXXXXXXXXXXXXXXXXXXXXXXXXXXXXXXXXXXXXXXXXXXXXXXXXXXXXXXXXXXXXXXXXXXXXXXXXXXXXXXXXXXXXXXXXXXXXXXXXXXXXXXXXXXXXXX

