--------------------------------------------------------------------------------------------------------------------------------------------------------------------------------------------------------
--------------------------------------------------------------------------------------------------------------------------------------------------------------------------------------------------------
--------------------------------------------------------------------------------------------------------------------------------------------------------------------------------------------------------
--------------------------------------------------------------------------------------------------------------------------------------------------------------------------------------------------------
--------------------------------------------------------------------------------------------------------------------------------------------------------------------------------------------------------
--------------------------------------------------------------------------------------------------------------------------------------------------------------------------------------------------------
--------------------------------------------------------------------------------------------------------------------------------------------------------------------------------------------------------
--------------------------------------------------------------------------------------------------------------------------------------------------------------------------------------------------------
--------------------------------------------------------------------------------------------------------------------------------------------------------------------------------------------------------
--------------------------------------------------------------------------------------------------------------------------------------------------------------------------------------------------------
--------------------------------------------------------------------------------------------------------------------------------------------------------------------------------------------------------
--------------------------------------------------------------------------------------------------------------------------------------------------------------------------------------------------------
------------------------------------------------------------------------------------------------------------ooooo--------------------------------------------------SoS--------------------------ooo-----
------------------------------------------------------------------------------------------------oooooS-------------------------------------ooooS--------------------------------------------------------
-------------ooooo--------------------oSo------ooo----------------SSoo------------------Soo-------------------oo------------------------------------ooSoooo-------oooo------------------------ooooo-----
--------------------------------------------------------------------------------oSo--------------ooooooo---------g----oooooSo---------------------------------------------------------Sooo--------------
XXXXXXXXXXX-ooo----------------ooo---oooooo--XXXXXX--oo-----------ooo-------------------oooo--------------XXXXXXXXXX-------------------------------ooooooooo----XXXXXXXX--------------------XXXXXXXXX---
XXXXXXXXXXX----------------------------------XXXXXX------XXXXX------------------oooo-----------XXXXXXXXXXXXXXXXXXXXX-ooooo----XXXX--------XXXXXXXX-----------XXXXXXXXXXX-oo------------oo---XXXXXXXXX---
XXXXXXXXXXXXXXXXXXX---------XXXXXXXXXXXXXXXXXXXXXXXXXXXXXXXXXXXXXXXXXXXXX------------XXXXXXXXXXXXXXXXXXXXXXXXXXXXXXX----------XXXX--------XXXXXXXXXXXXXXXXXXXXXXXXXXXXXX------XXXXX-----g---XXXXXXXXXXXX
XXXXXXXXXXXXXXXXXXXXXXXXXXXXXXXXXXXXXXXXXXXXXXXXXXXXXXXXXXXXXXXXXXXXXXXXXXXXXXXXXXXXXXXXXXXXXXXXXXXXXXXXXXXXXXXXXXXXXXXXXXXXXXXXXXXXXXXXXXXXXXXXXXXXXXXXXXXXXXXXXXXXXXXXXXXXXXXXXXXXXXXXXXXXXXXXXXXXXXXX

