--------------------------------------------------------------------------------------------------------------------------------------------------------------------------------------------------------
--------------------------------------------------------------------------------------------------------------------------------------------------------------------------------------------------------
--------------------------------------------------------------------------------------------------------------------------------------------------------------------------------------------------------
--------------------------------------------------------------------------------------------------------------------------------------------------------------------------------------------------------
--------------------------------------------------------------------------------------------------------------------------------------------------------------------------------------------------------
--------------------------------------------------------------------------------------------------------------------------------------------------------------------------------------------------------
--------------------------------------------------------------------------------------------------------------------------------------------------------------------------------------------------------
--------------------------------------------------------------------------------------------------------------------------------------------------------------------------------------------------------
--------------------------------------------------------------------------------------------------------------------------------------------------------------------------------------------------------
--------------------------------------------------------------------------------------------------------------------------------------------------------------------------------------------------------
--------------------------------------------------------------------------------------------------------------------------------------------------------------------------------------------------------
--------------------------------------------------------------------------------------------------------------------------------------------------------------------------------------------------------
-------------------------------------------------------------------------------------ooSSoo-------------------------------------------------------------------------------------------------------------
-------------------------------------------------------oSo-------------------------------------------------------------------------SooSSo------ooooSoo-------------ooo-------------oooS-----------------
----------------------------oSoo---------------------------------------------------oooooo-----------------oSo-------------------------------------------------------------------------------------------
-------------ooSoo-----------------------------------ooooooo--------------oooSS----------------------------------------------------oooooooo------oo-------ooSooo----oo----------oooooooo----------------
XXXXXXXXXXX-------------------oooo-------------XXXXX-----------------------------XXXXXXXXXXX------------oooooooo----XXXXXX----oo------------XX-----------------------------------------------XXXXXX-----
XXXXXXXXXXX-oooo-----------------------XXXX----XXXXXXXXXXXXXXX------------oooo---XXXXXXXXXXXXXX---------------------XXXXXX-------XXXXXXXXXXXXXXXXXXXXXX---ooooo--XXXXXXXXX-----XXXXXXXXXXXX--XXXXXX-----
XXXXXXXXXXX---------------XXXXXXXXX----XXXX--XXXXXXXXXXXXXXXXX-------XX----------XXXXXXXXXXXXXXXXXXXXXXXXXXXXXXXX---XXXXXXXXXXXXXXXXXXXXXXXXXXXXXXXXXXX----------XXXXXXXXXXXXXXXXXXXXXXXXXXXXXXXXXX-----
XXXXXXXXXXXXXXXXXXXXXXXXXXXXXXXXXXXXXXXXXXXXXXXXXXXXXXXXXXXXXXXXXXXXXXXXXXXXXXXXXXXXXXXXXXXXXXXXXXXXXXXXXXXXXXXXXXXXXXXXXXXXXXXXXXXXXXXXXXXXXXXXXXXXXXXXXXXXXXXXXXXXXXXXXXXXXXXXXXXXXXXXXXXXXXXXXXXXXXXX

