--------------------------------------------------------------------------------------------------------------------------------------------------------------------------------------------------------
--------------------------------------------------------------------------------------------------------------------------------------------------------------------------------------------------------
--------------------------------------------------------------------------------------------------------------------------------------------------------------------------------------------------------
--------------------------------------------------------------------------------------------------------------------------------------------------------------------------------------------------------
--------------------------------------------------------------------------------------------------------------------------------------------------------------------------------------------------------
--------------------------------------------------------------------------------------------------------------------------------------------------------------------------------------------------------
--------------------------------------------------------------------------------------------------------------------------------------------------------------------------------------------------------
--------------------------------------------------------------------------------------------------------------------------------------------------------------------------------------------------------
--------------------------------------------------------------------------------------------------------------------------------------------------------------------------------------------------------
--------------------------------------------------------------------------------------------------------------------------------------------------------------------------------------------------------
--------------------------------------------------------------------------------------------------------------------------------------------------------------------------------------------------------
--------------------------------------------------------------------------------------------------------------------------------------------------------------------------------------------------------
----------------------------------------------------------------------ooooo------------------ooSSS-------------------------------------------------------------------------------------ooo--------------
---------------ooo---------ooooo---------------------------------------------------------------------------------------------------------------------------------------SoSoo----------------------------
-------------------------------------------------------------------ooooooo-------------------oooooo-----------------------------------------------------------------------------------------------------
---------------------------oooooo-----Soooo------------------------------------oo----------------------------------oooo-------------------------oo-------------------ooooooo----------g-----------------
---------------g------XXXX------------------------------------oo--XXXXXXXXXX----------------XXXXXXXXX--------XXXXX----------ooo------------g------------XXXXX---------g--------------XXXXXX-------------
--------------XXXXXXXXXXXXXXXXXXXX----oooooo-XX-------------------XXXXXXXXXX--XXXXXXXXXXX---XXXXXXXXX--oooo--XXXXX----oo---------------XXXXXXXXXXXXXXXXXXXXXX------XXXXXXXXXXXXXXXXXXXXXXXX-------------
--------------XXXXXXXXXXXXXXXXXXXX-----------XX-----XXXX--XXXXXXXXXXXXXXXXXX--XXXXXXXXXXXXXXXXXXXXXXX--------XXXXX--------XXXXXXXXX----XXXXXXXXXXXXXXXXXXXXXXXXXXXXXXXXXXXXXXXXXXXXXXXXXXXX-------------
XXXXXXXXXXXXXXXXXXXXXXXXXXXXXXXXXXXXXXXXXXXXXXXXXXXXXXXXXXXXXXXXXXXXXXXXXXXXXXXXXXXXXXXXXXXXXXXXXXXXXXXXXXXXXXXXXXXXXXXXXXXXXXXXXXXXXXXXXXXXXXXXXXXXXXXXXXXXXXXXXXXXXXXXXXXXXXXXXXXXXXXXXXXXXXXXXXXXXXXX

