--------------------------------------------------------------------------------------------------------------------------------------------------------------------------------------------------------
--------------------------------------------------------------------------------------------------------------------------------------------------------------------------------------------------------
--------------------------------------------------------------------------------------------------------------------------------------------------------------------------------------------------------
--------------------------------------------------------------------------------------------------------------------------------------------------------------------------------------------------------
--------------------------------------------------------------------------------------------------------------------------------------------------------------------------------------------------------
--------------------------------------------------------------------------------------------------------------------------------------------------------------------------------------------------------
--------------------------------------------------------------------------------------------------------------------------------------------------------------------------------------------------------
--------------------------------------------------------------------------------------------------------------------------------------------------------------------------------------------------------
--------------------------------------------------------------------------------------------------------------------------------------------------------------------------------------------------------
--------------------------------------------------------------------------------------------------------------------------------------------------------------------------------------------------------
--------------------------------------------------------------------------------------------------------------------------------------------------------------------------------------------------------
--------------------------------------------------------------------------------------------------------------------------------------------------------------------------------------------------------
--------------------------------------oSoooSS------------------------------------------------------------------------------------------------------------SoS--------------------ooSooo------------------
--------------ooSSo-----------------------------------------------------------------------------------SSSo-------------------------------SSo------------------------------------------------------------
---------------------------------------ooooooo-----------------------------------------------------------------SSoo------------------------------Soo-----------------------------ooooooo------ooo-------
---------------------------------------------------------------------ooSoo----------------------g----ooo---------------------------------ooo-----------g----g-----------ooSS----------------------------
----------------g----------------XXXXXXXXXXXXXX-----XXXXXX----------------------------ooooo-XXXXXX-----------oooo---XXXXXX----------------------oo----XXXXXXXX-----------------XXXXXXXXXX-----oooo--XXXX
XXXXXXXXXXXXXXXXXXXX-----XXX-----XXXXXXXXXXXXXX-----XXXXXX------------ooooo----oo-----------XXXXXXXXXXXXXXXX--------XXXXXX-----------XXXXXXXX------g--XXXXXXXXXXX--------oooo--XXXXXXXXXX-----------XXXX
XXXXXXXXXXXXXXXXXXXXXXXXXXXXXXXXXXXXXXXXXXXXXXX-----XXXXXXXXXXXXXXXX----------------XXXXXXXXXXXXXXXXXXXXXXXXXXXXXXXXXXXXXX---XX------XXXXXXXXXXXXXXXXXXXXXXXXXXXX--------------XXXXXXXXXXXXXXXXXXXXXXXXX
XXXXXXXXXXXXXXXXXXXXXXXXXXXXXXXXXXXXXXXXXXXXXXXXXXXXXXXXXXXXXXXXXXXXXXXXXXXXXXXXXXXXXXXXXXXXXXXXXXXXXXXXXXXXXXXXXXXXXXXXXXXXXXXXXXXXXXXXXXXXXXXXXXXXXXXXXXXXXXXXXXXXXXXXXXXXXXXXXXXXXXXXXXXXXXXXXXXXXXXX

