--------------------------------------------------------------------------------------------------------------------------------------------------------------------------------------------------------
--------------------------------------------------------------------------------------------------------------------------------------------------------------------------------------------------------
--------------------------------------------------------------------------------------------------------------------------------------------------------------------------------------------------------
--------------------------------------------------------------------------------------------------------------------------------------------------------------------------------------------------------
--------------------------------------------------------------------------------------------------------------------------------------------------------------------------------------------------------
--------------------------------------------------------------------------------------------------------------------------------------------------------------------------------------------------------
--------------------------------------------------------------------------------------------------------------------------------------------------------------------------------------------------------
--------------------------------------------------------------------------------------------------------------------------------------------------------------------------------------------------------
--------------------------------------------------------------------------------------------------------------------------------------------------------------------------------------------------------
--------------------------------------------------------------------------------------------------------------------------------------------------------------------------------------------------------
--------------------------------------------------------------------------------------------------------------------------------------------------------------------------------------------------------
--------------------------------------------------------------------------------------------------------------------------------------------------------------------------------------------------------
-------------------------------------------------------------------------------------ooooS------------------------------------------------oooSoo---oSooo------------------------------------oSooooo-----
-----------------------------------------------oooSSoo----oSSSo---------oooo-------------------------------------------------------------------------------------------------------oSoo-----------------
---------------------------------ooSSSo-----------------------------------------------oo------------------ooSoooo-----------ooo------------oooooo---oo-------oooo---------oooo----------------oooooo----
-----------------oo-------------------------------------ooooo---------oooooooo--------------------------------------------g----------ooo--------------------------------------------oo------------------
--------------------XXXXXXXXX----ooo-----------------------------XXXX--------------XXXXXXXXX-oooo--------oooooo----------XXXXXXXX--------XXXXXXXXXXXXXXXX---ooo---XXXXXX--oooooo----------XXXXXXXXXXX---
XXXXXXXXXXXXXXXXXXXXXXXXXXXXX-----------------XXXXXXXXXXXXXXXXXXXXXXXXXXXXXXXXX----XXXXXXXXX------XXXXX------------------XXXXXXXXXXXXXXXXXXXXXXXXXXXXXXXX---------XXXXXX---------XXXXXXXXXXXXXXXXXXXX---
XXXXXXXXXXXXXXXXXXXXXXXXXXXXXXXXXXXXXXXXXXXXXXXXXXXXXXXXXXXXXXXXXXXXXXXXXXXXXXX----XXXXXXXXXXXXXXXXXXXXXXXXXXXXXXXXXXXXXXXXXXXXXXXXXXXXXXXXXXXXXXXXXXXXXXXXXXXXXXXXXXXXXXXXXXXXXXXXXXXXXXXXXXXXXXXXXXXXX
XXXXXXXXXXXXXXXXXXXXXXXXXXXXXXXXXXXXXXXXXXXXXXXXXXXXXXXXXXXXXXXXXXXXXXXXXXXXXXXXXXXXXXXXXXXXXXXXXXXXXXXXXXXXXXXXXXXXXXXXXXXXXXXXXXXXXXXXXXXXXXXXXXXXXXXXXXXXXXXXXXXXXXXXXXXXXXXXXXXXXXXXXXXXXXXXXXXXXXXX

