--------------------------------------------------------------------------------------------------------------------------------------------------------------------------------------------------------
--------------------------------------------------------------------------------------------------------------------------------------------------------------------------------------------------------
--------------------------------------------------------------------------------------------------------------------------------------------------------------------------------------------------------
--------------------------------------------------------------------------------------------------------------------------------------------------------------------------------------------------------
--------------------------------------------------------------------------------------------------------------------------------------------------------------------------------------------------------
--------------------------------------------------------------------------------------------------------------------------------------------------------------------------------------------------------
--------------------------------------------------------------------------------------------------------------------------------------------------------------------------------------------------------
--------------------------------------------------------------------------------------------------------------------------------------------------------------------------------------------------------
--------------------------------------------------------------------------------------------------------------------------------------------------------------------------------------------------------
--------------------------------------------------------------------------------------------------------------------------------------------------------------------------------------------------------
--------------------------------------------------------------------------------------------------------------------------------------------------------------------------------------------------------
--------------------------------------------------------------------------------------------------------------------------------------------------------------------------------------------------------
------------ooo-------------------oooooo----------------------------------Soooooo-----------------------------------------------------------------------------------------------------------------------
----------------------ooSoo------------------------------------oooooSoo--------------------------------------------------------------------SoS----------------------------------------------------------
-----------ooo-------------------ooooooo------------------------------------ooooo---oooooooo------------------------------------------------------------------------oSSSo-------------------------------
----------------------ooooo-----------------------oooo------------ooooo---g--------------------oo-----------oSSSSo-------------------------ooooo-----oSSSoo--ooS-------------------oooo--------oSo------
----------XXXXXXX-------------XXXXXXXXXXX---------------XXXXXX----------XXXXXXXXXXX--ooooooo--g-----------------------ooooo--XXXXX-----------------------------------oooooo------------------------XXXXX
XXXXXXXXXXXXXXXXXXXXXXXXXXXX--XXXXXXXXXXX-ooo----XXXXXXXXXXXXXXXXXXXXXXXXXXXXXXXXXX----------XXXXXX-----XX----oooooo---------XXXXX----XXXXXXXXXXX---oooooo------------------------ooooo--------ooo-XXXXX
XXXXXXXXXXXXXXXXXXXXXXXXXXXXXXXXXXXXXXXXX--------XXXXXXXXXXXXXXXXXXXXXXXXXXXXXXXXXXXXXXXXXXXXXXXXXXXXXXXXX-----------XXXXXXXXXXXXX----XXXXXXXXXXX-----------------XXXXXXXXXXXXXXX------------------XXXXX
XXXXXXXXXXXXXXXXXXXXXXXXXXXXXXXXXXXXXXXXXXXXXXXXXXXXXXXXXXXXXXXXXXXXXXXXXXXXXXXXXXXXXXXXXXXXXXXXXXXXXXXXXXXXXXXXXXXXXXXXXXXXXXXXXXXXXXXXXXXXXXXXXXXXXXXXXXXXXXXXXXXXXXXXXXXXXXXXXXXXXXXXXXXXXXXXXXXXXXXX

