--------------------------------------------------------------------------------------------------------------------------------------------------------------------------------------------------------
--------------------------------------------------------------------------------------------------------------------------------------------------------------------------------------------------------
--------------------------------------------------------------------------------------------------------------------------------------------------------------------------------------------------------
--------------------------------------------------------------------------------------------------------------------------------------------------------------------------------------------------------
--------------------------------------------------------------------------------------------------------------------------------------------------------------------------------------------------------
--------------------------------------------------------------------------------------------------------------------------------------------------------------------------------------------------------
--------------------------------------------------------------------------------------------------------------------------------------------------------------------------------------------------------
--------------------------------------------------------------------------------------------------------------------------------------------------------------------------------------------------------
--------------------------------------------------------------------------------------------------------------------------------------------------------------------------------------------------------
--------------------------------------------------------------------------------------------------------------------------------------------------------------------------------------------------------
--------------------------------------------------------------------------------------------------------------------------------------------------------------------------------------------------------
--------------------------------------------------------------------------------------------------------------------------------------------------------------------------------------------------------
----------------------------------oSooSoooo------------------------------------------------------------------------------------------------------------oSo----------------------------------------------
-----------------------------------------------------------------oooo-----------------------------------oSooSo-------Soo-------------------------------------------------------------oooSo--------------
-------------oSS-------------------ooooo----------------------------------------------------------------------------------------ooooS-------------------oooo--------------ooSoo-------------------------
----------------------------g-------------------------ooooo-------oo-------------------------------------oooo-----------------------------------------------------------------------ooooooooo-----------
XXXXXXXXXX-ooooo---XXX----XXXXXXXXXXXXXXXXXX----------------------------------------------XXXXXX---------------g-----------------ooo-----------------XXXXXXXXXXXXXXXXXXXX--oooooo-----------------------
XXXXXXXXXX---------XXX----XXXXXXXXXXXXXXXXXX---------oooooo--XXXXXXXXXXX---oooo-----------XXXXXX-----XXXXXXXXXXXX--XXXXXXXXX-------------------------XXXXXXXXXXXXXXXXXXXX----------XXXXXXXXXXX--XXX-----
XXXXXXXXXXXXXXXXXXXXXX----XXXXXXXXXXXXXXXXXX-----------------XXXXXXXXXXX--------XXXXXXXXXXXXXXXXXXXXXXXXXXXXXXXXXXXXXXXXXXXXXXXXXXXXXXXXXXXXXXXXXXXXXXXXXXXXXXXXXXXXXXXXXXXXXXXXXXXXXXXXXXXXXX--XXXXXX--
XXXXXXXXXXXXXXXXXXXXXXXXXXXXXXXXXXXXXXXXXXXXXXXXXXXXXXXXXXXXXXXXXXXXXXXXXXXXXXXXXXXXXXXXXXXXXXXXXXXXXXXXXXXXXXXXXXXXXXXXXXXXXXXXXXXXXXXXXXXXXXXXXXXXXXXXXXXXXXXXXXXXXXXXXXXXXXXXXXXXXXXXXXXXXXXXXXXXXXXX

