--------------------------------------------------------------------------------------------------------------------------------------------------------------------------------------------------------
--------------------------------------------------------------------------------------------------------------------------------------------------------------------------------------------------------
--------------------------------------------------------------------------------------------------------------------------------------------------------------------------------------------------------
--------------------------------------------------------------------------------------------------------------------------------------------------------------------------------------------------------
--------------------------------------------------------------------------------------------------------------------------------------------------------------------------------------------------------
--------------------------------------------------------------------------------------------------------------------------------------------------------------------------------------------------------
--------------------------------------------------------------------------------------------------------------------------------------------------------------------------------------------------------
--------------------------------------------------------------------------------------------------------------------------------------------------------------------------------------------------------
--------------------------------------------------------------------------------------------------------------------------------------------------------------------------------------------------------
--------------------------------------------------------------------------------------------------------------------------------------------------------------------------------------------------------
--------------------------------------------------------------------------------------------------------------------------------------------------------------------------------------------------------
--------------------------------------------------------------------------------------------------------------------------------------------------------------------------------------------------------
-------------------------------------oSooSo--------------------------------------------------------------------------------------------------------------------------------------oSoo-------------------
------------------------------------------------------------------------------------------------------------------------------------------------------------------------oSSSoo--------------------------
-----------------------------------oooooo------SSoooo----------oooooo-------------------------SSSS------ooSoo-----------------oooo-----------------------------------------------ooooooo----------------
----------------------oSSoS----------------------------------------------------------------------------------------ooSSoo-----------------------------------------------oooo----------------------------
XXXXXXXXXXXXXX-----XX------------XXXXXXXXXXX--oooooooo-XXXXX---ooo----XXX----ooo------------ooooooo-XX-oooooo---------------ooooooo--------XXXX-------------XX--XXXX-----------XXXXXXXXXX----------XXXXX
XXXXXXXXXXXXXXXXXXXXX--ooooo-----XXXXXXXXXXX-----------XXXXX----------XXX--------XX----oo----g------XX-------------oooooo------------------XXXX---XXXXX-----XX--XXXXXXXXXXXXXXXXXXXXXXXXX----------XXXXX
XXXXXXXXXXXXXXXXXXXXX---------XXXXXXXXXXXXXXXXXXXXXXXXXXXXXXXXXXXXXXXXXXXXXXXXXXXXX---g---XXXXXXXXXXXXXXXXXXXXXXX---------XXXXXXXXXX-------XXXXXXXXXXXXXXXXXXXXXXXXXXXXXXXXXXXXXXXXXXXXXXXXXXX-----XXXXX
XXXXXXXXXXXXXXXXXXXXXXXXXXXXXXXXXXXXXXXXXXXXXXXXXXXXXXXXXXXXXXXXXXXXXXXXXXXXXXXXXXXXXXXXXXXXXXXXXXXXXXXXXXXXXXXXXXXXXXXXXXXXXXXXXXXXXXXXXXXXXXXXXXXXXXXXXXXXXXXXXXXXXXXXXXXXXXXXXXXXXXXXXXXXXXXXXXXXXXXX

