--------------------------------------------------------------------------------------------------------------------------------------------------------------------------------------------------------
--------------------------------------------------------------------------------------------------------------------------------------------------------------------------------------------------------
--------------------------------------------------------------------------------------------------------------------------------------------------------------------------------------------------------
--------------------------------------------------------------------------------------------------------------------------------------------------------------------------------------------------------
--------------------------------------------------------------------------------------------------------------------------------------------------------------------------------------------------------
--------------------------------------------------------------------------------------------------------------------------------------------------------------------------------------------------------
--------------------------------------------------------------------------------------------------------------------------------------------------------------------------------------------------------
--------------------------------------------------------------------------------------------------------------------------------------------------------------------------------------------------------
--------------------------------------------------------------------------------------------------------------------------------------------------------------------------------------------------------
--------------------------------------------------------------------------------------------------------------------------------------------------------------------------------------------------------
--------------------------------------------------------------------------------------------------------------------------------------------------------------------------------------------------------
--------------------------------------------------------------------------------------------------------------------------------------------------------------------------------------------------------
--------------------oSooSo------------------------------------------------------------------------------------------------------------------oooo----SoSo------ooSS---------------Sooo-------------------
-----------------------------------oooooS-----------------SSooSo----------------------------------------------------------------------------------------------------------------------------------------
-------------------ooooo------------------------------------------oSS--------------------------oooooo------------ooo-------------------------oo------oooo-----oooo----------------oooo------------ooo---
-------------------------------------oooo------------------ooooo-------------------ooSoSS--------------------------------------oooo-----------g-----------------------ooooS-------------------------g---
XXXXXXXXXXXXX----XXXXXXXXXX-ooooo----------------XX-------g-----------------------------------XXXXXXXXX---------oooooo-XXXXXX--g-----------XXXXXXXXXXXXXXXXXXXXXXXXXX---------XXXXXXXXXXX----ooo-XXXXXXX
XXXXXXXXXXXXX----XXXXXXXXXX-------XXXXXXXXXXXXXXXXX----XXXXXXXXXX-----------------oooooooo--XXXXXXXXXXX---XXX---g-g----XXXXXXXXXXXXXX------XXXXXXXXXXXXXXXXXXXXXXXXXX-ooooo---XXXXXXXXXXX--------XXXXXXX
XXXXXXXXXXXXXXXXXXXXXXXXXXXXXXXXXXXXXXXXXXXXXXXXXXX----XXXXXXXXXXXXXXXXXXXXXXXXXX-----g-----XXXXXXXXXXX---XXXXXXXXXXXXXXXXXXXXXXXXXXX------XXXXXXXXXXXXXXXXXXXXXXXXXX---------XXXXXXXXXXXXXXXXXXXXXXXXXX
XXXXXXXXXXXXXXXXXXXXXXXXXXXXXXXXXXXXXXXXXXXXXXXXXXXXXXXXXXXXXXXXXXXXXXXXXXXXXXXXXXXXXXXXXXXXXXXXXXXXXXXXXXXXXXXXXXXXXXXXXXXXXXXXXXXXXXXXXXXXXXXXXXXXXXXXXXXXXXXXXXXXXXXXXXXXXXXXXXXXXXXXXXXXXXXXXXXXXXXX

