--------------------------------------------------------------------------------------------------------------------------------------------------------------------------------------------------------
--------------------------------------------------------------------------------------------------------------------------------------------------------------------------------------------------------
--------------------------------------------------------------------------------------------------------------------------------------------------------------------------------------------------------
--------------------------------------------------------------------------------------------------------------------------------------------------------------------------------------------------------
--------------------------------------------------------------------------------------------------------------------------------------------------------------------------------------------------------
--------------------------------------------------------------------------------------------------------------------------------------------------------------------------------------------------------
--------------------------------------------------------------------------------------------------------------------------------------------------------------------------------------------------------
--------------------------------------------------------------------------------------------------------------------------------------------------------------------------------------------------------
--------------------------------------------------------------------------------------------------------------------------------------------------------------------------------------------------------
--------------------------------------------------------------------------------------------------------------------------------------------------------------------------------------------------------
--------------------------------------------------------------------------------------------------------------------------------------------------------------------------------------------------------
--------------------------------------------------------------------------------------------------------------------------------------------------------------------------------------------------------
----------------------------------oSo------------------------------------------------------ooo-----------------------oSooooooo------------------------------------------------------------oooo----------
--------------------------------------------------------------------------------------------------------------------------------------------------------------------ooo---------------------------------
----------------------ooooo-----------------Sooo------------------------------------------oooo-------------------------oooooo----------------oSooo-----oooo------------------Soo--oSSooo----oo----------
----------------------------------------------------oooSooo----------------------------------------------------------------------oSoooooo--------------------------oooooo-------------------------------
----------------------ooooo-XXXXXXXXXXXX--ooooooo-----------XXX------------XXXXX----XXXXXXXXXXX--oo-----------------XXXXXXXXXXX-------------oooo------XXXXXXXXXXXX-----------------ooo---XXXXXXX--------
-----------------oo---------XXXXXXXXXXXX-------------ooo----XXX-----XXXXXXXXXXXXXXXXXXXXXXXXXXX-g----XXXXX----------XXXXXXXXXXX-oooooo-------g------XXXXXXXXXXXXXXXXXXXXXXX---------g----XXXXXXXXXX-----
XXXXXXXXXX-----------XXXXXXXXXXXXXXXXXXXXXXXXXXXXX----------XXX-----XXXXXXXXXXXXXXXXXXXXXXXXXXXXXXXXXXXXXX----------XXXXXXXXXXX---------g-XXXXXXXXXXXXXXXXXXXXXXXXXXXXXXXXXXXXXXXXXXXXXXXXXXXXXXXXXXXXXX
XXXXXXXXXXXXXXXXXXXXXXXXXXXXXXXXXXXXXXXXXXXXXXXXXXXXXXXXXXXXXXXXXXXXXXXXXXXXXXXXXXXXXXXXXXXXXXXXXXXXXXXXXXXXXXXXXXXXXXXXXXXXXXXXXXXXXXXXXXXXXXXXXXXXXXXXXXXXXXXXXXXXXXXXXXXXXXXXXXXXXXXXXXXXXXXXXXXXXXXX

