--------------------------------------------------------------------------------------------------------------------------------------------------------------------------------------------------------
--------------------------------------------------------------------------------------------------------------------------------------------------------------------------------------------------------
--------------------------------------------------------------------------------------------------------------------------------------------------------------------------------------------------------
--------------------------------------------------------------------------------------------------------------------------------------------------------------------------------------------------------
--------------------------------------------------------------------------------------------------------------------------------------------------------------------------------------------------------
--------------------------------------------------------------------------------------------------------------------------------------------------------------------------------------------------------
--------------------------------------------------------------------------------------------------------------------------------------------------------------------------------------------------------
--------------------------------------------------------------------------------------------------------------------------------------------------------------------------------------------------------
--------------------------------------------------------------------------------------------------------------------------------------------------------------------------------------------------------
--------------------------------------------------------------------------------------------------------------------------------------------------------------------------------------------------------
--------------------------------------------------------------------------------------------------------------------------------------------------------------------------------------------------------
--------------------------------------------------------------------------------------------------------------------------------------------------------------------------------------------------------
----------------------------------------------oSoSS------------oSSo--------------Sooo-------------------------ooS---oSSoSSo------------------oooSooo----------------------------------------------------
-------------------------------------------------------------------------------------------------------ooS----------------------------------------------SoSo--------Soo---------------------------------
---------------------------------------ooSoo----oooo-------------------oSoSooo--ooooo----ooo------------------oooo--ooooo-----------------------oooo----------------------------------------------------
------------------------------------------------------------------g-----------------------------------ooooo-----------g----------------------g-----------ooooo----ooo----------------oSSooo-------------
-------------------------XXXXX-------oooooo--XXXXXXXXX-------XXXXXXX---ooooooo-XXXXXXXXXXXXXX----------------XXXXXXXXXXXXXXXXXX-------------XXXXXXXXX------------g--------------------------------------
XXXXXXXXXXXXX------------XXXXXXXXXXX---------XXXXXXXXX-------XXXXXXX-----------XXXXXXXXXXXXXXXXX--XXXXXXXXXXXXXXXXXXXXXXXXXXXXXXXXXXXXX-----XXXXXXXXXXXXXXXXXXXXXXXXXXXXXXXXXXXXXXX-ooooooooo---oo------
XXXXXXXXXXXXX---XXXXX----XXXXXXXXXXXXXXXXXXXXXXXXXXXXX-------XXXXXXXXXXXXXXXXXXXXXXXXXXXXXXXXXXXXXXXXXXXXXXXXXXXXXXXXXXXXXXXXXXXXXXXXXX-----XXXXXXXXXXXXXXXXXXXXXXXXXXXXXXXXXXXXXXX--------------g------
XXXXXXXXXXXXXXXXXXXXXXXXXXXXXXXXXXXXXXXXXXXXXXXXXXXXXXXXXXXXXXXXXXXXXXXXXXXXXXXXXXXXXXXXXXXXXXXXXXXXXXXXXXXXXXXXXXXXXXXXXXXXXXXXXXXXXXXXXXXXXXXXXXXXXXXXXXXXXXXXXXXXXXXXXXXXXXXXXXXXXXXXXXXXXXXXXXXXXXXX

