--------------------------------------------------------------------------------------------------------------------------------------------------------------------------------------------------------
--------------------------------------------------------------------------------------------------------------------------------------------------------------------------------------------------------
--------------------------------------------------------------------------------------------------------------------------------------------------------------------------------------------------------
--------------------------------------------------------------------------------------------------------------------------------------------------------------------------------------------------------
--------------------------------------------------------------------------------------------------------------------------------------------------------------------------------------------------------
--------------------------------------------------------------------------------------------------------------------------------------------------------------------------------------------------------
--------------------------------------------------------------------------------------------------------------------------------------------------------------------------------------------------------
--------------------------------------------------------------------------------------------------------------------------------------------------------------------------------------------------------
--------------------------------------------------------------------------------------------------------------------------------------------------------------------------------------------------------
--------------------------------------------------------------------------------------------------------------------------------------------------------------------------------------------------------
--------------------------------------------------------------------------------------------------------------------------------------------------------------------------------------------------------
--------------------------------------------------------------------------------------------------------------------------------------------------------------------------------------------------------
----------------------------------------------------------------------------------------------------oooo------------------------------------------------------------------------------------------------
----------------------------------------------------------------------------------------------------------------------oSSo-------SSo---------------------------------------------------Soooo-----oSooSo-
---------------------------------------------------------------------ooo----------oSoSooSo--------ooooo-----------------------------------------------oooo----------------------------------------------
-------------------------------------------------------------------------------------------------------------------------------ooooo--------------------------------------------------ooo---------------
XXXXXXXXXXXX----g--g-------------------XXXXXXXXXX------XXX--------------------------oooo---------XXXXXXXXXXXXXXXXXXXX-----------------------------XXXXXXXXX-------------XXXX-----------------XXX--------
XXXXXXXXXXXXXXXXXXXXX-------------XXXXXXXXXXXXXXX------XXX------------------ooo------------------XXXXXXXXXXXXXXXXXXXXXXXXXX---XXXXXXX------XXXXXXXXXXXXXXXXXXXXX--------XXXX-----XXXXXXXXXXXXXXXXXXXXXXX
XXXXXXXXXXXXXXXXXXXXX--g----------XXXXXXXXXXXXXXXXXXXXXXXXXXXXXXXXXXXXXXX-g-----XXXXXXXXXXX------XXXXXXXXXXXXXXXXXXXXXXXXXXXXXXXXXXXX------XXXXXXXXXXXXXXXXXXXXX--------XXXXXXXXXXXXXXXXXXXXXXXXXXXXXXXX
XXXXXXXXXXXXXXXXXXXXXXXXXXXXXXXXXXXXXXXXXXXXXXXXXXXXXXXXXXXXXXXXXXXXXXXXXXXXXXXXXXXXXXXXXXXXXXXXXXXXXXXXXXXXXXXXXXXXXXXXXXXXXXXXXXXXXXXXXXXXXXXXXXXXXXXXXXXXXXXXXXXXXXXXXXXXXXXXXXXXXXXXXXXXXXXXXXXXXXXX

