--------------------------------------------------------------------------------------------------------------------------------------------------------------------------------------------------------
--------------------------------------------------------------------------------------------------------------------------------------------------------------------------------------------------------
--------------------------------------------------------------------------------------------------------------------------------------------------------------------------------------------------------
--------------------------------------------------------------------------------------------------------------------------------------------------------------------------------------------------------
--------------------------------------------------------------------------------------------------------------------------------------------------------------------------------------------------------
--------------------------------------------------------------------------------------------------------------------------------------------------------------------------------------------------------
--------------------------------------------------------------------------------------------------------------------------------------------------------------------------------------------------------
--------------------------------------------------------------------------------------------------------------------------------------------------------------------------------------------------------
--------------------------------------------------------------------------------------------------------------------------------------------------------------------------------------------------------
--------------------------------------------------------------------------------------------------------------------------------------------------------------------------------------------------------
--------------------------------------------------------------------------------------------------------------------------------------------------------------------------------------------------------
--------------------------------------------------------------------------------------------------------------------------------------------------------------------------------------------------------
---------------------------------------------------------------------------------------------------------------------------------------------------------------------------------------------ooo--------
-----------ooooSSSo-------------------------------------SooooSo-----------------------------------------oSo------------------------------------ooooo---------------oooooS-------------------------------
--------------------------------SSSo-----------------------------------------------------------------------------------------------------------------------------------------oooooS--------oooooooo-----
------------oooooo---oSSo---------------------------------oooooo------------------------oooo-----------------------------ooo----ooS------ooo--------------ooSo--------oo--------------------------------
------------------------------oooooo--XXXX----oooo----------g----------oooo-------------------------------------oo----------------------------------g------------------------oooooo------XXXXXXXXXXXXXXX
----------XXXXXXXXXX---oooo-----------XXXX------------XXXXXXXXXXX---------------oo-----oooo------------XXXXXXXX--g----oooo----oooooooo-XXXXXXXXXXXXXXXXX-ooooooo--XXXXXXXXX-g---------XXXXXXXXXXXXXXXXXX
----------XXXXXXXXXX---------XXXXXXXXXXXXXXXXXXXXXXXXXXXXXXXXXXXX-----XXXXXXX--------------------------XXXXXXXXXXXXXX------------------XXXXXXXXXXXXXXXXX-------g--XXXXXXXXXXXXXXXXXXXXXXXXXXXXXXXXXXXXXX
XXXXXXXXXXXXXXXXXXXXXXXXXXXXXXXXXXXXXXXXXXXXXXXXXXXXXXXXXXXXXXXXXXXXXXXXXXXXXXXXXXXXXXXXXXXXXXXXXXXXXXXXXXXXXXXXXXXXXXXXXXXXXXXXXXXXXXXXXXXXXXXXXXXXXXXXXXXXXXXXXXXXXXXXXXXXXXXXXXXXXXXXXXXXXXXXXXXXXXXX

