--------------------------------------------------------------------------------------------------------------------------------------------------------------------------------------------------------
--------------------------------------------------------------------------------------------------------------------------------------------------------------------------------------------------------
--------------------------------------------------------------------------------------------------------------------------------------------------------------------------------------------------------
--------------------------------------------------------------------------------------------------------------------------------------------------------------------------------------------------------
--------------------------------------------------------------------------------------------------------------------------------------------------------------------------------------------------------
--------------------------------------------------------------------------------------------------------------------------------------------------------------------------------------------------------
--------------------------------------------------------------------------------------------------------------------------------------------------------------------------------------------------------
--------------------------------------------------------------------------------------------------------------------------------------------------------------------------------------------------------
--------------------------------------------------------------------------------------------------------------------------------------------------------------------------------------------------------
--------------------------------------------------------------------------------------------------------------------------------------------------------------------------------------------------------
--------------------------------------------------------------------------------------------------------------------------------------------------------------------------------------------------------
--------------------------------------------------------------------------------------------------------------------------------------------------------------------------------------------------------
-------------------------oooooSS--------------oooSooo---------------------------------------------ooooo------------------Sooooo-------------------------------------------------------------------------
-------------------------------------------------------------------------------------------------------------------------------------------------------------------------------------oooo--------ooSo---
-------------------------oooooo----------------oooo------------------------------oooo----ooooo-----ooo-----------------oooooo----------------------------------oSoSoS-----------------------------------
------------------------------------------------------------oSo-------------------------------------------------------------------Soooo--------Soo----oSoooo-------------------------ooo---------oo-----
-----------------------XXXXXXXXXXX--XXXXX----XXXXXXXXX-----------XX-----XXXXX-----oo----XXXXXXXXXXXXXXXX--------------XXXXXXXXXX--------XXXXX------XX----------oooooo-----------------------------------
-----------------------XXXXXXXXXXX--XXXXXXXXXXXXXXXXXX----ooooo--XXXXXXXXXXXX-----g-----XXXXXXXXXXXXXXXX----oo---oooo-XXXXXXXXXX--ooo---XXXXX------XX-oooo--------------------XXXXXXXXXXXXXXXXXXXXXXXX--
XXXXXXXXXXXXXXXXXXXX---XXXXXXXXXXX--XXXXXXXXXXXXXXXXXX-----------XXXXXXXXXXXX---XXXXXXXXXXXXXXXXXXXXXXXX--------------XXXXXXXXXX--------XXXXX------XX---------XXXXXXXXXXX-----XXXXXXXXXXXXXXXXXXXXXXXXXX
XXXXXXXXXXXXXXXXXXXXXXXXXXXXXXXXXXXXXXXXXXXXXXXXXXXXXXXXXXXXXXXXXXXXXXXXXXXXXXXXXXXXXXXXXXXXXXXXXXXXXXXXXXXXXXXXXXXXXXXXXXXXXXXXXXXXXXXXXXXXXXXXXXXXXXXXXXXXXXXXXXXXXXXXXXXXXXXXXXXXXXXXXXXXXXXXXXXXXXXX

