--------------------------------------------------------------------------------------------------------------------------------------------------------------------------------------------------------
--------------------------------------------------------------------------------------------------------------------------------------------------------------------------------------------------------
--------------------------------------------------------------------------------------------------------------------------------------------------------------------------------------------------------
--------------------------------------------------------------------------------------------------------------------------------------------------------------------------------------------------------
--------------------------------------------------------------------------------------------------------------------------------------------------------------------------------------------------------
--------------------------------------------------------------------------------------------------------------------------------------------------------------------------------------------------------
--------------------------------------------------------------------------------------------------------------------------------------------------------------------------------------------------------
--------------------------------------------------------------------------------------------------------------------------------------------------------------------------------------------------------
--------------------------------------------------------------------------------------------------------------------------------------------------------------------------------------------------------
--------------------------------------------------------------------------------------------------------------------------------------------------------------------------------------------------------
--------------------------------------------------------------------------------------------------------------------------------------------------------------------------------------------------------
--------------------------------------------------------------------------------------------------------------------------------------------------------------------------------------------------------
---------------------------------oooSoo-----------------------------------------------------------------------------ooooo-----Soo------------------------------------------------ooo--------------------
----------------------------------------------------------SoSoooSo---------------------------------------------------------------------------------------------------oSoSSo-------------------oSSS------
-----------------------oooo-------oooo-------------Soo-------------------------------------------------------------ooooo----oooooo----------------------------------------------------------------------
----------------------------------------------------------ooooo-------------------------------ooooo---SoSS----------------------------------------------------------ooooooo------------------ooo--------
---------------------XXXXXXXXXXXXXXXXXXXXXXX-------oo--------g--------------XXXX----oo--------------------------XXXXXXXXXXXXXXXXXXXXXXXXX----------XX-------oo----------------XXXXXXXXXXXX--------------
-----------------XXXXXXXXXXXXXXXXXXXXXXXXXXX------------XXXXXXXXXXX---------XXXXXXX-------XXXXXXXXXX--ooo----XXXXXXXXXXXXXXXXXXXXXXXXXXXX----------XXXXXXX--------XXXXXXXXXXXXXXXXXXXXXXXXXXXXXXXXXX----
------------XXXXXXXXXXXXXXXXXXXXXXXXXXXXXXXXXXXXXXXXXXXXXXXXXXXXXXXXXXXXXXXXXXXXXXXXXXXXXXXXXXXXXXXX---------XXXXXXXXXXXXXXXXXXXXXXXXXXXXXXXXX-----XXXXXXXXXXXXXXXXXXXXXXXXXXXXXXXXXXXXXXXXXXXXXXXXX----
XXXXXXXXXXXXXXXXXXXXXXXXXXXXXXXXXXXXXXXXXXXXXXXXXXXXXXXXXXXXXXXXXXXXXXXXXXXXXXXXXXXXXXXXXXXXXXXXXXXXXXXXXXXXXXXXXXXXXXXXXXXXXXXXXXXXXXXXXXXXXXXXXXXXXXXXXXXXXXXXXXXXXXXXXXXXXXXXXXXXXXXXXXXXXXXXXXXXXXXX

