--------------------------------------------------------------------------------------------------------------------------------------------------------------------------------------------------------
--------------------------------------------------------------------------------------------------------------------------------------------------------------------------------------------------------
--------------------------------------------------------------------------------------------------------------------------------------------------------------------------------------------------------
--------------------------------------------------------------------------------------------------------------------------------------------------------------------------------------------------------
--------------------------------------------------------------------------------------------------------------------------------------------------------------------------------------------------------
--------------------------------------------------------------------------------------------------------------------------------------------------------------------------------------------------------
--------------------------------------------------------------------------------------------------------------------------------------------------------------------------------------------------------
--------------------------------------------------------------------------------------------------------------------------------------------------------------------------------------------------------
--------------------------------------------------------------------------------------------------------------------------------------------------------------------------------------------------------
--------------------------------------------------------------------------------------------------------------------------------------------------------------------------------------------------------
--------------------------------------------------------------------------------------------------------------------------------------------------------------------------------------------------------
--------------------------------------------------------------------------------------------------------------------------------------------------------------------------------------------------------
------------------------------------------------------------------------------------------------------------------------------SooS----------ooo---------------------------Sooo--------------------------
------------------------------------------------------------ooSo------------------------------------------------------------------------------------------ooSo----------------------------oSo-----------
----------------------------------ooS---------------oooo--------------oooo---------------------------------------Soo---------ooo-------------oo--oooo-------------------oooo----------------------------
--------------------oSoo--------------------oSS-------------ooooo-------------------------g----------------------------------------------------------------oooo-----------------------------------------
--------------------------------oooooo-----------XXXXXXXX------------XXXXXXX-------ooo---XXXXXX-------------------oo-------XXXXXXXXX-----XXXXXXXXXXXXXXX---------ooo--XXXXXXXXX------------g--XXXXXXX---
------------------ooooo--XXXXXX------g-----------XXXXXXXXXXXXXXXXXXXXXXXXXXX---XX--------XXXXXX-------oooo-----------------XXXXXXXXXXXXXXXXXXXXXXXXXXXXXXXXXXXXX------XXXXXXXXXXXX------XXXXXXXXXXXXXXXX
-----------XXXXX---------XXXXXXXXXXXXXXXX--------XXXXXXXXXXXXXXXXXXXXXXXXXXXXXXXXXXXXXXXXXXXXXXXXXXXX---------XXXXXXXXXX---XXXXXXXXXXXXXXXXXXXXXXXXXXXXXXXXXXXXXXXXXXXXXXXXXXXXXXXXXXXXXXXXXXXXXXXXXXXXX
XXXXXXXXXXXXXXXXXXXXXXXXXXXXXXXXXXXXXXXXXXXXXXXXXXXXXXXXXXXXXXXXXXXXXXXXXXXXXXXXXXXXXXXXXXXXXXXXXXXXXXXXXXXXXXXXXXXXXXXXXXXXXXXXXXXXXXXXXXXXXXXXXXXXXXXXXXXXXXXXXXXXXXXXXXXXXXXXXXXXXXXXXXXXXXXXXXXXXXXX

