--------------------------------------------------------------------------------------------------------------------------------------------------------------------------------------------------------
--------------------------------------------------------------------------------------------------------------------------------------------------------------------------------------------------------
--------------------------------------------------------------------------------------------------------------------------------------------------------------------------------------------------------
--------------------------------------------------------------------------------------------------------------------------------------------------------------------------------------------------------
--------------------------------------------------------------------------------------------------------------------------------------------------------------------------------------------------------
--------------------------------------------------------------------------------------------------------------------------------------------------------------------------------------------------------
--------------------------------------------------------------------------------------------------------------------------------------------------------------------------------------------------------
--------------------------------------------------------------------------------------------------------------------------------------------------------------------------------------------------------
--------------------------------------------------------------------------------------------------------------------------------------------------------------------------------------------------------
--------------------------------------------------------------------------------------------------------------------------------------------------------------------------------------------------------
--------------------------------------------------------------------------------------------------------------------------------------------------------------------------------------------------------
--------------------------------------------------------------------------------------------------------------------------------------------------------------------------------------------------------
---------------------------------------------------------------------------------------------------------------------------------------------------------------------------oSo--------------------------
---------------------Sooo------------------------------------------------oooS--------------------------------------------------------------------------------------ooo-------------------------oooooo---
----------------------------------------------------------SoS---------------------oooo-------------------------------------------------------------------ooo----------------oo------------ooo-----------
----------------------ooooo---oSSS--------ooooo-------------------------ooooooo------------------------------SSoSoo------------------SooooS------------------------ooo--------------------------ooooo---
XXXXXXXXXX--XXX-----------------------------------g--------oo--------------------oooooo--XXXXXXXX----XXXX---------------------------------------oooo----oooooo-----------XXXXXX---------oo--------------
XXXXXXXXXX--XXX----XXXXXXXXXX--ooo------XXXXXXXXXXXXXXX----------XXXXXXXXXXXXXXX-------g-XXXXXXXX----XXXX---oooooo-------XXX--------ooooooooo-----g----------g----XXXXXXXXXXXXX---------g-----XXXXXXXX--
XXXXXXXXXXXXXXXXXXXXXXXXXXXXX-----------XXXXXXXXXXXXXXXXXXXXXXXXXXXXXXXXXXXXXXXXXXXXXXXXXXXXXXXXX----XXXX-----------XXXXXXXXXXXXXXX-----------XXXXXXXXXXXXXXXXXXXXXXXXXXXXXXXXX-------XXXXXXXXXXXXXXXXXX
XXXXXXXXXXXXXXXXXXXXXXXXXXXXXXXXXXXXXXXXXXXXXXXXXXXXXXXXXXXXXXXXXXXXXXXXXXXXXXXXXXXXXXXXXXXXXXXXXXXXXXXXXXXXXXXXXXXXXXXXXXXXXXXXXXXXXXXXXXXXXXXXXXXXXXXXXXXXXXXXXXXXXXXXXXXXXXXXXXXXXXXXXXXXXXXXXXXXXXXX

