--------------------------------------------------------------------------------------------------------------------------------------------------------------------------------------------------------
--------------------------------------------------------------------------------------------------------------------------------------------------------------------------------------------------------
--------------------------------------------------------------------------------------------------------------------------------------------------------------------------------------------------------
--------------------------------------------------------------------------------------------------------------------------------------------------------------------------------------------------------
--------------------------------------------------------------------------------------------------------------------------------------------------------------------------------------------------------
--------------------------------------------------------------------------------------------------------------------------------------------------------------------------------------------------------
--------------------------------------------------------------------------------------------------------------------------------------------------------------------------------------------------------
--------------------------------------------------------------------------------------------------------------------------------------------------------------------------------------------------------
--------------------------------------------------------------------------------------------------------------------------------------------------------------------------------------------------------
--------------------------------------------------------------------------------------------------------------------------------------------------------------------------------------------------------
--------------------------------------------------------------------------------------------------------------------------------------------------------------------------------------------------------
--------------------------------------------------------------------------------------------------------------------------------------------------------------------------------------------------------
----------------oSoSoo-----------------------------------------------------------------------------oSoooSoo---------------------------------------------------------------oooooo------------------------
-----------------------------------------------------------------------------------------------------------------------------------------------------------------------------------------Soo------------
---------------oooooo------------------------------------------------------oSoSooo----------oo-------ooooo-------------------oo-------------------------------------------------------------------------
-----------------------------------------------oooooo-------------------------------------------------------------------------------------------ooSo----------------------------------------------------
--------------XXXXXXXXXXX--XX-------XXXXX-------------XXXXXXXXXX----XXXXX---oooo-----------XXXXXXXXXXXXXXXXXXXX---XXX----XXXXXXXXX---------------------------------------XXXXXXXX------------XXX--------
XXXXXXXXXXXXXXXXXXXXXXXXXXXXX-------XXXXX-----XXXXXXXXXXXXXXXXXXXXXXXXXXX------------------XXXXXXXXXXXXXXXXXXXX---XXX----XXXXXXXXX--------XXXX--------XXXXXXX--------oo--XXXXXXXX-----XXXXXXXXXX--XXXXXX
XXXXXXXXXXXXXXXXXXXXXXXXXXXXX---g---XXXXX-----XXXXXXXXXXXXXXXXXXXXXXXXXXXXXXXXXXXXX----XXXXXXXXXXXXXXXXXXXXXXXX---XXXXXXXXXXXXXXXX--XXXXXXXXXX--------XXXXXXX------------XXXXXXXXXXXXXXXXXXXXXXXXXXXXXXX
XXXXXXXXXXXXXXXXXXXXXXXXXXXXXXXXXXXXXXXXXXXXXXXXXXXXXXXXXXXXXXXXXXXXXXXXXXXXXXXXXXXXXXXXXXXXXXXXXXXXXXXXXXXXXXXXXXXXXXXXXXXXXXXXXXXXXXXXXXXXXXXXXXXXXXXXXXXXXXXXXXXXXXXXXXXXXXXXXXXXXXXXXXXXXXXXXXXXXXXX

