--------------------------------------------------------------------------------------------------------------------------------------------------------------------------------------------------------
--------------------------------------------------------------------------------------------------------------------------------------------------------------------------------------------------------
--------------------------------------------------------------------------------------------------------------------------------------------------------------------------------------------------------
--------------------------------------------------------------------------------------------------------------------------------------------------------------------------------------------------------
--------------------------------------------------------------------------------------------------------------------------------------------------------------------------------------------------------
--------------------------------------------------------------------------------------------------------------------------------------------------------------------------------------------------------
--------------------------------------------------------------------------------------------------------------------------------------------------------------------------------------------------------
--------------------------------------------------------------------------------------------------------------------------------------------------------------------------------------------------------
--------------------------------------------------------------------------------------------------------------------------------------------------------------------------------------------------------
--------------------------------------------------------------------------------------------------------------------------------------------------------------------------------------------------------
--------------------------------------------------------------------------------------------------------------------------------------------------------------------------------------------------------
--------------------------------------------------------------------------------------------------------------------------------------------------------------------------------------------------------
----------------------------------------------------ooSoo---------------------------------------------------------oSSS--------ooSo---------------------------------------oooo---------------------------
--------------------------------------------------------------------------------------------------------------------------------------------------------------------------------------------------------
--------------------Soo--------ooSo-----------------oooo-------ooo--------------------------------------oooooo----oooo--------ooooo----oooSSSo-----oSo------------------ooooooo----------ooo------------
-----------------------------------------------------------------------SoSS-------------------------------------------------------g----------------------------------------g------------------g---------
XXXXXXXXXXXX--------oooo----oooooooo---------------XXXXXXXXXXXXXXXX---------------------XXXXX---------XXXXXXXXXXXXXXXXXXXX--XXXXXXXXXX-oooooooo----oo---------------XXXXXXXXXXXXX--XXXXXXXXXXXXX--------
XXXXXXXXXXXX-------------g-------------------------XXXXXXXXXXXXXXXX---ooooo-------------XXXXXXXX------XXXXXXXXXXXXXXXXXXXX--XXXXXXXXXX----g--------------oo---XXXXXXXXXXXXXXXXXXX--XXXXXXXXXXXXX--------
XXXXXXXXXXXX------XXXXXXXXXXXXXXXXXXXX-----XXXXXXXXXXXXXXXXXXXXXXXX----------XX-----XXXXXXXXXXXX------XXXXXXXXXXXXXXXXXXXXXXXXXXXXXXXXXXXXXXXXXXXXXXXXXX------XXXXXXXXXXXXXXXXXXXXXXXXXXXXXXXXXX--------
XXXXXXXXXXXXXXXXXXXXXXXXXXXXXXXXXXXXXXXXXXXXXXXXXXXXXXXXXXXXXXXXXXXXXXXXXXXXXXXXXXXXXXXXXXXXXXXXXXXXXXXXXXXXXXXXXXXXXXXXXXXXXXXXXXXXXXXXXXXXXXXXXXXXXXXXXXXXXXXXXXXXXXXXXXXXXXXXXXXXXXXXXXXXXXXXXXXXXXXX

