--------------------------------------------------------------------------------------------------------------------------------------------------------------------------------------------------------
--------------------------------------------------------------------------------------------------------------------------------------------------------------------------------------------------------
--------------------------------------------------------------------------------------------------------------------------------------------------------------------------------------------------------
--------------------------------------------------------------------------------------------------------------------------------------------------------------------------------------------------------
--------------------------------------------------------------------------------------------------------------------------------------------------------------------------------------------------------
--------------------------------------------------------------------------------------------------------------------------------------------------------------------------------------------------------
--------------------------------------------------------------------------------------------------------------------------------------------------------------------------------------------------------
--------------------------------------------------------------------------------------------------------------------------------------------------------------------------------------------------------
--------------------------------------------------------------------------------------------------------------------------------------------------------------------------------------------------------
--------------------------------------------------------------------------------------------------------------------------------------------------------------------------------------------------------
--------------------------------------------------------------------------------------------------------------------------------------------------------------------------------------------------------
--------------------------------------------------------------------------------------------------------------------------------------------------------------------------------------------------------
-----------------------------ooSoo------------------------------oSooSSSS--------SoSoooo-----------------------------------------------------------------------------------------------------------------
------------------------------------------------------------------------------------------------------------------ooooo------------------------------------------SooSooS--------------------------------
----------------------------------------------------------------oooooo----------oooooooo----------------------------------------------------ooooooo-----------------------------------------------------
------------oooo---------------------------------ooooo------------------------------------ooooo---------oSooo------ooo---------------SoSS-------------------------ooooo----ooo--------------------------
XXXXXXXXXX----------XX------XXXXXXXXXXXXXXXXX----------XXXX----XXXXXXXXXXXXXXXXXXXXXXXXXX-----g----------------------------ooo--------------oooo------ooooo-XXX---------g-------XXXXX-------------------
XXXXXXXXXX----ooooo-XX------XXXXXXXXXXXXXXXXXXXXXXXXXXXXXXXXXXXXXXXXXXXXXXXXXXXXXXXXXXXXXXXXXXXXXX-------oooo--XXXXXXXXXXX------------oo--------------------XXXXXXXXXXXXXXXXXXXXXXXXX-------------------
XXXXXXXXXX----------XX------XXXXXXXXXXXXXXXXXXXXXXXXXXXXXXXXXXXXXXXXXXXXXXXXXXXXXXXXXXXXXXXXXXXXXXXX-----g-----XXXXXXXXXXXXXXXXXXX----g----XXXXXXXXXXXXXXXXXXXXXXXXXXXXXXXXXXXXXXXXXXXXXXX--------XXXXXX
XXXXXXXXXXXXXXXXXXXXXXXXXXXXXXXXXXXXXXXXXXXXXXXXXXXXXXXXXXXXXXXXXXXXXXXXXXXXXXXXXXXXXXXXXXXXXXXXXXXXXXXXXXXXXXXXXXXXXXXXXXXXXXXXXXXXXXXXXXXXXXXXXXXXXXXXXXXXXXXXXXXXXXXXXXXXXXXXXXXXXXXXXXXXXXXXXXXXXXXX

