--------------------------------------------------------------------------------------------------------------------------------------------------------------------------------------------------------
--------------------------------------------------------------------------------------------------------------------------------------------------------------------------------------------------------
--------------------------------------------------------------------------------------------------------------------------------------------------------------------------------------------------------
--------------------------------------------------------------------------------------------------------------------------------------------------------------------------------------------------------
--------------------------------------------------------------------------------------------------------------------------------------------------------------------------------------------------------
--------------------------------------------------------------------------------------------------------------------------------------------------------------------------------------------------------
--------------------------------------------------------------------------------------------------------------------------------------------------------------------------------------------------------
--------------------------------------------------------------------------------------------------------------------------------------------------------------------------------------------------------
--------------------------------------------------------------------------------------------------------------------------------------------------------------------------------------------------------
--------------------------------------------------------------------------------------------------------------------------------------------------------------------------------------------------------
--------------------------------------------------------------------------------------------------------------------------------------------------------------------------------------------------------
--------------------------------------------------------------------------------------------------------------------------------------------------------------------------------------------------------
-----------------------------------------------------------------------------------------------------ooSoooSSo----------------------Sooooo---------------------oSoo-----------SSooo---------------------
----------------------------------------------------------------------------------SooS------------------------------------------------------------------------------------------------------------------
-----------------------------------ooooo----------------------------------------------------------------oooooo-----------------------ooo------oo----ooo--------oo------------ooooo---------oSooSo-------
-----------------ooS---------------------------oSS---------------------------oo--ooooo------oSSooo----------g-------------------------------------------------------------------------------------------
---------------------------------oooooooo---------------------------XXX------g----------------------XXXXXXXXXXX---------------XXXXXXXXXXXXXXXXXXXXX--ooo--XXXXXXXXXX--------XXXXXXXXX-------ooooo-------
XXXXXXXXXXXXX-----------XXXXXX----------------oooo-----ooo-----ooo--XXXXXXXXXXXXXXXXXXXXX----oooo---XXXXXXXXXXX---oooo------XXXXXXXXXXXXXXXXXXXXXXX-------XXXXXXXXXX--------XXXXXXXXX-----------------XX
XXXXXXXXXXXXX-----------XXXXXXXXXXXXXXXXXXX-------------------------XXXXXXXXXXXXXXXXXXXXX-----------XXXXXXXXXXX-g-----------XXXXXXXXXXXXXXXXXXXXXXXXXXXXXXXXXXXXXXXXXXXXXXXXXXXXXXXXXXXXXXXXXXXXXXXXXXXX
XXXXXXXXXXXXXXXXXXXXXXXXXXXXXXXXXXXXXXXXXXXXXXXXXXXXXXXXXXXXXXXXXXXXXXXXXXXXXXXXXXXXXXXXXXXXXXXXXXXXXXXXXXXXXXXXXXXXXXXXXXXXXXXXXXXXXXXXXXXXXXXXXXXXXXXXXXXXXXXXXXXXXXXXXXXXXXXXXXXXXXXXXXXXXXXXXXXXXXXX

