--------------------------------------------------------------------------------------------------------------------------------------------------------------------------------------------------------
--------------------------------------------------------------------------------------------------------------------------------------------------------------------------------------------------------
--------------------------------------------------------------------------------------------------------------------------------------------------------------------------------------------------------
--------------------------------------------------------------------------------------------------------------------------------------------------------------------------------------------------------
--------------------------------------------------------------------------------------------------------------------------------------------------------------------------------------------------------
--------------------------------------------------------------------------------------------------------------------------------------------------------------------------------------------------------
--------------------------------------------------------------------------------------------------------------------------------------------------------------------------------------------------------
--------------------------------------------------------------------------------------------------------------------------------------------------------------------------------------------------------
--------------------------------------------------------------------------------------------------------------------------------------------------------------------------------------------------------
--------------------------------------------------------------------------------------------------------------------------------------------------------------------------------------------------------
--------------------------------------------------------------------------------------------------------------------------------------------------------------------------------------------------------
--------------------------------------------------------------------------------------------------------------------------------------------------------------------------------------------------------
---------------------------------------------------------------------------------------------------------------------------------------------------------ooSoo-------------ooo--------------------------
-------------------------------------------------------------------------------------------------------------------------------oSooo--------------------------------------------------------------------
--------------------------------------------oooSoo----ooo---------------------------------------------------SSSSoo-----------------------------------------ooo------------oo----ooo---------------ooSoo-
----------------oooSS-----------oooSo--------------------------------------ooooo----oooSoo-------ooooSSo----------------------ooooooooo--oSSoo----------g-----------------------------------------------
--------------------------------------------ooooo------------------------------------------XX----------------oooooo----------------------------------XXXXXXXXXXXXXXXX----XXXXXXXXXXXX-oo----------------
---------------oooo--------------oo---XXXXX-------------g-----XXXXXX----XXXXXXXXX---oooooo-XX-------ooo----------------------XXXXXXXXXXX---oo----XXXXXXXXXXXXXXXXXXXX----XXXXXXXXXXXX-------------g-----
XXXXXXXXXXXXXX---------XXXXXXX--------XXXXXXXXXXXXXXXXXXXXXXXXXXXXXX----XXXXXXXXX----------XX-------------XXXXXXXXXXX----XXXXXXXXXXXXXXX---------XXXXXXXXXXXXXXXXXXXXXXXXXXXXXXXXXXXXXXXXXXXXXXXXXXXXXXX
XXXXXXXXXXXXXXXXXXXXXXXXXXXXXXXXXXXXXXXXXXXXXXXXXXXXXXXXXXXXXXXXXXXXXXXXXXXXXXXXXXXXXXXXXXXXXXXXXXXXXXXXXXXXXXXXXXXXXXXXXXXXXXXXXXXXXXXXXXXXXXXXXXXXXXXXXXXXXXXXXXXXXXXXXXXXXXXXXXXXXXXXXXXXXXXXXXXXXXXX

