--------------------------------------------------------------------------------------------------------------------------------------------------------------------------------------------------------
--------------------------------------------------------------------------------------------------------------------------------------------------------------------------------------------------------
--------------------------------------------------------------------------------------------------------------------------------------------------------------------------------------------------------
--------------------------------------------------------------------------------------------------------------------------------------------------------------------------------------------------------
--------------------------------------------------------------------------------------------------------------------------------------------------------------------------------------------------------
--------------------------------------------------------------------------------------------------------------------------------------------------------------------------------------------------------
--------------------------------------------------------------------------------------------------------------------------------------------------------------------------------------------------------
--------------------------------------------------------------------------------------------------------------------------------------------------------------------------------------------------------
--------------------------------------------------------------------------------------------------------------------------------------------------------------------------------------------------------
--------------------------------------------------------------------------------------------------------------------------------------------------------------------------------------------------------
--------------------------------------------------------------------------------------------------------------------------------------------------------------------------------------------------------
--------------------------------------------------------------------------------------------------------------------------------------------------------------------------------------------------------
---------------------------oooo---------------------------------oSSoo-----------------------------------------------------------------------------------------------------------------------------------
-------------------------------------Soo-------------------------------------------ooSoooSo-------------------oooo--------------------------------------------------------------------------------------
---------------------------ooooooo------------------------SSo-------------------------------------------------------------------------------------------------------------------------------------------
--------------------------------------oo----------------------------------------------oooo---ooo----------------oo------oSSooooo------------------------------oo----------------------SSSo--------------
---------------------XXXXXXXXXXXXXX-----------------------ooo--XXXXXXXX-------XXXX--------------------------------------------------------------XXXX--------------XXXXXXXX------------------------XXXXXX
XXXXXXXXXXXXXXXXXXXXXXXXXXXXXXXXXXXXXXXXXXX--------XXXX--------XXXXXXXX-------XXXXXXXXXXXXXXXXXXXXX---------XXXXXXXXXX--ooooo----XXXXXX------g--XXXX----oo-XXXXXXXXXXXXXXX----XXXXX---ooo---XXXXXXXXXXXX
XXXXXXXXXXXXXXXXXXXXXXXXXXXXXXXXXXXXXXXXXXX--------XXXXXXXXXXXXXXXXXXXXXXXXXXXXXXXXXXXXXXXXXXXXXXXX-----XXXXXXXXXXXXXX-----------XXXXXXXXXXXXXXXXXXX-------XXXXXXXXXXXXXXX----XXXXX---------XXXXXXXXXXXX
XXXXXXXXXXXXXXXXXXXXXXXXXXXXXXXXXXXXXXXXXXXXXXXXXXXXXXXXXXXXXXXXXXXXXXXXXXXXXXXXXXXXXXXXXXXXXXXXXXXXXXXXXXXXXXXXXXXXXXXXXXXXXXXXXXXXXXXXXXXXXXXXXXXXXXXXXXXXXXXXXXXXXXXXXXXXXXXXXXXXXXXXXXXXXXXXXXXXXXXX

