--------------------------------------------------------------------------------------------------------------------------------------------------------------------------------------------------------
--------------------------------------------------------------------------------------------------------------------------------------------------------------------------------------------------------
--------------------------------------------------------------------------------------------------------------------------------------------------------------------------------------------------------
--------------------------------------------------------------------------------------------------------------------------------------------------------------------------------------------------------
--------------------------------------------------------------------------------------------------------------------------------------------------------------------------------------------------------
--------------------------------------------------------------------------------------------------------------------------------------------------------------------------------------------------------
--------------------------------------------------------------------------------------------------------------------------------------------------------------------------------------------------------
--------------------------------------------------------------------------------------------------------------------------------------------------------------------------------------------------------
--------------------------------------------------------------------------------------------------------------------------------------------------------------------------------------------------------
--------------------------------------------------------------------------------------------------------------------------------------------------------------------------------------------------------
--------------------------------------------------------------------------------------------------------------------------------------------------------------------------------------------------------
--------------------------------------------------------------------------------------------------------------------------------------------------------------------------------------------------------
--------------------------------------------------------------------------------------------------SSooSo------------------------------------------------------------------------oSSSoSo-----------------
-------------------ooooSo-----ooooooo------------------------------oSoSS------------------------------------------------ooooooo-------------------------------------------------------------------------
---------------------------------------------------oooooS----------------------------------------ooooooo-------Soooo--------------------ooS---ooSooS-----------------oooSo--------oooo------------------
-------------------ooooo--------oo--------------------------------oooooo---------------------------g---------------------ooo------------------------------------------------------------------SoooS-----
-----------------------------g----------oo----------oooooo-----------g----XXXX-----------------XXXXXXXXXX------oooo------------------XX--------ooooo---------------ooooooo-----XXXXXXXXXXX--------------
------------------XXXXXXXXXXXXXXXXXXXX------XXXX------------oooo-XXXXXXXXXXXXX-----g-----------XXXXXXXXXXXXX---------XXXXXXXXXXX-----XX-----------------XXXXX--------------XXXXXXXXXXXXXXX----ooo-------
XXXXXXXXXXXXX-----XXXXXXXXXXXXXXXXXXXXXXXXXXXXXXXXXXXXXXXXX------XXXXXXXXXXXXX---XXXXXX-----XXXXXXXXXXXXXXXXXXXXXXXXXXXXXXXXXXXXXXXXXXXXXXXXXXXXXXXXXXXXXXXXX-----XXXXXXXXXXXXXXXXXXXXXXXX-----------XXX
XXXXXXXXXXXXXXXXXXXXXXXXXXXXXXXXXXXXXXXXXXXXXXXXXXXXXXXXXXXXXXXXXXXXXXXXXXXXXXXXXXXXXXXXXXXXXXXXXXXXXXXXXXXXXXXXXXXXXXXXXXXXXXXXXXXXXXXXXXXXXXXXXXXXXXXXXXXXXXXXXXXXXXXXXXXXXXXXXXXXXXXXXXXXXXXXXXXXXXXX

