--------------------------------------------------------------------------------------------------------------------------------------------------------------------------------------------------------
--------------------------------------------------------------------------------------------------------------------------------------------------------------------------------------------------------
--------------------------------------------------------------------------------------------------------------------------------------------------------------------------------------------------------
--------------------------------------------------------------------------------------------------------------------------------------------------------------------------------------------------------
--------------------------------------------------------------------------------------------------------------------------------------------------------------------------------------------------------
--------------------------------------------------------------------------------------------------------------------------------------------------------------------------------------------------------
--------------------------------------------------------------------------------------------------------------------------------------------------------------------------------------------------------
--------------------------------------------------------------------------------------------------------------------------------------------------------------------------------------------------------
--------------------------------------------------------------------------------------------------------------------------------------------------------------------------------------------------------
--------------------------------------------------------------------------------------------------------------------------------------------------------------------------------------------------------
--------------------------------------------------------------------------------------------------------------------------------------------------------------------------------------------------------
--------------------------------------------------------------------------------------------------------------------------------------------------------------------------------------------------------
---------------------------------------ooSooo---------------------------------ooSo---------------ooo----SoSSSooo----------ooSSoSo-----------oooooo------------------------------------------------------
--------------------------------------------------------------------------------------------------------------------------------------------------------------ooo---------------------------------------
---------------------------oooSS------ooooo----------------oooSo--------------oooooo---SoSo-------oo------oooo------------oooo----------------ooo-----oooo----------oSooS-------------------------------
-----------------SSo---------------------------------Soo-----------SSooSo-------------------------------------------------------------------------------------------------------------------------------
XXXXXXXXXXXX---------------oooooooo-XXXXXXXXXXXXXX-----------ooo------------XXXXXXXXX-ooooooo-XXXXXXXXXXXXXXXXXXX--------XXXXXXXXX---------XXXXXXXXXXXXXXXX----------oooooo-------------XXXXXX----------
XXXXXXXXXXXX---oooo-----------------XXXXXXXXXXXXXX-oo-------------oooooo----XXXXXXXXX---------XXXXXXXXXXXXXXXXXXX--------XXXXXXXXXXX-ooo---XXXXXXXXXXXXXXXX--XXXXXX--------------XXXXXXXXXXXXX----------
XXXXXXXXXXXXXX------------XXXXXXXXXXXXXXXXXXXXXXXX-------XXXXXXXX--------g--XXXXXXXXXXXXXXXXXXXXXXXXXXXXXXXXXXXXXXXXXXXXXXXXXXXXXXXX-------XXXXXXXXXXXXXXXX--XXXXXXXXXXXXXXXX----XXXXXXXXXXXXXXXXXXXXXXX
XXXXXXXXXXXXXXXXXXXXXXXXXXXXXXXXXXXXXXXXXXXXXXXXXXXXXXXXXXXXXXXXXXXXXXXXXXXXXXXXXXXXXXXXXXXXXXXXXXXXXXXXXXXXXXXXXXXXXXXXXXXXXXXXXXXXXXXXXXXXXXXXXXXXXXXXXXXXXXXXXXXXXXXXXXXXXXXXXXXXXXXXXXXXXXXXXXXXXXXX

