--------------------------------------------------------------------------------------------------------------------------------------------------------------------------------------------------------
--------------------------------------------------------------------------------------------------------------------------------------------------------------------------------------------------------
--------------------------------------------------------------------------------------------------------------------------------------------------------------------------------------------------------
--------------------------------------------------------------------------------------------------------------------------------------------------------------------------------------------------------
--------------------------------------------------------------------------------------------------------------------------------------------------------------------------------------------------------
--------------------------------------------------------------------------------------------------------------------------------------------------------------------------------------------------------
--------------------------------------------------------------------------------------------------------------------------------------------------------------------------------------------------------
--------------------------------------------------------------------------------------------------------------------------------------------------------------------------------------------------------
--------------------------------------------------------------------------------------------------------------------------------------------------------------------------------------------------------
--------------------------------------------------------------------------------------------------------------------------------------------------------------------------------------------------------
--------------------------------------------------------------------------------------------------------------------------------------------------------------------------------------------------------
--------------------------------------------------------------------------------------------------------------------------------------------------------------------------------------------------------
---------------------------------------oSS---------------------------------------------------------------------------------------------------------------------------SSo--------------------------------
------------------------------------------------oooSSo----------ooSo----------------------------------------------------------------------------------------------------------------ooooo---------------
--------------------------------------oooo----------------------------------------------------------------------oo--------oooooo--oSSooSSo--------------------------ooo-----------------------oSo-------
--------------------------------------g--------oooo-------------oooo--ooo------Soooo-----------------oSoS-------------------------------------SoS----oooo----------------------------ooo----------------
-------------XX----XXXX------------XXXXXXXXXX---g------------------------------------------XXXXXXX-----------XXXXXXXXX----oooo----oooooooo----------------XXXXX--XXXXXXXX-------------------------------
-------------XXXXXXXXXX--ooo-------XXXXXXXXXXXXXXXXXXXX----XXXXXXXXXX--------ooooooo-------XXXXXXX-oooooo----XXXXXXXXXXXX-------------------ooooooo-XXXXXXXXXXX--XXXXXXXXXXXXXXXXXXXXXXXXXXX------XXXX--
-------------XXXXXXXXXX---g--------XXXXXXXXXXXXXXXXXXXXXXXXXXXXXXXXXX-----------------XXXXXXXXXXXX-----------XXXXXXXXXXXXXXXXXXXXXXXXXXXXXX-----g---XXXXXXXXXXX--XXXXXXXXXXXXXXXXXXXXXXXXXXXXXXXXXXXXX--
XXXXXXXXXXXXXXXXXXXXXXXXXXXXXXXXXXXXXXXXXXXXXXXXXXXXXXXXXXXXXXXXXXXXXXXXXXXXXXXXXXXXXXXXXXXXXXXXXXXXXXXXXXXXXXXXXXXXXXXXXXXXXXXXXXXXXXXXXXXXXXXXXXXXXXXXXXXXXXXXXXXXXXXXXXXXXXXXXXXXXXXXXXXXXXXXXXXXXXXX

