--------------------------------------------------------------------------------------------------------------------------------------------------------------------------------------------------------
--------------------------------------------------------------------------------------------------------------------------------------------------------------------------------------------------------
--------------------------------------------------------------------------------------------------------------------------------------------------------------------------------------------------------
--------------------------------------------------------------------------------------------------------------------------------------------------------------------------------------------------------
--------------------------------------------------------------------------------------------------------------------------------------------------------------------------------------------------------
--------------------------------------------------------------------------------------------------------------------------------------------------------------------------------------------------------
--------------------------------------------------------------------------------------------------------------------------------------------------------------------------------------------------------
--------------------------------------------------------------------------------------------------------------------------------------------------------------------------------------------------------
--------------------------------------------------------------------------------------------------------------------------------------------------------------------------------------------------------
--------------------------------------------------------------------------------------------------------------------------------------------------------------------------------------------------------
--------------------------------------------------------------------------------------------------------------------------------------------------------------------------------------------------------
--------------------------------------------------------------------------------------------------------------------------------------------------------------------------------------------------------
-------------------------------------------------------------ooSoo-------SSoooo-------------------------------------------------------------------------------------------------------------------------
--------------oooSSoo--------------------------SSoo----------------------------------------------ooooo-----SSo----------oooS----oSoooSSo---ooSoo------------------------------------------Sooo----------
-----------------------------ooooo---------------------------ooooooo---oooooo----ooSoooS----------------------------------------------------------------------------------------oooo--------------------
---------------oooooooo--------------------------oo----ooo----------g----------------------------oooooo---ooooo----------oooo----ooooo------ooooo------ooo--------------Soo---------------oooo----------
----------------------------ooo----XXXXXXXX-----------------XXXXXXXXXXXXXXXXXXXX---ooooo----------------------------------------------g----------------------------------------XXXXXXX-------------oo---
-------------XXXXXXXXXXX-----------XXXXXXXXXXXXXXXXX---ooo--XXXXXXXXXXXXXXXXXXXX-----------XXXXXXXXXXXXXXXXXXXXXXX-----XXXXXXXXXXXXXXXXXXXXXXXXXXXX-ooooo--XXXX------ooooooo---XXXXXXXXXXXXXXXXX--------
-------------XXXXXXXXXXXXXXXXXXXXXXXXXXXXXXXXXXXXXXX---g----XXXXXXXXXXXXXXXXXXXXXXXXXXXXXXXXXXXXXXXXXXXXXXXXXXXXXX-----XXXXXXXXXXXXXXXXXXXXXXXXXXXX--------XXXX----------------XXXXXXXXXXXXXXXXXXXXXXX--
XXXXXXXXXXXXXXXXXXXXXXXXXXXXXXXXXXXXXXXXXXXXXXXXXXXXXXXXXXXXXXXXXXXXXXXXXXXXXXXXXXXXXXXXXXXXXXXXXXXXXXXXXXXXXXXXXXXXXXXXXXXXXXXXXXXXXXXXXXXXXXXXXXXXXXXXXXXXXXXXXXXXXXXXXXXXXXXXXXXXXXXXXXXXXXXXXXXXXXXX

