--------------------------------------------------------------------------------------------------------------------------------------------------------------------------------------------------------
--------------------------------------------------------------------------------------------------------------------------------------------------------------------------------------------------------
--------------------------------------------------------------------------------------------------------------------------------------------------------------------------------------------------------
--------------------------------------------------------------------------------------------------------------------------------------------------------------------------------------------------------
--------------------------------------------------------------------------------------------------------------------------------------------------------------------------------------------------------
--------------------------------------------------------------------------------------------------------------------------------------------------------------------------------------------------------
--------------------------------------------------------------------------------------------------------------------------------------------------------------------------------------------------------
--------------------------------------------------------------------------------------------------------------------------------------------------------------------------------------------------------
--------------------------------------------------------------------------------------------------------------------------------------------------------------------------------------------------------
--------------------------------------------------------------------------------------------------------------------------------------------------------------------------------------------------------
--------------------------------------------------------------------------------------------------------------------------------------------------------------------------------------------------------
--------------------------------------------------------------------------------------------------------------------------------------------------------------------------------------------------------
-------------------------------------------------------------------------------------------------------------------------SoSS-----------------------------------------------Soo-------------------------
--------------------------------oSoooo---------------------------------------------------oooo--------------------------------------oooSo-------------------------------------------------------ooo------
--------------------SSSSoo-----------------------------------------------------------------------------------------------ooo-------------------------------------------------ooo----oSo-----------------
-----------------------------------oo-------oSSo-----------------------------oSoo-------ooooo-------------------SoS----------------oooo----------------------------oSoo---------------------ooooooooo---
----------------XX-ooooooo-XXXX-------------------------------XX-----XXXXXXX------------------XXX-----XXX------------XXXXXXXXXXX---------------g-------------XXXXX--------XXXXXXX---ooo--XX-------------
XXXXXXXXXXXXX---XX---------XXXXXXXXXXXXXX-oooooo--XXXXXXXXXXXXXX-----XXXXXXX---ooooo-XXXXXXXXXXXX-----XXX-------oooo-XXXXXXXXXXXXXXXXXXXXXXXXXXXXXXXXXXX-----XXXXX-ooo----XXXXXXX--------XXXXXXXXXXXXXXX
XXXXXXXXXXXXXXXXXXXXXXXXXXXXXXXXXXXXXXXXX---------XXXXXXXXXXXXXXXXXXXXXXXXXX---------XXXXXXXXXXXX-----XXX--XX--------XXXXXXXXXXXXXXXXXXXXXXXXXXXXXXXXXXXXXXXXXXXXX--------XXXXXXXXXXXXXXXXXXXXXXXXXXXXXX
XXXXXXXXXXXXXXXXXXXXXXXXXXXXXXXXXXXXXXXXXXXXXXXXXXXXXXXXXXXXXXXXXXXXXXXXXXXXXXXXXXXXXXXXXXXXXXXXXXXXXXXXXXXXXXXXXXXXXXXXXXXXXXXXXXXXXXXXXXXXXXXXXXXXXXXXXXXXXXXXXXXXXXXXXXXXXXXXXXXXXXXXXXXXXXXXXXXXXXXX

