--------------------------------------------------------------------------------------------------------------------------------------------------------------------------------------------------------
--------------------------------------------------------------------------------------------------------------------------------------------------------------------------------------------------------
--------------------------------------------------------------------------------------------------------------------------------------------------------------------------------------------------------
--------------------------------------------------------------------------------------------------------------------------------------------------------------------------------------------------------
--------------------------------------------------------------------------------------------------------------------------------------------------------------------------------------------------------
--------------------------------------------------------------------------------------------------------------------------------------------------------------------------------------------------------
--------------------------------------------------------------------------------------------------------------------------------------------------------------------------------------------------------
--------------------------------------------------------------------------------------------------------------------------------------------------------------------------------------------------------
--------------------------------------------------------------------------------------------------------------------------------------------------------------------------------------------------------
--------------------------------------------------------------------------------------------------------------------------------------------------------------------------------------------------------
--------------------------------------------------------------------------------------------------------------------------------------------------------------------------------------------------------
--------------------------------------------------------------------------------------------------------------------------------------------------------------------------------------------------------
--------------------------------------------------------------oooooooS-----------------------------------------------------oSSoo------------------------------------------------------------------------
------------------------------------------------------------------------------------------------------------------------------------------------------------------oSSooo--------------------------------
-------------ooo--------oooSSooo----oSS------------------------ooooooo-------oSoSoSooo-------------------------------------oooooo--------ooo------------------------------------------oooSoo-----oooooo-
-------------------------------------------------ooooSoS--------------------------------ooSoSo---ooo--------SSoo---ooooo-------------------------oooooSS------------oo----------------------------------
-----------XXXXXXX--------oooooo------------ooo--------------XXXXXXXXXXX--------oooooo------------------XX----------------XXXXXXXXX----ooooo---------------XXXXXX-----------ooo--------oo-------XXXXXXXX
XXXXXXXXXXXXXXXXXX---------------------------------oooo----XXXXXXXXXXXXX------------------ooo-------oo--XX----oo--XXXXXXXXXXXXXXXXXXXX-g-----------ooooooo-XXXXXXXXXXXXXX-----g--------------XXXXXXXXXXX
XXXXXXXXXXXXXXXXXX-----XXXXXXXXXXXXXXXXXXXXXXXXX-----------XXXXXXXXXXXXXXXXXXXXXXXXXXXX--g--------------XX--------XXXXXXXXXXXXXXXXXXXXXXXXXXXXXX-------g---XXXXXXXXXXXXXXXXXXXXXXXXXXXXXXXXXXXXXXXXXXXXX
XXXXXXXXXXXXXXXXXXXXXXXXXXXXXXXXXXXXXXXXXXXXXXXXXXXXXXXXXXXXXXXXXXXXXXXXXXXXXXXXXXXXXXXXXXXXXXXXXXXXXXXXXXXXXXXXXXXXXXXXXXXXXXXXXXXXXXXXXXXXXXXXXXXXXXXXXXXXXXXXXXXXXXXXXXXXXXXXXXXXXXXXXXXXXXXXXXXXXXXX

