--------------------------------------------------------------------------------------------------------------------------------------------------------------------------------------------------------
--------------------------------------------------------------------------------------------------------------------------------------------------------------------------------------------------------
--------------------------------------------------------------------------------------------------------------------------------------------------------------------------------------------------------
--------------------------------------------------------------------------------------------------------------------------------------------------------------------------------------------------------
--------------------------------------------------------------------------------------------------------------------------------------------------------------------------------------------------------
--------------------------------------------------------------------------------------------------------------------------------------------------------------------------------------------------------
--------------------------------------------------------------------------------------------------------------------------------------------------------------------------------------------------------
--------------------------------------------------------------------------------------------------------------------------------------------------------------------------------------------------------
--------------------------------------------------------------------------------------------------------------------------------------------------------------------------------------------------------
--------------------------------------------------------------------------------------------------------------------------------------------------------------------------------------------------------
--------------------------------------------------------------------------------------------------------------------------------------------------------------------------------------------------------
-----------------------%%%%-----------------------------------------------------------------------------------------------------------------------------------------------------------------------------
-----------------------||||---oooSo---------------------------------------------------------------------------------------------------------------------------------------------------------------------
-----------------------||||-------------------------------------------------------SoSoooo------------------oooo------------------------------------ooooSSSo---------------------------------------------
-----------------------||||-----ooooo------------------------------------------------------------------------------------------------------------------------------------------oooo---------------------
------------------%%%%%%%||---gg----------oSoSo---oooo----------------------------oooooo------------ooo------oo---------------------------------------ooooo-----------------------------ooSoSoS---------
XXXXXXXXXXXXXX----|||||||||--XXXXXXXXX--------------------------------------------------------------g--------g-----------------------------------------------XXXXXX----XX-------oooo-------------------X
XXXXXXXXXXXXXXXXXXXXXXXXXXXXXXXXXXXXXX--ooooooo--XXXXXXXXX----------------------XXXXXXXXXX---------XXXXXXXXXXXXXXXXXXX------ooo---------------oo--XXXXXXXXXXXXXXXXXXXXXXXXXXXX-----------oooooooo------X
XXXXXXXXXXXXXXXXXXXXXXXXXXXXXXXXXXXXXX-----g-----XXXXXXXXXXXXXX---------XXXXXXXXXXXXXXXXXXXXX------XXXXXXXXXXXXXXXXXXX-----g--g-XXXX-----XX-------XXXXXXXXXXXXXXXXXXXXXXXXXXXXXXXXXXXXX-----------XXXXXX
XXXXXXXXXXXXXXXXXXXXXXXXXXXXXXXXXXXXXXXXXXXXXXXXXXXXXXXXXXXXXXXXXXXXXXXXXXXXXXXXXXXXXXXXXXXXXXXXXXXXXXXXXXXXXXXXXXXXXXXXXXXXXXXXXXXXXXXXXXXXXXXXXXXXXXXXXXXXXXXXXXXXXXXXXXXXXXXXXXXXXXXXXXXXXXXXXXXXXXXX

