--------------------------------------------------------------------------------------------------------------------------------------------------------------------------------------------------------
--------------------------------------------------------------------------------------------------------------------------------------------------------------------------------------------------------
--------------------------------------------------------------------------------------------------------------------------------------------------------------------------------------------------------
--------------------------------------------------------------------------------------------------------------------------------------------------------------------------------------------------------
--------------------------------------------------------------------------------------------------------------------------------------------------------------------------------------------------------
--------------------------------------------------------------------------------------------------------------------------------------------------------------------------------------------------------
--------------------------------------------------------------------------------------------------------------------------------------------------------------------------------------------------------
--------------------------------------------------------------------------------------------------------------------------------------------------------------------------------------------------------
--------------------------------------------------------------------------------------------------------------------------------------------------------------------------------------------------------
--------------------------------------------------------------------------------------------------------------------------------------------------------------------------------------------------------
--------------------------------------------------------------------------------------------------------------------------------------------------------------------------------------------------------
--------------------------------------------------------------------------------------------------------------------------------------------------------------------------------------------------------
----------------------------------------------------oSoS---oSoo--------------------------------------------------------------------------------oSooS----------------------------------------------------
-------------------------------------------------------------------oooSoSSo-----------------------------------------------------------------------------------------------------------------------------
---------------------------------------------------------------------------------------------------------------ooo-----ooo--oo--------ooo-----ooooooo---------ooS----------------------------ooSoo------
------------------------ooooo-----------------------------------------ooo---------------------ooSoS-----------------------------------------------------------------------------------------------------
---------------------------------------------XXXXXXXXXXXXXXXXXXXXX------------------XXXXX-----------------------oo----ooo--XXXXXXX--XXXXXXXXXXXXXXXXXXXX--------------------------------------oo--------
XXXXXXXXXXXX---------ooooo------ooo-------XXXXXXXXXXXXXXXXXXXXXXXXXXXXXXXXXX--------XXXXX-------ooo---XXXXXXX--------------XXXXXXXXXXXXXXXXXXXXXXXXXXXXXXXX--------XXXXXXXXXXXXXX---XX------------------
XXXXXXXXXXXXXXXXXXXX-------------------XXXXXXXXXXXXXXXXXXXXXXXXXXXXXXXXXXXXXXXXXXXXXXXXXX-------------XXXXXXXXXXXXXXXXXXXXXXXXXXXXXXXXXXXXXXXXXXXXXXXXXXXXXXXXXXXXXXXXXXXXXXXXXXXXXXXXXXXXXXXXXXXXXX----
XXXXXXXXXXXXXXXXXXXXXXXXXXXXXXXXXXXXXXXXXXXXXXXXXXXXXXXXXXXXXXXXXXXXXXXXXXXXXXXXXXXXXXXXXXXXXXXXXXXXXXXXXXXXXXXXXXXXXXXXXXXXXXXXXXXXXXXXXXXXXXXXXXXXXXXXXXXXXXXXXXXXXXXXXXXXXXXXXXXXXXXXXXXXXXXXXXXXXXXX

