--------------------------------------------------------------------------------------------------------------------------------------------------------------------------------------------------------
--------------------------------------------------------------------------------------------------------------------------------------------------------------------------------------------------------
--------------------------------------------------------------------------------------------------------------------------------------------------------------------------------------------------------
--------------------------------------------------------------------------------------------------------------------------------------------------------------------------------------------------------
--------------------------------------------------------------------------------------------------------------------------------------------------------------------------------------------------------
--------------------------------------------------------------------------------------------------------------------------------------------------------------------------------------------------------
--------------------------------------------------------------------------------------------------------------------------------------------------------------------------------------------------------
--------------------------------------------------------------------------------------------------------------------------------------------------------------------------------------------------------
--------------------------------------------------------------------------------------------------------------------------------------------------------------------------------------------------------
--------------------------------------------------------------------------------------------------------------------------------------------------------------------------------------------------------
--------------------------------------------------------------------------------------------------------------------------------------------------------------------------------------------------------
--------------------------------------------------------------------------------------------------------------------------------------------------------------------------------------------------------
---------------------------------------------------------------------------------------ooooo--oSooooooo-------------------------------------------------------------------------------------------------
----------------------------oooS--------SSSo---------------------------------ooSSSSo---------------------------oSoSS------------------------------------------------------oooSSS------------------------
---------------------------------------------------------------------oooo---------------oo-----oooooo--------------------oo----------------------oSoSoSS-------oo---------------------------------------
--------------------------ooooooooo---oooooooo----------------ooooo-----------oooo---------------------------oooooooo--------------------------------------------------------oooo---ooSoooS---------ooo-
----------------------------------------g---------------------------XXXXXXXX---------XXXXXXXXXXXXXXXXXXX----------------XXXXXXX----------ooo-------ooooooo-XXXXXXXXX-------------------------XXX--------
------------XXXX---------XXXXXXXXXXXXXXXXXXXXXXXXXXX----ooo---ooooo-XXXXXXXXXXXXXXXXXXXXXXXXXXXXXXXXXXXX----XXXXXXXXXX--XXXXXXX----------------------------XXXXXXXXX-----XXXXXXXXXX----oo----XXX----ooo-
XXXXXXXXXXXXXXXX---------XXXXXXXXXXXXXXXXXXXXXXXXXXX----------------XXXXXXXXXXXXXXXXXXXXXXXXXXXXXXXXXXXXXXXXXXXXXXXXXX--XXXXXXX---------XXXXXXXXXXXXXXXXXXXXXXXXXXXX-----XXXXXXXXXX--------g-XXX--------
XXXXXXXXXXXXXXXXXXXXXXXXXXXXXXXXXXXXXXXXXXXXXXXXXXXXXXXXXXXXXXXXXXXXXXXXXXXXXXXXXXXXXXXXXXXXXXXXXXXXXXXXXXXXXXXXXXXXXXXXXXXXXXXXXXXXXXXXXXXXXXXXXXXXXXXXXXXXXXXXXXXXXXXXXXXXXXXXXXXXXXXXXXXXXXXXXXXXXXXX

