--------------------------------------------------------------------------------------------------------------------------------------------------------------------------------------------------------
--------------------------------------------------------------------------------------------------------------------------------------------------------------------------------------------------------
--------------------------------------------------------------------------------------------------------------------------------------------------------------------------------------------------------
--------------------------------------------------------------------------------------------------------------------------------------------------------------------------------------------------------
--------------------------------------------------------------------------------------------------------------------------------------------------------------------------------------------------------
--------------------------------------------------------------------------------------------------------------------------------------------------------------------------------------------------------
--------------------------------------------------------------------------------------------------------------------------------------------------------------------------------------------------------
--------------------------------------------------------------------------------------------------------------------------------------------------------------------------------------------------------
--------------------------------------------------------------------------------------------------------------------------------------------------------------------------------------------------------
--------------------------------------------------------------------------------------------------------------------------------------------------------------------------------------------------------
--------------------------------------------------------------------------------------------------------------------------------------------------------------------------------------------------------
--------------------------------------------------------------------------------------------------------------------------------------------------------------------------------------------------------
----------------------ooooo----------------------------------------------------------------------------------oSooo----------------------------------------------------oooo------------------------------
--------------------------------------------------------------oooooo------------------------------------------------------------------------------------------------------------------------------------
--------------------oooooo-------oSoS---------------Sooooo---------------------------------------------------ooooooo--------------------------------------SoSooo-----oo------Sooo--------oooo-----------
--------------------------------------------ooS---------------oooooooo---------------------------------Soo--------------oooSSoSoo----oooooo-------------------------------------------------g-----------
-----------XXXXXXXXXXXXXXXXXX---ooooo---------------ooooooo--------------------------oooo-------------------XXXXXXXXX-------------------------------------ooooo-----XXXXXXX---oooo------XXXXXX----------
-----------XXXXXXXXXXXXXXXXXX---------------oooo---------g---XXXXXXXXXX-------------------------------ooo---XXXXXXXXX---oooooooo--XXXXXXXXXX------------------------XXXXXXX-------------XXXXXX----oo-XXX
-----------XXXXXXXXXXXXXXXXXXXXXXXXXXXXXX------g--XXXXXXXXXXXXXXXXXXXXX------------XXXXXXX-----XXXXX--------XXXXXXXXX-------------XXXXXXXXXX---------XXXXXXXXXXXXXXXXXXXXXXXXXXXXXX-----XXXXXX-------XXX
XXXXXXXXXXXXXXXXXXXXXXXXXXXXXXXXXXXXXXXXXXXXXXXXXXXXXXXXXXXXXXXXXXXXXXXXXXXXXXXXXXXXXXXXXXXXXXXXXXXXXXXXXXXXXXXXXXXXXXXXXXXXXXXXXXXXXXXXXXXXXXXXXXXXXXXXXXXXXXXXXXXXXXXXXXXXXXXXXXXXXXXXXXXXXXXXXXXXXXXX

