--------------------------------------------------------------------------------------------------------------------------------------------------------------------------------------------------------
--------------------------------------------------------------------------------------------------------------------------------------------------------------------------------------------------------
--------------------------------------------------------------------------------------------------------------------------------------------------------------------------------------------------------
--------------------------------------------------------------------------------------------------------------------------------------------------------------------------------------------------------
--------------------------------------------------------------------------------------------------------------------------------------------------------------------------------------------------------
--------------------------------------------------------------------------------------------------------------------------------------------------------------------------------------------------------
--------------------------------------------------------------------------------------------------------------------------------------------------------------------------------------------------------
--------------------------------------------------------------------------------------------------------------------------------------------------------------------------------------------------------
--------------------------------------------------------------------------------------------------------------------------------------------------------------------------------------------------------
--------------------------------------------------------------------------------------------------------------------------------------------------------------------------------------------------------
--------------------------------------------------------------------------------------------------------------------------------------------------------------------------------------------------------
--------------------------------------------------------------------------------------------------------------------------------------------------------------------------------------------------------
--------------------------------------------------------------------------------------------------------SoSo-----ooo--------------------------------------------------------------------oooo-------ooS--
-------------------------------------------------------------------------------------oooo--------------------------------------------------------------------------------SooS---------------------------
----------------------------Soooooo--------------ooSSoo------------------------------------------------ooooo--------------------------------------ooo------------oo-------------------------------------
------------------oooSooo----------------oooo-----------------------------oSSo--------oooo-----------------------------ooooo--------oSooo----------------------------------oooo-------------------------
-----------------------------ooo------------------------XXX---------XXXXX----------g-----------------XXXXXXXX--XXXXXX--------XXX-----------------XXXXXX-------XXXXXX---------------oo--XXXXXXXX--XXXXXXX
XXXXXXXXXX--------oooo-------------------ooo------------XXXXXXXXXXXXXXXXX---oooo--XXXXXXXXXXX--ooooo-XXXXXXXXXXXXXXXX--------XXX---oooooo-XXXX---XXXXXXXXX----XXXXXXXXXXXXXXXXXXX------XXXXXXXX--XXXXXXX
XXXXXXXXXX----------------XXXXXXXXXX-----------XXXXXXXXXXXXXXXXXXXXXXXXXX---------XXXXXXXXXXX--------XXXXXXXXXXXXXXXX--------XXX--------g-XXXXXXXXXXXXXXXX----XXXXXXXXXXXXXXXXXXXXXXXXXXXXXXXXXXXXXXXXXX
XXXXXXXXXXXXXXXXXXXXXXXXXXXXXXXXXXXXXXXXXXXXXXXXXXXXXXXXXXXXXXXXXXXXXXXXXXXXXXXXXXXXXXXXXXXXXXXXXXXXXXXXXXXXXXXXXXXXXXXXXXXXXXXXXXXXXXXXXXXXXXXXXXXXXXXXXXXXXXXXXXXXXXXXXXXXXXXXXXXXXXXXXXXXXXXXXXXXXXXX

