--------------------------------------------------------------------------------------------------------------------------------------------------------------------------------------------------------
--------------------------------------------------------------------------------------------------------------------------------------------------------------------------------------------------------
--------------------------------------------------------------------------------------------------------------------------------------------------------------------------------------------------------
--------------------------------------------------------------------------------------------------------------------------------------------------------------------------------------------------------
--------------------------------------------------------------------------------------------------------------------------------------------------------------------------------------------------------
--------------------------------------------------------------------------------------------------------------------------------------------------------------------------------------------------------
--------------------------------------------------------------------------------------------------------------------------------------------------------------------------------------------------------
--------------------------------------------------------------------------------------------------------------------------------------------------------------------------------------------------------
--------------------------------------------------------------------------------------------------------------------------------------------------------------------------------------------------------
--------------------------------------------------------------------------------------------------------------------------------------------------------------------------------------------------------
--------------------------------------------------------------------------------------------------------------------------------------------------------------------------------------------------------
--------------------------------------------------------------------------------------------------------------------------------------------------------------------------------------------------------
--------------oooo-------------------------------------------------SSSoo--------------------------------------------------------oSSoSo-------------------------------------------oooS-------------------
--------------------------------------------------------------------------------------SSo--------ooSo---------------------------------------------------------------------------------------------ooSSo-
--------------ooooo-----------------------------------------------ooooo-----------------------------------ooooS------------------ooo------------------------------------------------oo------------------
-----------------------------------------------------------------------------------ooooo------ooooooo----------------------------------------------------------------Soo----ooo-----------------oooooo--
-----------XXXXXXXXXXXXX-------XXXX----------------XX----------XXXXXXXXXXX---------------------------------ooooo-------------XXXXXXXXXX-----------------------------------------XXXXXXXXX--------g------
-----------XXXXXXXXXXXXX-------XXXX----------------XX----------XXXXXXXXXXX---XXX--XXXXXXXXX--XXXXXXXXXXX----------oo---------XXXXXXXXXX------oo----------XXXXXXXXXX------XXXXXXXXXXXXXXXXXXXXXXXXXXXXXXX
-----------XXXXXXXXXXXXX-------XXXX-------XXXX-----XXXXXXXXXXXXXXXXXXXXXXXXXXXXXXXXXXXXXXXX--XXXXXXXXXXXXXXXXXXXX------------XXXXXXXXXXXXX-------XXXXXXXXXXXXXXXXXX----g-XXXXXXXXXXXXXXXXXXXXXXXXXXXXXXX
XXXXXXXXXXXXXXXXXXXXXXXXXXXXXXXXXXXXXXXXXXXXXXXXXXXXXXXXXXXXXXXXXXXXXXXXXXXXXXXXXXXXXXXXXXXXXXXXXXXXXXXXXXXXXXXXXXXXXXXXXXXXXXXXXXXXXXXXXXXXXXXXXXXXXXXXXXXXXXXXXXXXXXXXXXXXXXXXXXXXXXXXXXXXXXXXXXXXXXXX

