--------------------------------------------------------------------------------------------------------------------------------------------------------------------------------------------------------
--------------------------------------------------------------------------------------------------------------------------------------------------------------------------------------------------------
--------------------------------------------------------------------------------------------------------------------------------------------------------------------------------------------------------
--------------------------------------------------------------------------------------------------------------------------------------------------------------------------------------------------------
--------------------------------------------------------------------------------------------------------------------------------------------------------------------------------------------------------
--------------------------------------------------------------------------------------------------------------------------------------------------------------------------------------------------------
--------------------------------------------------------------------------------------------------------------------------------------------------------------------------------------------------------
--------------------------------------------------------------------------------------------------------------------------------------------------------------------------------------------------------
--------------------------------------------------------------------------------------------------------------------------------------------------------------------------------------------------------
--------------------------------------------------------------------------------------------------------------------------------------------------------------------------------------------------------
--------------------------------------------------------------------------------------------------------------------------------------------------------------------------------------------------------
--------------------------------------------------------------------------------------------------------------------------------------------------------------------------------------------------------
-------------------------------------------------------------------------------------------------------------------------ooo---------------------------------------------------oSoooo----------oooSoSSo-
---------------------------------------------------------------------------------------------------------------ooo---------------------------------------------------oSSoo------------------------------
----------------------------------------Sooo-----ooo----------------------oo----------------------------------------------oo-----SoooSo--------------------------------------------------oSo------oo----
-------------------oSoS-------oooooo---------------------------------------------------------------------------oooo--------------------------------------------------ooooooo----------------------------
-----------XXXXXX------------------------oooo------oo-XXXXXXXXXX----XXXXXXXXXXXXXXX--------XXXX----------XXXXX---------XXXXXX----oooooo----------XXX--------------------------XXXXXXXX----oo--XXXXXXXXXX
-----------XXXXXX--oooooo-----oooooo------------------XXXXXXXXXX----XXXXXXXXXXXXXXX--------XXXX----------XXXXXXXXXXX---XXXXXX---------------XXXXXXXX--oooo--XXX-----XXXXXXXXXXXXXXXXXX--------XXXXXXXXXX
XXXXXXXXXXXXXXXXX--------------------XXXXXXXXXXXXXXXXXXXXXXXXXXX----XXXXXXXXXXXXXXXXX------XXXX-----XXXXXXXXXXXXXXXXXXXXXXXXXXXXXXXXXXXXXXXXXXXXXXXX--------XXX-----XXXXXXXXXXXXXXXXXXXXXXXXXXXXXXXXXXXX
XXXXXXXXXXXXXXXXXXXXXXXXXXXXXXXXXXXXXXXXXXXXXXXXXXXXXXXXXXXXXXXXXXXXXXXXXXXXXXXXXXXXXXXXXXXXXXXXXXXXXXXXXXXXXXXXXXXXXXXXXXXXXXXXXXXXXXXXXXXXXXXXXXXXXXXXXXXXXXXXXXXXXXXXXXXXXXXXXXXXXXXXXXXXXXXXXXXXXXXX

