--------------------------------------------------------------------------------------------------------------------------------------------------------------------------------------------------------
--------------------------------------------------------------------------------------------------------------------------------------------------------------------------------------------------------
--------------------------------------------------------------------------------------------------------------------------------------------------------------------------------------------------------
--------------------------------------------------------------------------------------------------------------------------------------------------------------------------------------------------------
--------------------------------------------------------------------------------------------------------------------------------------------------------------------------------------------------------
--------------------------------------------------------------------------------------------------------------------------------------------------------------------------------------------------------
--------------------------------------------------------------------------------------------------------------------------------------------------------------------------------------------------------
--------------------------------------------------------------------------------------------------------------------------------------------------------------------------------------------------------
--------------------------------------------------------------------------------------------------------------------------------------------------------------------------------------------------------
--------------------------------------------------------------------------------------------------------------------------------------------------------------------------------------------------------
--------------------------------------------------------------------------------------------------------------------------------------------------------------------------------------------------------
--------------------------------------------------------------------------------------------------------------------------------------------------------------------------------------------------------
----------------------------------------SoSSo-----------------------------------------------------------------------------------------------------------------------------------------------------------
-----------------oooS--------------------------------------------------------------------SoSoSo--------------------------------------------------oSoo---------------------------------------------------
--------------------------oooo----------ooo--------------------------------------------------------------------ooo-----------oooSooo---------------------------------SoS------SSo-------------SSoSoo----
---------------ooooooooo-----------------------------------------------oSoo-------------oooo----------------------g----SoS----------------------oooooo--------------------------------------------------
-------------------------XXXXXXX----XXXXXXXXXX---oo-XXXXXX-------XXXXX---------XXXXXXXX----------------oo--XXXXXXXXX-----------ooooooo-------------------------------ooooo---oooo----XXXXXX---ooooo---XX
XXXXXXXXXXXXXXXXXXXXXXXXXXXXXXXX----XXXXXXXXXX------XXXXXX-------XXXXX--oooo---XXXXXXXXXXXXXXXXXXXXXX------XXXXXXXXX-------------------------XXXXXXXXXXXXXXX----------------------g--XXXXXX---g-------XX
XXXXXXXXXXXXXXXXXXXXXXXXXXXXXXXXXXXXXXXXXXXXXXXXXXXXXXXXXXXXXXX--XXXXX---------XXXXXXXXXXXXXXXXXXXXXXXXXXXXXXXXXXXXX--------XXXXXXXXXXX------XXXXXXXXXXXXXXXXXXXXXXXXXXXXXXXXXXXXXXXXXXXXXXXXXXXXXXXXXXX
XXXXXXXXXXXXXXXXXXXXXXXXXXXXXXXXXXXXXXXXXXXXXXXXXXXXXXXXXXXXXXXXXXXXXXXXXXXXXXXXXXXXXXXXXXXXXXXXXXXXXXXXXXXXXXXXXXXXXXXXXXXXXXXXXXXXXXXXXXXXXXXXXXXXXXXXXXXXXXXXXXXXXXXXXXXXXXXXXXXXXXXXXXXXXXXXXXXXXXXX

