--------------------------------------------------------------------------------------------------------------------------------------------------------------------------------------------------------
--------------------------------------------------------------------------------------------------------------------------------------------------------------------------------------------------------
--------------------------------------------------------------------------------------------------------------------------------------------------------------------------------------------------------
--------------------------------------------------------------------------------------------------------------------------------------------------------------------------------------------------------
--------------------------------------------------------------------------------------------------------------------------------------------------------------------------------------------------------
--------------------------------------------------------------------------------------------------------------------------------------------------------------------------------------------------------
--------------------------------------------------------------------------------------------------------------------------------------------------------------------------------------------------------
--------------------------------------------------------------------------------------------------------------------------------------------------------------------------------------------------------
--------------------------------------------------------------------------------------------------------------------------------------------------------------------------------------------------------
--------------------------------------------------------------------------------------------------------------------------------------------------------------------------------------------------------
--------------------------------------------------------------------------------------------------------------------------------------------------------------------------------------------------------
--------------------------------------------------------------------------------------------------------------------------------------------------------------------------------------------------------
--------------------------oooSoo--ooSoSoSSo-----------------------------------------------------ooSS-----------SoSoS-----------------------------------------------------------oSSooSo------------------
---------------------------------------------------------------------------------------------------------------------------------------------------ooS--------------------------------------------------
-----------ooSoooo--------ooo-------oooo---------SSS----------------------------oooSSo-----------oooo-----------ooooooo-----------------------------------------------------------oooooo----------------
-----------------------------------------------------------------oooSS---oooo--------------------------------------------------oooSoSS-------------ooooo----------------oooSo---------------oooooo------
XXXXXXXXXX---oooo-------XXXXXXXXXXXXXXXXXXXX----oooooo-------------------------ooooooo-------XXXXXXXXXXXXXXXXXXXXXXXXXXX---------------------------------XXXXXX---------------XXXXXXXXXXX---------------
XXXXXXXXXX--------------XXXXXXXXXXXXXXXXXXXXXX-------------------oooooo-XXXXXX---------------XXXXXXXXXXXXXXXXXXXXXXXXXXXXXXX---oooooooo-XXXXXXXXXXXXXXXXXXXXXXX---------ooooo-XXXXXXXXXXX--ooooooo------
XXXXXXXXXXXXXXXXXXX-----XXXXXXXXXXXXXXXXXXXXXXXXXXXXXXX-g---------------XXXXXXXXXXXXXXXXXXXXXXXXXXXXXXXXXXXXXXXXXXXXXXXXXXXXXX----------XXXXXXXXXXXXXXXXXXXXXXXXXXXX----------XXXXXXXXXXX----------XXXXX
XXXXXXXXXXXXXXXXXXXXXXXXXXXXXXXXXXXXXXXXXXXXXXXXXXXXXXXXXXXXXXXXXXXXXXXXXXXXXXXXXXXXXXXXXXXXXXXXXXXXXXXXXXXXXXXXXXXXXXXXXXXXXXXXXXXXXXXXXXXXXXXXXXXXXXXXXXXXXXXXXXXXXXXXXXXXXXXXXXXXXXXXXXXXXXXXXXXXXXXX

