--------------------------------------------------------------------------------------------------------------------------------------------------------------------------------------------------------
--------------------------------------------------------------------------------------------------------------------------------------------------------------------------------------------------------
--------------------------------------------------------------------------------------------------------------------------------------------------------------------------------------------------------
--------------------------------------------------------------------------------------------------------------------------------------------------------------------------------------------------------
--------------------------------------------------------------------------------------------------------------------------------------------------------------------------------------------------------
--------------------------------------------------------------------------------------------------------------------------------------------------------------------------------------------------------
--------------------------------------------------------------------------------------------------------------------------------------------------------------------------------------------------------
--------------------------------------------------------------------------------------------------------------------------------------------------------------------------------------------------------
--------------------------------------------------------------------------------------------------------------------------------------------------------------------------------------------------------
--------------------------------------------------------------------------------------------------------------------------------------------------------------------------------------------------------
--------------------------------------------------------------------------------------------------------------------------------------------------------------------------------------------------------
--------------------------------------------------------------------------------------------------------------------------------------------------------------------------------------------------------
-----------------------------Soooo-----oSooo-----------------------------------oSooo-------------------------------------------------------oSooSo--------Soo--------------------------------------------
---------------------oooo---------------------------------------------------------------------------------------oSSo------------------------------------------------------------------------------------
----------------------------ooooooo-----ooo-----ooooS--------ooooooS---ooo-------ooo-------------------------------------------------------oooooo-----oooo----------------------------------------------
-----------------------------------------------------------------------------------------------------------------------------------oSSSoo----------------------------ooooooS-----oooo-------------------
--------------------------XXXXXXXXXXXXXXXXXXX---oooo-----XX--oooooo----oo----XXXXXXXXXX-----------XXXXX-oooo----------XXXX----------------XXXXXXXXXXXXXXXXXXXX---XXX------------------------------------
-----------------XXXXXXXXXXXXXXXXXXXXXXXXXXXX----------XXXX----------------g-XXXXXXXXXXXXXXXXX----XXXXX--------XXXXXXXXXXXXXX-------------XXXXXXXXXXXXXXXXXXXX---XXX----oooo----ooo---XXXXXXXXXX---oo---
------------XXXXXXXXXXXXXXXXXXXXXXXXXXXXXXXXXXXXXXXXXXXXXXXXXXXXXXXXXXXXXXXXXXXXXXXXXXXXXXXXXXXXXXXXXXXXXXXXXXXXXXXXXXXXXXXXXXXXXX--------XXXXXXXXXXXXXXXXXXXXXXXXXX------------------XXXXXXXXXX--------
XXXXXXXXXXXXXXXXXXXXXXXXXXXXXXXXXXXXXXXXXXXXXXXXXXXXXXXXXXXXXXXXXXXXXXXXXXXXXXXXXXXXXXXXXXXXXXXXXXXXXXXXXXXXXXXXXXXXXXXXXXXXXXXXXXXXXXXXXXXXXXXXXXXXXXXXXXXXXXXXXXXXXXXXXXXXXXXXXXXXXXXXXXXXXXXXXXXXXXXX

