--------------------------------------------------------------------------------------------------------------------------------------------------------------------------------------------------------
--------------------------------------------------------------------------------------------------------------------------------------------------------------------------------------------------------
--------------------------------------------------------------------------------------------------------------------------------------------------------------------------------------------------------
--------------------------------------------------------------------------------------------------------------------------------------------------------------------------------------------------------
--------------------------------------------------------------------------------------------------------------------------------------------------------------------------------------------------------
--------------------------------------------------------------------------------------------------------------------------------------------------------------------------------------------------------
--------------------------------------------------------------------------------------------------------------------------------------------------------------------------------------------------------
--------------------------------------------------------------------------------------------------------------------------------------------------------------------------------------------------------
--------------------------------------------------------------------------------------------------------------------------------------------------------------------------------------------------------
--------------------------------------------------------------------------------------------------------------------------------------------------------------------------------------------------------
--------------------------------------------------------------------------------------------------------------------------------------------------------------------------------------------------------
--------------------------------------------------------------------------------------------------------------------------------------------------------------------------------------------------------
--------------------------------------------------------------Soo-----------ooooSoSoo-------------------------------------------------------ooS---------------------------------------------------------
-----------------------------------------------------------------------------------------------oooooSSoo-------------------------------------------------------Sooooo-----------------------------------
-------------------------oSSo---------------------------------ooooo----------ooooooo--------------------------------------------------------oo-----ooSooSSo-------------------oSo----ooSSoooo-----------
----------------------------------ooooSoSSo------------------------------------g---------------oooooo--------ooo-------Sooo-----------------------------------ooooooo-----------------------------------
--------------------------oooo-----------------------------XXXXXXXXXX------XXXXXXXXXXX----XXXX------------------------------------------XXXXXXXXXX--ooooooo-----------XXXXX--ooooo----ooooo------XXX----
-----------------XXXXX-----g-------ooooo----XXXXXX--ooooo--XXXXXXXXXX----g-XXXXXXXXXXX----XXXXXXXXXXXXXXX---oooo-------ooooo---XXX------XXXXXXXXXX----------XXXXXXXXXXXXXXX----------------------XXX----
-----------XXXXXXXXXXXXXXXXXXXXXX-----------XXXXXX---------XXXXXXXXXXXXXXXXXXXXXXXXXXX----XXXXXXXXXXXXXXX----------------------XXXXXXXXXXXXXXXXXXXXXXXXXXXXXXXXXXXXXXXXXXXXXXXXXXXXXXXXXXXXXXXXXXXXXXXXX
XXXXXXXXXXXXXXXXXXXXXXXXXXXXXXXXXXXXXXXXXXXXXXXXXXXXXXXXXXXXXXXXXXXXXXXXXXXXXXXXXXXXXXXXXXXXXXXXXXXXXXXXXXXXXXXXXXXXXXXXXXXXXXXXXXXXXXXXXXXXXXXXXXXXXXXXXXXXXXXXXXXXXXXXXXXXXXXXXXXXXXXXXXXXXXXXXXXXXXXX

