--------------------------------------------------------------------------------------------------------------------------------------------------------------------------------------------------------
--------------------------------------------------------------------------------------------------------------------------------------------------------------------------------------------------------
--------------------------------------------------------------------------------------------------------------------------------------------------------------------------------------------------------
--------------------------------------------------------------------------------------------------------------------------------------------------------------------------------------------------------
--------------------------------------------------------------------------------------------------------------------------------------------------------------------------------------------------------
--------------------------------------------------------------------------------------------------------------------------------------------------------------------------------------------------------
--------------------------------------------------------------------------------------------------------------------------------------------------------------------------------------------------------
--------------------------------------------------------------------------------------------------------------------------------------------------------------------------------------------------------
--------------------------------------------------------------------------------------------------------------------------------------------------------------------------------------------------------
--------------------------------------------------------------------------------------------------------------------------------------------------------------------------------------------------------
---------------------------------------------------------------------------------------%%%--------------------------------------------------------------------------------------------------------------
---------------------------------------------------------------------------------------|||--------------------------------------------------------------------------------------------------------------
--------------------SooSSo-------------------------------------------------------------|||----------------------------------------------------------------ooSSooS------oSS------------------------------
-------------------------------------------------------------------------------oooo----|||-----%%%%%%----------------------------oSSSooo----------SoSooo------------------------------------------------
-------------------oooooo---ooooo----------------SooSoo--------------------------------|||-----||||||----------oooo----------------------------------------oooooo---ooooo-------------------------------
------------------------------------ooSoo-----------------oooo----------------oooooo---|||--g--||||||-------------------Soo-------oooo-------------ooooo------------------------------------------------
XXXXXXXXXXXXXXXXXXXXXXXXXXXXXXXXXX--------------ooooooo-----------XXXXX---------------XXXXXXXXXXXXXXXXX------XXXXXXX---------------------XXXX------------XXXXXXXXXXXXXXXXXXXX---------------------------
XXXXXXXXXXXXXXXXXXXXXXXXXXXXXXXXXX----oo--------------g----ooooo--XXXXX-----XXXXXXXXXXXXXXXXXXXXXXXXXXX------XXXXXXX----oooooo-XXXXXXXXXXXXXX--XXXXXXXXXXXXXXXXXXXXXXXXXXXXXX---------XX--------XXXXXXXX
XXXXXXXXXXXXXXXXXXXXXXXXXXXXXXXXXX------------XXXXXXXXXX----------XXXXX-----XXXXXXXXXXXXXXXXXXXXXXXXXXXXXXXXXXXXXXXX-----g-----XXXXXXXXXXXXXXXXXXXXXXXXXXXXXXXXXXXXXXXXXXXXXX---------XX-----g--XXXXXXXX
XXXXXXXXXXXXXXXXXXXXXXXXXXXXXXXXXXXXXXXXXXXXXXXXXXXXXXXXXXXXXXXXXXXXXXXXXXXXXXXXXXXXXXXXXXXXXXXXXXXXXXXXXXXXXXXXXXXXXXXXXXXXXXXXXXXXXXXXXXXXXXXXXXXXXXXXXXXXXXXXXXXXXXXXXXXXXXXXXXXXXXXXXXXXXXXXXXXXXXXX

