--------------------------------------------------------------------------------------------------------------------------------------------------------------------------------------------------------
--------------------------------------------------------------------------------------------------------------------------------------------------------------------------------------------------------
--------------------------------------------------------------------------------------------------------------------------------------------------------------------------------------------------------
--------------------------------------------------------------------------------------------------------------------------------------------------------------------------------------------------------
--------------------------------------------------------------------------------------------------------------------------------------------------------------------------------------------------------
--------------------------------------------------------------------------------------------------------------------------------------------------------------------------------------------------------
--------------------------------------------------------------------------------------------------------------------------------------------------------------------------------------------------------
--------------------------------------------------------------------------------------------------------------------------------------------------------------------------------------------------------
--------------------------------------------------------------------------------------------------------------------------------------------------------------------------------------------------------
--------------------------------------------------------------------------------------------------------------------------------------------------------------------------------------------------------
--------------------------------------------------------------------------------------------------------------------------------------------------------------------------------------------------------
--------------------------------------------------------------------------------------------------------------------------------------------------------------------------------------------------------
----------------------------------------------------------------------------------Sooooooo---------------------------------------------------------oooSoo-----------------------------------------------
---------------------------------------------------------------------------------------------oSoS----------------------------------------oSoS-------------------oSSoo------------------oSSo-------------
------------ooo--------------ooo--------------------ooSoo------------------------ooooooooo--------------------------SSo-----------------------------ooooo-----------------------------------------------
------------------oooo---------------------------------------------ooSooo--------------------oo----------oooSo--------------------------oooooo-------------------ooooo------oSS-----ooooooooo-----------
----------XXXXXXX------XXXXXXXXXX-----XXXXX--g------oo----XXXX------------------XXXXXXXXXXX--------XXX------------------------------------------XXXXXXXXXXXX------g-------------------------------------
----------XXXXXXX------XXXXXXXXXXXXXXXXXXXXXXXXXXXX-------XXXX-----oooooo---XXXXXXXXXXXXXXXXXXXXXXXXXX----oo-----------------XXXXXXXXXXXXXXXXXXXXXXXXXXXXXXX---XXXXXXXXXX---oooo---XXXXXXXXXXX----------
XXXXXXXXXXXXXXXXX------XXXXXXXXXXXXXXXXXXXXXXXXXXXXXXXXXXXXXXXXXX-----------XXXXXXXXXXXXXXXXXXXXXXXXXX---------XXXXXXXXXXXXXXXXXXXXXXXXXXXXXXXXXXXXXXXXXXXXX---XXXXXXXXXX----------XXXXXXXXXXXXXXXXXXXXX
XXXXXXXXXXXXXXXXXXXXXXXXXXXXXXXXXXXXXXXXXXXXXXXXXXXXXXXXXXXXXXXXXXXXXXXXXXXXXXXXXXXXXXXXXXXXXXXXXXXXXXXXXXXXXXXXXXXXXXXXXXXXXXXXXXXXXXXXXXXXXXXXXXXXXXXXXXXXXXXXXXXXXXXXXXXXXXXXXXXXXXXXXXXXXXXXXXXXXXXX

