--------------------------------------------------------------------------------------------------------------------------------------------------------------------------------------------------------
--------------------------------------------------------------------------------------------------------------------------------------------------------------------------------------------------------
--------------------------------------------------------------------------------------------------------------------------------------------------------------------------------------------------------
--------------------------------------------------------------------------------------------------------------------------------------------------------------------------------------------------------
--------------------------------------------------------------------------------------------------------------------------------------------------------------------------------------------------------
--------------------------------------------------------------------------------------------------------------------------------------------------------------------------------------------------------
--------------------------------------------------------------------------------------------------------------------------------------------------------------------------------------------------------
--------------------------------------------------------------------------------------------------------------------------------------------------------------------------------------------------------
--------------------------------------------------------------------------------------------------------------------------------------------------------------------------------------------------------
--------------------------------------------------------------------------------------------------------------------------------------------------------------------------------------------------------
--------------------------------------------------------------------------------------------------------------------------------------------------------------------------------------------------------
--------------------------------------------------------------------------------------------------------------------------------------------------------------------------------------------------------
-----------------------------------------------------------------------------------------------Soo------------------------------------------------------------------------------oSoooo------------------
-----------------------------------------------------------------------------------------------------------------------------------------ooSooSo--------------------------------------------------------
----------------------------------oooo--------------------------------------------------------oooooo----Soooo----------------------------------------ooooo----------------------ooooo----------------oo-
---------------------------------------------------------ooooooo--oSSooo---oSoSSo---------------------------------------------------------oooooo--------------SoSo-----oSSS-----------------------------
---------------------------------XXXXXX----------------------------------------------------XXXXXXXXXX-oooooo-----------------XX----------g---g---XX-oooooo-------------------XXXXXXXXXXX---------XXXXXXX
------------ooo------------------XXXXXX-----------oo----XXXXXXXXX-oooo------ooo---------XXXXXXXXXXXXX----------XXX--oo-------XX--------XXXXXXXXXXXX---------oooooooo--oooooo-XXXXXXXXXXX----g----XXXXXXX
-------------gg--XXXXXXXXXX------XXXXXX---------------g-XXXXXXXXX-gg-g------------------XXXXXXXXXXXXXXXXXXXXXXXXXX-----------XX--------XXXXXXXXXXXXXXXXXXXX----g-------------XXXXXXXXXXXXXXXXXXXXXXXXXXX
XXXXXXXXXXXXXXXXXXXXXXXXXXXXXXXXXXXXXXXXXXXXXXXXXXXXXXXXXXXXXXXXXXXXXXXXXXXXXXXXXXXXXXXXXXXXXXXXXXXXXXXXXXXXXXXXXXXXXXXXXXXXXXXXXXXXXXXXXXXXXXXXXXXXXXXXXXXXXXXXXXXXXXXXXXXXXXXXXXXXXXXXXXXXXXXXXXXXXXXX

