--------------------------------------------------------------------------------------------------------------------------------------------------------------------------------------------------------
--------------------------------------------------------------------------------------------------------------------------------------------------------------------------------------------------------
--------------------------------------------------------------------------------------------------------------------------------------------------------------------------------------------------------
--------------------------------------------------------------------------------------------------------------------------------------------------------------------------------------------------------
--------------------------------------------------------------------------------------------------------------------------------------------------------------------------------------------------------
--------------------------------------------------------------------------------------------------------------------------------------------------------------------------------------------------------
--------------------------------------------------------------------------------------------------------------------------------------------------------------------------------------------------------
--------------------------------------------------------------------------------------------------------------------------------------------------------------------------------------------------------
--------------------------------------------------------------------------------------------------------------------------------------------------------------------------------------------------------
--------------------------------------------------------------------------------------------------------------------------------------------------------------------------------------------------------
--------------------------------------------------------------------------------------------------------------------------------------------------------------------------------------------------------
--------------------------------------------------------------------------------------------------------------------------------------------------------------------------------------------------------
---------------------------------------------------------------------------------------------------------------------------------------------------------------------------------------------------Sooo-
-----------------------------------------oooooSo--------------------------------------------------------------------------------------------------------------------------------------------------------
--------------------------------------------------------------------ooo----------------ooSo-----ooSo-------------------------------ooo--------------------ooo---------------------------------------oo--
---------------------oooo----------------oooo-----ooS--------------------------ooS-----------------------------------ooo-----------------------------------------------oSoo------------oooo-------------
-------------------------------XXXX----------------------------------ooooo------------oooo------ooooo-----XXXXXXXXXX-------------------------------------oooooo-XXXXX----------------------------XXXXXXX
XXXXXXXXXXXXX-oo---XXXXXXXXXXXXXXXX---XXXXXXXXXXX----ooo----------------------oooo------------------------XXXXXXXXXX-----------------------oooo-----XX--g-------XXXXX---------------XXXXXXXXXXXXXXXXXXXX
XXXXXXXXXXXXX------XXXXXXXXXXXXXXXXXXXXXXXXXXXXXX--------XXXXX---XXXXXXXXXXXX-------XXXXXXXXXXXXXXXXXXXXXXXXXXXXXXXX-------------XXXXXXXX--g--------XXXXXXXXXXXXXXXXX----g---XXXXXXXXXXXXXXXXXXXXXXXXXXX
XXXXXXXXXXXXXXXXXXXXXXXXXXXXXXXXXXXXXXXXXXXXXXXXXXXXXXXXXXXXXXXXXXXXXXXXXXXXXXXXXXXXXXXXXXXXXXXXXXXXXXXXXXXXXXXXXXXXXXXXXXXXXXXXXXXXXXXXXXXXXXXXXXXXXXXXXXXXXXXXXXXXXXXXXXXXXXXXXXXXXXXXXXXXXXXXXXXXXXXX

