--------------------------------------------------------------------------------------------------------------------------------------------------------------------------------------------------------
--------------------------------------------------------------------------------------------------------------------------------------------------------------------------------------------------------
--------------------------------------------------------------------------------------------------------------------------------------------------------------------------------------------------------
--------------------------------------------------------------------------------------------------------------------------------------------------------------------------------------------------------
--------------------------------------------------------------------------------------------------------------------------------------------------------------------------------------------------------
--------------------------------------------------------------------------------------------------------------------------------------------------------------------------------------------------------
--------------------------------------------------------------------------------------------------------------------------------------------------------------------------------------------------------
--------------------------------------------------------------------------------------------------------------------------------------------------------------------------------------------------------
--------------------------------------------------------------------------------------------------------------------------------------------------------------------------------------------------------
--------------------------------------------------------------------------------------------------------------------------------------------------------------------------------------------------------
--------------------------------------------------------------------------------------------------------------------------------------------------------------------------------------------------------
--------------------------------------------------------------------------------------------------------------------------------------------------------------------------------------------------------
-----------------------------------------ooSooS----------------------------------------------oSSSS----oSSo----------------------------------------------------------------------------------------------
-----------------------------------------------------------------------------------------------------------------oooSSo--------------------------------------------------------------ooS----------------
-----------------------------------------ooooooooo--------------------------------------------oooooo-----ooo--------------------------------------------------------------------------------------------
-----------------ooSSoo-----------ooo--------------------------oSo--------------------oo--------------------g---ooooo---------oSSoooSo----------------ooo-----------------------------oooo--------------
-------------XXX------------oooo--------XXXXXXXXXXX----------------XXXXXXXXX-ooo------------XXXXXXXXXXXXXXXXXX--g------------------------ooooo----------------ooo---------------------------------------
-------------XXX-oooooo---g------XXXXXXXXXXXXXXXXXX--oo--------oo--XXXXXXXXX--------XXXXXXXXXXXXXXXXXXXXXXXXXXXXXXXXXXXX--------ooo------------XXXXXXXXXXXXX-------oooooo-XXXXX----XXXXXXXX--oo--XXXXXXX
-------------XXX----g---XXXXXXXXXXXXXXXXXXXXXXXXXXX----g-----------XXXXXXXXXXXXXXXXXXXXXXXXXXXXXXXXXXXXXXXXXXXXXXXXXXXXXXXXX-----------XXXXXXXXXXXXXXXXXXXXXXXXXXX--------XXXXX--XXXXXXXXXX------XXXXXXX
XXXXXXXXXXXXXXXXXXXXXXXXXXXXXXXXXXXXXXXXXXXXXXXXXXXXXXXXXXXXXXXXXXXXXXXXXXXXXXXXXXXXXXXXXXXXXXXXXXXXXXXXXXXXXXXXXXXXXXXXXXXXXXXXXXXXXXXXXXXXXXXXXXXXXXXXXXXXXXXXXXXXXXXXXXXXXXXXXXXXXXXXXXXXXXXXXXXXXXXX

