--------------------------------------------------------------------------------------------------------------------------------------------------------------------------------------------------------
--------------------------------------------------------------------------------------------------------------------------------------------------------------------------------------------------------
--------------------------------------------------------------------------------------------------------------------------------------------------------------------------------------------------------
--------------------------------------------------------------------------------------------------------------------------------------------------------------------------------------------------------
--------------------------------------------------------------------------------------------------------------------------------------------------------------------------------------------------------
--------------------------------------------------------------------------------------------------------------------------------------------------------------------------------------------------------
--------------------------------------------------------------------------------------------------------------------------------------------------------------------------------------------------------
--------------------------------------------------------------------------------------------------------------------------------------------------------------------------------------------------------
--------------------------------------------------------------------------------------------------------------------------------------------------------------------------------------------------------
--------------------------------------------------------------------------------------------------------------------------------------------------------------------------------------------------------
--------------------------------------------------------------------------------------------------------------------------------------------------------------------------------------------------------
--------------------------------------------------------------------------------------------------------------------------------------------------------------------------------------------------------
--------------------------------------ooooo-----------------------------------------------------------------------------oSoSo-------------SSSooo---oSooSooo------------------ooSo-----------------------
------------------oooo-------SSooSS----------------------------------------------------------------------------------------------------------------------------oooSS------------------------------------
---------------------------------------oooo----------------------------------------oSo------oooo------------------------------------------ooooo---ooooooo-------------------ooo-------------------------
------------------ooooo----oooooooo------------oSSS---------------ooooS--------------------------------------------------------------------------------------ooooo------------g--------------------g----
----------XXXX----g-----------g------XXXXXXXX------------------------------------oooooooo-----------------ooo---------XXXXXXXX-----ooo--XXXXXXXXXXXXXXXXXXXX----g----------XXXXXXXX-------------XXXXXXXX
----------XXXXXXXXXXXXXX--XXXXXXXXXXXXXXXXXXX-ooooo------------oooooooo--------------g-----------XXXXX----------------XXXXXXXX----------XXXXXXXXXXXXXXXXXXXXXXXXXXXXXXXXXXXXXXXXXXX-oooo------g-XXXXXXXX
XXXXXXXXXXXXXXXXXXXXXXXXXXXXXXXXXXXXXXXXXXXXX----------XXXXXXX-----------XXXXXXXXXXXXXXXXXXXXXXXXXXXXXXXXXXXXXXXXXXX--XXXXXXXXXXXXXXXXXXXXXXXXXXXXXXXXXXXXXXXXXXXXXXXXXXXXXXXXXXXXX-------XXXXXXXXXXXXXX
XXXXXXXXXXXXXXXXXXXXXXXXXXXXXXXXXXXXXXXXXXXXXXXXXXXXXXXXXXXXXXXXXXXXXXXXXXXXXXXXXXXXXXXXXXXXXXXXXXXXXXXXXXXXXXXXXXXXXXXXXXXXXXXXXXXXXXXXXXXXXXXXXXXXXXXXXXXXXXXXXXXXXXXXXXXXXXXXXXXXXXXXXXXXXXXXXXXXXXXX

