--------------------------------------------------------------------------------------------------------------------------------------------------------------------------------------------------------
--------------------------------------------------------------------------------------------------------------------------------------------------------------------------------------------------------
--------------------------------------------------------------------------------------------------------------------------------------------------------------------------------------------------------
--------------------------------------------------------------------------------------------------------------------------------------------------------------------------------------------------------
--------------------------------------------------------------------------------------------------------------------------------------------------------------------------------------------------------
--------------------------------------------------------------------------------------------------------------------------------------------------------------------------------------------------------
--------------------------------------------------------------------------------------------------------------------------------------------------------------------------------------------------------
--------------------------------------------------------------------------------------------------------------------------------------------------------------------------------------------------------
--------------------------------------------------------------------------------------------------------------------------------------------------------------------------------------------------------
--------------------------------------------------------------------------------------------------------------------------------------------------------------------------------------------------------
--------------------------------------------------------------------------------------------------------------------------------------------------------------------------------------------------------
--------------------------------------------------------------------------------------------------------------------------------------------------------------------------------------------------------
----------------------------ooooo-------------------------------------------------------------------------------------oooooo---------------------------oSSSo-------------------------------------ooo----
------------------------------------------------------------------------------------------------------------------------------------------------------------------oSoSooS------oSSSS--------------------
----------------------------oooo---------------------------------------------SooSo-------------------ooS---------------oooooo----------------Soo-------ooo-----------------------------------------oo---
----------------------------g----------------------oo-------oo--------------------------------------------------------g---------------------------------------------oooo-------oooo---------------------
-------------------------XXXXXXXXXX------ooo------------------------ooo------------XXXXXXXXXXXXXXXXX-----------------XXXXXXXXXX---XXX------oooooo---XXXXXXXXX----------------------------------XXXXXXXXX
-------------------------XXXXXXXXXXXXXX-----------XXXXXX---XXXXXXX-------------g---XXXXXXXXXXXXXXXXX---------oooo----XXXXXXXXXX---XXXXXXXX----------XXXXXXXXXXXXXXXXXXXXXXX--XXXXXXXXX---------XXXXXXXXX
-----------XXXXXXXX------XXXXXXXXXXXXXXXXXXXXXX---XXXXXX---XXXXXXXXXXXXXXXXXXXXXXXXXXXXXXXXXXXXXXXXXXXXXXXXX---------XXXXXXXXXXXXXXXXXXXXXXXXXXXXXXXXXXXXXXXXXXXXXXXXXXXXXXXXXXXXXXXXX---g--XXXXXXXXXXXX
XXXXXXXXXXXXXXXXXXXXXXXXXXXXXXXXXXXXXXXXXXXXXXXXXXXXXXXXXXXXXXXXXXXXXXXXXXXXXXXXXXXXXXXXXXXXXXXXXXXXXXXXXXXXXXXXXXXXXXXXXXXXXXXXXXXXXXXXXXXXXXXXXXXXXXXXXXXXXXXXXXXXXXXXXXXXXXXXXXXXXXXXXXXXXXXXXXXXXXXX

