--------------------------------------------------------------------------------------------------------------------------------------------------------------------------------------------------------
--------------------------------------------------------------------------------------------------------------------------------------------------------------------------------------------------------
--------------------------------------------------------------------------------------------------------------------------------------------------------------------------------------------------------
--------------------------------------------------------------------------------------------------------------------------------------------------------------------------------------------------------
--------------------------------------------------------------------------------------------------------------------------------------------------------------------------------------------------------
--------------------------------------------------------------------------------------------------------------------------------------------------------------------------------------------------------
--------------------------------------------------------------------------------------------------------------------------------------------------------------------------------------------------------
--------------------------------------------------------------------------------------------------------------------------------------------------------------------------------------------------------
--------------------------------------------------------------------------------------------------------------------------------------------------------------------------------------------------------
--------------------------------------------------------------------------------------------------------------------------------------------------------------------------------------------------------
--------------------------------------------------------------------------------------------------------------------------------------------------------------------------------------------------------
--------------------------------------------------------------------------------------------------------------------------------------------------------------------------------------------------------
-------------------------------------------------------oSoSoooS--------------------------------------------SSo--------------------------oSoSSS-----SSoo-------------------------------------------------
-------------------------------------------------------------------------oooSS-------------------------------------------------------------------------------------------------------------SoSooo-------
-------------------------------------------------oooo---ooooo-------------------------------------Soo----------------oooooo--ooSoooSo------oo----oooo---------------------------------------------------
-------------oooo--ooooS---oooooo------ooo--------------------------------ooo------------------------------------------------------------------------------------------oo-----------------oooooo--------
------------------------------------------------oooo--XXXXXXXXXXX---------------------------------oooo---XXXXXXXX-oooooo-------ooooo---XXXXXXXXXXXXXXXXXX----------------------------------------g------
------------XXXXXX--------XXXXXXXX-------ooo----------XXXXXXXXXXX------XXXXXXXXXXXXXXXXXXXXXXXXX---------XXXXXXXX----------------------XXXXXXXXXXXXXXXXXX----ooo-----XXXXXXXXXX--XXXXXXXXXXXXXXXXXX---XX
------------XXXXXX--------XXXXXXXXXX---------XXXXXXXXXXXXXXXXXXXX------XXXXXXXXXXXXXXXXXXXXXXXXXXXXXXXXXXXXXXXXXXXXXXXXXXXXXXXXXXXXXXXXXXXXXXXXXXXXXXXXXX------------XXXXXXXXXXXXXXXXXXXXXXXXXXXXXXXXXXX
XXXXXXXXXXXXXXXXXXXXXXXXXXXXXXXXXXXXXXXXXXXXXXXXXXXXXXXXXXXXXXXXXXXXXXXXXXXXXXXXXXXXXXXXXXXXXXXXXXXXXXXXXXXXXXXXXXXXXXXXXXXXXXXXXXXXXXXXXXXXXXXXXXXXXXXXXXXXXXXXXXXXXXXXXXXXXXXXXXXXXXXXXXXXXXXXXXXXXXXX

