--------------------------------------------------------------------------------------------------------------------------------------------------------------------------------------------------------
--------------------------------------------------------------------------------------------------------------------------------------------------------------------------------------------------------
--------------------------------------------------------------------------------------------------------------------------------------------------------------------------------------------------------
--------------------------------------------------------------------------------------------------------------------------------------------------------------------------------------------------------
--------------------------------------------------------------------------------------------------------------------------------------------------------------------------------------------------------
--------------------------------------------------------------------------------------------------------------------------------------------------------------------------------------------------------
--------------------------------------------------------------------------------------------------------------------------------------------------------------------------------------------------------
--------------------------------------------------------------------------------------------------------------------------------------------------------------------------------------------------------
--------------------------------------------------------------------------------------------------------------------------------------------------------------------------------------------------------
--------------------------------------------------------------------------------------------------------------------------------------------------------------------------------------------------------
--------------------------------------------------------------------------------------------------------------------------------------------------------------------------------------------------------
--------------------------------------------------------------------------------------------------------------------------------------------------------------------------------------------------------
---------------------------------------------ooSoooSo---------------ooSo-----------------------------------------------------------------------oSoooo-----------------------------------------oooo------
------------------------------------------------------------------------------------------oooSo----------------------------------oSoS-------------------------------------------------------------------
---------------------------------------------oooooo-----------------ooooo-------------------------ooooooo---------------------------------------oooo----------------------------------------------------
------------ooSoSo--------ooooo---oooooooo-----------g----------------g------------------oooo-----------------------------------oooooo---oo-----------------------------------ooSSo---------------------
XXXXXXXXXX----------------------------------XXXXXXXXXXX----ooooo-XXXXXXXXXX-------------g------------ooo-------------oo----------------------XXXXXXXXXX-----------------------------XXXX--XXXXXXXXX-----
XXXXXXXXXX--oooo----------oooo-------ooo----XXXXXXXXXXX----------XXXXXXXXXX--oo-------XXXXXXXXXXX--g--------------------------XXXXXXXXXXXXXXXXXXXXXXXXX----------------------oooooo-XXXX--XXXXXXXXX--XXX
XXXXXXXXXX----------------------------------XXXXXXXXXXXXXXXXXXXXXXXXXXXXXXX-----------XXXXXXXXXXXXXXXXXXXXXXXXXXXXXXXXXX-g----XXXXXXXXXXXXXXXXXXXXXXXXXXXXXX-----XXXXXXXXXXX--------XXXX--XXXXXXXXXXXXXX
XXXXXXXXXXXXXXXXXXXXXXXXXXXXXXXXXXXXXXXXXXXXXXXXXXXXXXXXXXXXXXXXXXXXXXXXXXXXXXXXXXXXXXXXXXXXXXXXXXXXXXXXXXXXXXXXXXXXXXXXXXXXXXXXXXXXXXXXXXXXXXXXXXXXXXXXXXXXXXXXXXXXXXXXXXXXXXXXXXXXXXXXXXXXXXXXXXXXXXXX

