--------------------------------------------------------------------------------------------------------------------------------------------------------------------------------------------------------
--------------------------------------------------------------------------------------------------------------------------------------------------------------------------------------------------------
--------------------------------------------------------------------------------------------------------------------------------------------------------------------------------------------------------
--------------------------------------------------------------------------------------------------------------------------------------------------------------------------------------------------------
--------------------------------------------------------------------------------------------------------------------------------------------------------------------------------------------------------
--------------------------------------------------------------------------------------------------------------------------------------------------------------------------------------------------------
--------------------------------------------------------------------------------------------------------------------------------------------------------------------------------------------------------
--------------------------------------------------------------------------------------------------------------------------------------------------------------------------------------------------------
--------------------------------------------------------------------------------------------------------------------------------------------------------------------------------------------------------
--------------------------------------------------------------------------------------------------------------------------------------------------------------------------------------------------------
--------------------------------------------------------------------------------------------------------------------------------------------------------------------------------------------------------
--------------------------------------------------------------------------------------------------------------------------------------------------------------------------------------------------------
-------------------------oooS-------------------------------------------------------------------------ooSSo---------------------------------------------------------------------------------------------
-----------------------------------------------------------------------------------------oooooSo-------------------------------------------------------------------------oSo------------oooo------------
-----------------oo------oooo-----------------------------------SoS---------------ooo-----------------------------------ooooSo-----------------------ooooo------ooo-------------------------------oooS--
--------------------------------------------------ooooSo-----------------ooooSoo-----------oooo-------g-----------------------------------------------------------------------------------oooo----------
-----------XXXXXXXXX--XXXXXXXXXXXXX----------------------------ooooo--XX-----------ooo------g------XXXXXXXXXX----oo-----ooooo-------ooo----XX-------oooooo----XXXXXXX----------------------------oooooo-
XXXXXXXXXXXXXXXXXXXX--XXXXXXXXXXXXX-ooooo------oooooooo---------------XX---oo-------g---XXXXXXXXXXXXXXXXXXXXX------------------------------XXXXX--------------XXXXXXXXXXXXXXX-----XXXXXXXXXXXXX---------
XXXXXXXXXXXXXXXXXXXXXXXXXXXXXXXXXXX---------XX-----g-----XXXXXXXXXXXXXXX---------XXXXXXXXXXXXXXXXXXXXXXXXXXXXXXXXXXXXXXXXXXXXXX----XXXXXXXXXXXXXXXXXXXXXXXXXXXXXXXXXXXXXXXXXXXXXXXXXXXXXXXXXXXXXXXXXXXXX
XXXXXXXXXXXXXXXXXXXXXXXXXXXXXXXXXXXXXXXXXXXXXXXXXXXXXXXXXXXXXXXXXXXXXXXXXXXXXXXXXXXXXXXXXXXXXXXXXXXXXXXXXXXXXXXXXXXXXXXXXXXXXXXXXXXXXXXXXXXXXXXXXXXXXXXXXXXXXXXXXXXXXXXXXXXXXXXXXXXXXXXXXXXXXXXXXXXXXXXX

