--------------------------------------------------------------------------------------------------------------------------------------------------------------------------------------------------------
--------------------------------------------------------------------------------------------------------------------------------------------------------------------------------------------------------
--------------------------------------------------------------------------------------------------------------------------------------------------------------------------------------------------------
--------------------------------------------------------------------------------------------------------------------------------------------------------------------------------------------------------
--------------------------------------------------------------------------------------------------------------------------------------------------------------------------------------------------------
--------------------------------------------------------------------------------------------------------------------------------------------------------------------------------------------------------
--------------------------------------------------------------------------------------------------------------------------------------------------------------------------------------------------------
--------------------------------------------------------------------------------------------------------------------------------------------------------------------------------------------------------
--------------------------------------------------------------------------------------------------------------------------------------------------------------------------------------------------------
--------------------------------------------------------------------------------------------------------------------------------------------------------------------------------------------------------
--------------------------------------------------------------------------------------------------------------------------------------------------------------------------------------------------------
--------------------------------------------------------------------------------------------------------------------------------------------------------------------------------------------------------
------------------------------------------------------------------------------------oooSo---------------------------------------ooSoo--------------------------SoSoS------------------------------------
----------------------------------------------------------------oSooSoo---------------------oSSoooS-------------------------------------------------oSSoo-----------------------------------------------
----------------oooo----------oSooS-----oSS--------------------------------------ooooooo----------------------------------------oooo----------------------------ooooo--------------oo-----ooSoo---------
------------------------------------------------oooo----------ooooooo------------------------ooooooo----oSooooo---------------g-g-------oSoo---------ooo------------------------------------------------
---------------------------ooooooo------oooo------------------------------------XXXXXXXXXXX---------------------------------XXXXXXXXXX--------------g-------XXXXXXXXXX----XXXXXXXXXXXXXX----ooo---------
----------------------------------------------XXXXXXXXXXXXX--XXXXXXXXXXX----ooo-XXXXXXXXXXXXXXXXXXXXX-----oo-------XXXXXXXXXXXXXXXXXXX--ooooo----XXXXXXXXXXXXXXXXXXXXX----XXXXXXXXXXXXXX----------------
XXXXXXXXXXX--XXXXXXXXXXXXXXXXXXXXXXXXXXXXXXXXXXXXXXXXXXXXXX--XXXXXXXXXXX--------XXXXXXXXXXXXXXXXXXXXX--------------XXXXXXXXXXXXXXXXXXX-g---------XXXXXXXXXXXXXXXXXXXXXXXXXXXXXXXXXXXXXXXXXXXXXXXXX------
XXXXXXXXXXXXXXXXXXXXXXXXXXXXXXXXXXXXXXXXXXXXXXXXXXXXXXXXXXXXXXXXXXXXXXXXXXXXXXXXXXXXXXXXXXXXXXXXXXXXXXXXXXXXXXXXXXXXXXXXXXXXXXXXXXXXXXXXXXXXXXXXXXXXXXXXXXXXXXXXXXXXXXXXXXXXXXXXXXXXXXXXXXXXXXXXXXXXXXXX

