--------------------------------------------------------------------------------------------------------------------------------------------------------------------------------------------------------
--------------------------------------------------------------------------------------------------------------------------------------------------------------------------------------------------------
--------------------------------------------------------------------------------------------------------------------------------------------------------------------------------------------------------
--------------------------------------------------------------------------------------------------------------------------------------------------------------------------------------------------------
--------------------------------------------------------------------------------------------------------------------------------------------------------------------------------------------------------
--------------------------------------------------------------------------------------------------------------------------------------------------------------------------------------------------------
--------------------------------------------------------------------------------------------------------------------------------------------------------------------------------------------------------
--------------------------------------------------------------------------------------------------------------------------------------------------------------------------------------------------------
--------------------------------------------------------------------------------------------------------------------------------------------------------------------------------------------------------
--------------------------------------------------------------------------------------------------------------------------------------------------------------------------------------------------------
--------------------------------------------------------------------------------------------------------------------------------------------------------------------------------------------------------
--------------------------------------------------------------------------------------------------------------------------------------------------------------------------------------------------------
------------------------------------------------------------oooo---------------------SoSoSS--------------------------------------------------ooSooSoo---------------------------------------------------
---------------------------SoSS--------------------------------------------------------------------------------------------------------------------------ooooS-----------------SSSSoo---ooSoSo----------
-----------------------------------------------------------ooooo--------------------oooooooo---oSoSooo-----------------------oo---------------oooooo--------------oSSSoo--------------------------------
----------------------------oo------------------------------------------ooooS-------------------------------------ooooooo-------------------------------oooooo------------------oooooo---ooooooo--------
--------------XXXXXXX----------------------XX------oooo---XXXXXXXXXX------------XXXXXXXXXXXXXX----ooo----------------------XXXXXXXX-----XXXXXXXXXXXXXXX------g-----ooooo----------------g---------------
--------------XXXXXXX----XXXXXXXX----------XX-----------XXXXXXXXXXXX---oooooooo-XXXXXXXXXXXXXX---g--g------------XXXXXXXXXXXXXXXXXXXXXXXXXXXXXXXXXXXXXXXXXXXXXXXX-----------XXXXXXXXXXXXXXXXXXXXXX----XX
--------------XXXXXXXXXXXXXXXXXXX----------XXXXXXXXXXXXXXXXXXXXXXXXXXX----------XXXXXXXXXXXXXXXXXXXXXXXXXXXXXXXXXXXXXXXXXXXXXXXXXXXXXXXXXXXXXXXXXXXXXXXXXXXXXXXXXXXXXXXXXXXXXXXXXXXXXXXXXXXXXXXXXX----XX
XXXXXXXXXXXXXXXXXXXXXXXXXXXXXXXXXXXXXXXXXXXXXXXXXXXXXXXXXXXXXXXXXXXXXXXXXXXXXXXXXXXXXXXXXXXXXXXXXXXXXXXXXXXXXXXXXXXXXXXXXXXXXXXXXXXXXXXXXXXXXXXXXXXXXXXXXXXXXXXXXXXXXXXXXXXXXXXXXXXXXXXXXXXXXXXXXXXXXXXX

