--------------------------------------------------------------------------------------------------------------------------------------------------------------------------------------------------------
--------------------------------------------------------------------------------------------------------------------------------------------------------------------------------------------------------
--------------------------------------------------------------------------------------------------------------------------------------------------------------------------------------------------------
--------------------------------------------------------------------------------------------------------------------------------------------------------------------------------------------------------
--------------------------------------------------------------------------------------------------------------------------------------------------------------------------------------------------------
--------------------------------------------------------------------------------------------------------------------------------------------------------------------------------------------------------
--------------------------------------------------------------------------------------------------------------------------------------------------------------------------------------------------------
--------------------------------------------------------------------------------------------------------------------------------------------------------------------------------------------------------
--------------------------------------------------------------------------------------------------------------------------------------------------------------------------------------------------------
--------------------------------------------------------------------------------------------------------------------------------------------------------------------------------------------------------
--------------------------------------------------------------------------------------------------------------------------------------------------------------------------------------------------------
--------------------------------------------------------------------------------------------------------------------------------------------------------------------------------------------------------
---------------------------oSoSo------------------------------------------------------------------------------------------------------------------------------------------------------------------------
--------------------------------------------------------------ooSoo----------------ooS-------------------SooSSo-------------------ooSoSo--ooooS---------------------------------------------------------
---------------------------ooooo---------------------------------------------------------------------------------------------------------------------ooooSoo--------------------------------------------
-----------------------------------oooSoSoo----SSSoo----------oooo-----oooSSo----ooooo-----oooo-----------ooo----------oooo------oooo-----oooooo--------------------------------------------------------
--------------------XXXXXXXXXXXXX-------------------------------------------------g--------------XXXXX------------------------------------g----------ooooo-------------------------------ooooo----------
--------------------XXXXXXXXXXXXX-oooooooo---ooooooo-XXXXXXXXXXXXXXX----ooooo--XXXXXXXXXXXXXXXXXXXXXXXXXXXXXXXXXX--------------XXXXXXXXXXXXXXXXXXX-g----------------XXXXXX------XXXX------------XXXXXXXX
---------------g----XXXXXXXXXXXXX-----------------g--XXXXXXXXXXXXXXX-----------XXXXXXXXXXXXXXXXXXXXXXXXXXXXXXXXXX--------------XXXXXXXXXXXXXXXXXXXXXXXXXXXXXX-------XXXXXXXXXXXXXXXX---XXXXXXXXXXXXXXXXX
XXXXXXXXXXXXXXXXXXXXXXXXXXXXXXXXXXXXXXXXXXXXXXXXXXXXXXXXXXXXXXXXXXXXXXXXXXXXXXXXXXXXXXXXXXXXXXXXXXXXXXXXXXXXXXXXXXXXXXXXXXXXXXXXXXXXXXXXXXXXXXXXXXXXXXXXXXXXXXXXXXXXXXXXXXXXXXXXXXXXXXXXXXXXXXXXXXXXXXXX

