--------------------------------------------------------------------------------------------------------------------------------------------------------------------------------------------------------
--------------------------------------------------------------------------------------------------------------------------------------------------------------------------------------------------------
--------------------------------------------------------------------------------------------------------------------------------------------------------------------------------------------------------
--------------------------------------------------------------------------------------------------------------------------------------------------------------------------------------------------------
--------------------------------------------------------------------------------------------------------------------------------------------------------------------------------------------------------
--------------------------------------------------------------------------------------------------------------------------------------------------------------------------------------------------------
--------------------------------------------------------------------------------------------------------------------------------------------------------------------------------------------------------
--------------------------------------------------------------------------------------------------------------------------------------------------------------------------------------------------------
--------------------------------------------------------------------------------------------------------------------------------------------------------------------------------------------------------
--------------------------------------------------------------------------------------------------------------------------------------------------------------------------------------------------------
--------------------------------------------------------------------------------------------------------------------------------------------------------------------------------------------------------
--------------------------------------------------------------------------------------------------------------------------------------------------------------------------------------------------------
---------------------------------SoS-------------------------ooooo--------------------------------------------------------------------------------------------------------------------------------------
------------------------------------------------ooSSoSo-------------------------------------------------------------------------------------------------------------------------------------------------
-------------------------------oooooo----oSSo----------------oooooo-----------------------SooSo-----------oooo---------oooo---------------------------------------------oSSS----------------------------
-----------------------------------g---------------oooo------------------------oSoo-------------------------------------------------------------------ooooo--oSoo----------------ooo-----------oooo-----
------------------------------XXXXXXXX----ooo---------------XXXXXXXXXX---------------------------------ooooo------------ooo---------------------------------------------oooo----------------------------
----------XXXX-----XXXXXXXXXXXXXXXXXXX---------XXXXXXXXXXX--XXXXXXXXXXXX--------oooo------------XX-------------XXXXX----------------XXXXXXX----------oooo-----ooo-----------g--XXXXXXX--XXX-oooooooo----
XXXXXXXXXXXXXX-----XXXXXXXXXXXXXXXXXXXXXXXXXXXXXXXXXXXXXXX--XXXXXXXXXXXXXXXXX----------XXXXXXXXXXXXXXXXXXXXXXXXXXXXXXXXXXXXXXXXXXXXXXXXXXXX----------------------------XXXXXXXXXXXXXXX--XXX----------XXX
XXXXXXXXXXXXXXXXXXXXXXXXXXXXXXXXXXXXXXXXXXXXXXXXXXXXXXXXXXXXXXXXXXXXXXXXXXXXXXXXXXXXXXXXXXXXXXXXXXXXXXXXXXXXXXXXXXXXXXXXXXXXXXXXXXXXXXXXXXXXXXXXXXXXXXXXXXXXXXXXXXXXXXXXXXXXXXXXXXXXXXXXXXXXXXXXXXXXXXXX

