--------------------------------------------------------------------------------------------------------------------------------------------------------------------------------------------------------
--------------------------------------------------------------------------------------------------------------------------------------------------------------------------------------------------------
--------------------------------------------------------------------------------------------------------------------------------------------------------------------------------------------------------
--------------------------------------------------------------------------------------------------------------------------------------------------------------------------------------------------------
--------------------------------------------------------------------------------------------------------------------------------------------------------------------------------------------------------
--------------------------------------------------------------------------------------------------------------------------------------------------------------------------------------------------------
--------------------------------------------------------------------------------------------------------------------------------------------------------------------------------------------------------
--------------------------------------------------------------------------------------------------------------------------------------------------------------------------------------------------------
--------------------------------------------------------------------------------------------------------------------------------------------------------------------------------------------------------
--------------------------------------------------------------------------------------------------------------------------------------------------------------------------------------------------------
--------------------------------------------------------------------------------------------------------------------------------------------------------------------------------------------------------
--------------------------------------------------------------------------------------------------------------------------------------------------------------------------------------------------------
-----------------------------------------------------------------ooo------------------------------------------------------------------------------------------------------------------------------------
------------------------------------------oooo--------------------------------------------------------------------------------------------------------------------------SoSoSoo----ooooS----------------
---------------oSoooS-----------oooSooo----------------------------------------oo-----------oSSS--------------------------------------------------------------------------------------------------------
-----------------------------------------ooooooo-----oooSoo-------------------------oooo--------------------------------------oSSoo--------------------------SSoSooo----ooooo------oooooooo-----SSSSS---
----------------oooo----XX------oooo--------------------------XXXXXXXXXXXXXXXXXXXXX----------ooo------------------oooo---------------------------------XXX----------------------------------------------
----------XXXX----------XXXXXX----------XXXXXXXXX-oooooooo----XXXXXXXXXXXXXXXXXXXXX-ooo-------------ooooooo------------XXXXX--oooooooo-----oo----------XXX----oooooo-XXXXXXXXXXX--XXXXXXXXXX-ooooooooo--
XXXXXXXXXXXXXXXXXXXXXXXXXXXXXXXXXXXXXXXXXXXXXXXXX-------g-----XXXXXXXXXXXXXXXXXXXXX------XXXXXXXXX----------XXXXXXXXXXXXXXXX------------------XXXXXXXXXXXX-----g-----XXXXXXXXXXXXXXXXXXXXXXX-----g-----X
XXXXXXXXXXXXXXXXXXXXXXXXXXXXXXXXXXXXXXXXXXXXXXXXXXXXXXXXXXXXXXXXXXXXXXXXXXXXXXXXXXXXXXXXXXXXXXXXXXXXXXXXXXXXXXXXXXXXXXXXXXXXXXXXXXXXXXXXXXXXXXXXXXXXXXXXXXXXXXXXXXXXXXXXXXXXXXXXXXXXXXXXXXXXXXXXXXXXXXXX

