--------------------------------------------------------------------------------------------------------------------------------------------------------------------------------------------------------
--------------------------------------------------------------------------------------------------------------------------------------------------------------------------------------------------------
--------------------------------------------------------------------------------------------------------------------------------------------------------------------------------------------------------
--------------------------------------------------------------------------------------------------------------------------------------------------------------------------------------------------------
--------------------------------------------------------------------------------------------------------------------------------------------------------------------------------------------------------
--------------------------------------------------------------------------------------------------------------------------------------------------------------------------------------------------------
--------------------------------------------------------------------------------------------------------------------------------------------------------------------------------------------------------
--------------------------------------------------------------------------------------------------------------------------------------------------------------------------------------------------------
--------------------------------------------------------------------------------------------------------------------------------------------------------------------------------------------------------
--------------------------------------------------------------------------------------------------------------------------------------------------------------------------------------------------------
--------------------------------------------------------------------------------------------------------------------------------------------------------------------------------------------------------
--------------------------------------------------------------------------------------------------------------------------------------------------------------------------------------------------------
-------------oSoooSo-----------------------------------------------------------------------------------ooo---------------------------------ooooSo-------------------------------------------------------
------------------------------------------------------------ooo---------------------------------------------------------ooooo--ooSooSSo------------ooSooo----SoS----------------------------------------
-------------ooooooo------------------------------------------------------------------------------------oooo------ooo-----------------------oo-------------------------ooo------------------------------
------------------------------------ooo----oSoSooS--------oooo--------------------------------------------g---------------oo-----ooooo--------------ooo--------oo---------------------------------------
XXXXXXXXXXXXXXXXXXXXXXXXX------------------------------------g-----ooo--------oo-XXXXXXXXXX-----------XXXXXXXX--------------------------XXXXXXXXXX------------------ooooooo--XXXXX-tt---XXXXX---------XX
XXXXXXXXXXXXXXXXXXXXXXXXX-----g-XXXXXXXXXX--ooooooo-XXXXXXXXXXXX-----------------XXXXXXXXXX---XX-ooo--XXXXXXXXXXX------XXXXXXXXXXXXXXXXXXXXXXXXXXXXXXXXXXXXXXXXXXXX----------XXXXX-tt---XXXXXXXXXXXXXXXX
XXXXXXXXXXXXXXXXXXXXXXXXXXXXXXXXXXXXXXXXXX----------XXXXXXXXXXXXXXXXXXXX---XXXXXXXXXXXXXXXXXXXXX------XXXXXXXXXXXXXXXXXXXXXXXXXXXXXXXXXXXXXXXXXXXXXXXXXXXXXXXXXXXXXXXXXXXXXXXXXXXX-tt---XXXXXXXXXXXXXXXX
XXXXXXXXXXXXXXXXXXXXXXXXXXXXXXXXXXXXXXXXXXXXXXXXXXXXXXXXXXXXXXXXXXXXXXXXXXXXXXXXXXXXXXXXXXXXXXXXXXXXXXXXXXXXXXXXXXXXXXXXXXXXXXXXXXXXXXXXXXXXXXXXXXXXXXXXXXXXXXXXXXXXXXXXXXXXXXXXXXXXXXXXXXXXXXXXXXXXXXXX

