--------------------------------------------------------------------------------------------------------------------------------------------------------------------------------------------------------
--------------------------------------------------------------------------------------------------------------------------------------------------------------------------------------------------------
--------------------------------------------------------------------------------------------------------------------------------------------------------------------------------------------------------
--------------------------------------------------------------------------------------------------------------------------------------------------------------------------------------------------------
--------------------------------------------------------------------------------------------------------------------------------------------------------------------------------------------------------
--------------------------------------------------------------------------------------------------------------------------------------------------------------------------------------------------------
--------------------------------------------------------------------------------------------------------------------------------------------------------------------------------------------------------
--------------------------------------------------------------------------------------------------------------------------------------------------------------------------------------------------------
--------------------------------------------------------------------------------------------------------------------------------------------------------------------------------------------------------
--------------------------------------------------------------------------------------------------------------------------------------------------------------------------------------------------------
--------------------------------------------------------------------------------------------------------------------------------------------------------------------------------------------------------
--------------------------------------------------------------------------------------------------------------------------------------------------------------------------------------------------------
-------------------------------------------------------------------------------------------------------------------------------------------------------------------------Soo----------------------------
--------------------------------------------Soo-------------------------------------------------------ooSoo------ooooSSo---oooS------------------------oSoooo-----------------------------ooooSSooo-----
-----------------------------------------------------oSSS-------------------------------------------------------------------------------------------------------------oooooo----------------------------
-------------------------oSS----------------------------------------------------ooSoooSo--------------oo---------ooooo-------ooo----oSoSoSoo-----------oooooo----ooo-----------------Soo----oooooo------
--------------------------------------------------------oo---ooo-------------------------XXXX------------------------------------------------------------------------XXXXXXXXX--------------------------
---------------XXXXXXXX---------------XXXXXXXXXXXXXX------------------XXXXXXXXX---ooo----XXXX--------XXXXXXXXXXXXXXXXXXXXXXXXXXXXXX-oooooooo--------XXXXXXXXXXX--ooo-XXXXXXXXXXXXXX-oo---XXXXXXXXXXX----
XXXXXXXXXXXX---XXXXXXXX--------XXXXXXXXXXXXXXXXXXXXXXXXXXXXXXXXXX-----XXXXXXXXX----------XXXXXXXXX---XXXXXXXXXXXXXXXXXXXXXXXXXXXXXX-----------g-----XXXXXXXXXXX------XXXXXXXXXXXXXX------XXXXXXXXXXXXXX-
XXXXXXXXXXXXXXXXXXXXXXXXXXXXXXXXXXXXXXXXXXXXXXXXXXXXXXXXXXXXXXXXXXXXXXXXXXXXXXXXXXXXXXXXXXXXXXXXXXXXXXXXXXXXXXXXXXXXXXXXXXXXXXXXXXXXXXXXXXXXXXXXXXXXXXXXXXXXXXXXXXXXXXXXXXXXXXXXXXXXXXXXXXXXXXXXXXXXXXXX

