--------------------------------------------------------------------------------------------------------------------------------------------------------------------------------------------------------
--------------------------------------------------------------------------------------------------------------------------------------------------------------------------------------------------------
--------------------------------------------------------------------------------------------------------------------------------------------------------------------------------------------------------
--------------------------------------------------------------------------------------------------------------------------------------------------------------------------------------------------------
--------------------------------------------------------------------------------------------------------------------------------------------------------------------------------------------------------
--------------------------------------------------------------------------------------------------------------------------------------------------------------------------------------------------------
--------------------------------------------------------------------------------------------------------------------------------------------------------------------------------------------------------
--------------------------------------------------------------------------------------------------------------------------------------------------------------------------------------------------------
--------------------------------------------------------------------------------------------------------------------------------------------------------------------------------------------------------
--------------------------------------------------------------------------------------------------------------------------------------------------------------------------------------------------------
--------------------------------------------------------------------------------------------------------------------------------------------------------------------------------------------------------
--------------------------------------------------------------------------------------------------------------------------------------------------------------------------------------------------------
----------------------------------------------------------------------------------------------------------------------------------------------------SSo-----ooo-----------------------------------------
-------------------------------------------------------------------------------------------------------------------------------------------------------------------------------ooSoSo--------ooooo------
---------------------------------------------oSSooS----------------------SSoSS------------------------------oooooo-----------------------------------oooo-----ooo---------------------------------------
----------------------------------------------------------------------------------oooo------------------------------oSoo-----------SSo----ooSooo----------------------SSoo---ooooo----------oooooo------
--------------g----XXXXXXXXXXXXX-----------oooooooo-------------------ooooooooo--------------XXXXXXXXXXX---oooo----------------------------------XXXXXXXXXXXXXXXXX--------------------------------------
XXXXXXXXXXXXXXXXXXXXXXXXXXXXXXXX--oo--------------------oo-XXX---------------------oo----XXXXXXXXXXXXXXX------g-----ooooo--------oooo-----ooo----XXXXXXXXXXXXXXXXX-oooo----XXXXXXXXXXX----XXXXXXXXXXXXXX
XXXXXXXXXXXXXXXXXXXXXXXXXXXXXXXX-g------XXXXXXXXXXXXX------XXX---XXXXXXXXXXXXXXX---------XXXXXXXXXXXXXXXXXXXXXXXXXX------------------------------XXXXXXXXXXXXXXXXX---------XXXXXXXXXXXXXXXXXXXXXXXXXXXXX
XXXXXXXXXXXXXXXXXXXXXXXXXXXXXXXXXXXXXXXXXXXXXXXXXXXXXXXXXXXXXXXXXXXXXXXXXXXXXXXXXXXXXXXXXXXXXXXXXXXXXXXXXXXXXXXXXXXXXXXXXXXXXXXXXXXXXXXXXXXXXXXXXXXXXXXXXXXXXXXXXXXXXXXXXXXXXXXXXXXXXXXXXXXXXXXXXXXXXXXX

