--------------------------------------------------------------------------------------------------------------------------------------------------------------------------------------------------------
--------------------------------------------------------------------------------------------------------------------------------------------------------------------------------------------------------
--------------------------------------------------------------------------------------------------------------------------------------------------------------------------------------------------------
--------------------------------------------------------------------------------------------------------------------------------------------------------------------------------------------------------
--------------------------------------------------------------------------------------------------------------------------------------------------------------------------------------------------------
--------------------------------------------------------------------------------------------------------------------------------------------------------------------------------------------------------
--------------------------------------------------------------------------------------------------------------------------------------------------------------------------------------------------------
--------------------------------------------------------------------------------------------------------------------------------------------------------------------------------------------------------
--------------------------------------------------------------------------------------------------------------------------------------------------------------------------------------------------------
--------------------------------------------------------------------------------------------------------------------------------------------------------------------------------------------------------
--------------------------------------------------------------------------------------------------------------------------------------------------------------------------------------------------------
--------------------------------------------------------------------------------------------------------------------------------------------------------------------------------------------------------
----------------------------------------ooSo---------------------------------------------------------------oSS-----oSooo--------------------------------------------------------------------------------
-------------------------------------------------------------------------------------------------------------------------------------ooooo----ooSS------------------------------------------------------
------------------------------------------------ooooo--ooooooo-----------oooo--------------------------------ooo---ooooo--------------------------------------------------------------------------------
--------------------------------oooo-------------------------------------------------oooo------------------------------------------ooooo------ooooo-----------------------------------------------------
-------------XXXXX--------------------XXXXXXXXXXXXXXXX----ooo--XXX---XXXXXXXXXXXXXXX------g-XXX-------ooo-XXXXXXXXXXXXXXXXXX-------------------------------------ooo-----XXX----------------------------
-------------XXXXX-------------oooooo-XXXXXXXXXXXXXXXX---g-----XXX---XXXXXXXXXXXXXXXXXXXXXXXXXX--------g--XXXXXXXXXXXXXXXXXXXXXXXXXXXXXXXXXXXXXXXXXXXX-------------------XXX---XXXXXX-ooo--XXXX-oooo----
-------------XXXXXXXXXXXXXXXX---------XXXXXXXXXXXXXXXXXXXXXXXXXXXXXXXXXXXXXXXXXXXXXXXXXXXXXXXXX----XXXXXXXXXXXXXXXXXXXXXXXXXXXXXXXXXXXXXXXXXXXXXXXXXXX---------XXXXXXXX--XXXXXXXXXXXX------XXXX---------
XXXXXXXXXXXXXXXXXXXXXXXXXXXXXXXXXXXXXXXXXXXXXXXXXXXXXXXXXXXXXXXXXXXXXXXXXXXXXXXXXXXXXXXXXXXXXXXXXXXXXXXXXXXXXXXXXXXXXXXXXXXXXXXXXXXXXXXXXXXXXXXXXXXXXXXXXXXXXXXXXXXXXXXXXXXXXXXXXXXXXXXXXXXXXXXXXXXXXXXX

