--------------------------------------------------------------------------------------------------------------------------------------------------------------------------------------------------------
--------------------------------------------------------------------------------------------------------------------------------------------------------------------------------------------------------
--------------------------------------------------------------------------------------------------------------------------------------------------------------------------------------------------------
--------------------------------------------------------------------------------------------------------------------------------------------------------------------------------------------------------
--------------------------------------------------------------------------------------------------------------------------------------------------------------------------------------------------------
--------------------------------------------------------------------------------------------------------------------------------------------------------------------------------------------------------
--------------------------------------------------------------------------------------------------------------------------------------------------------------------------------------------------------
--------------------------------------------------------------------------------------------------------------------------------------------------------------------------------------------------------
--------------------------------------------------------------------------------------------------------------------------------------------------------------------------------------------------------
--------------------------------------------------------------------------------------------------------------------------------------------------------------------------------------------------------
--------------------------------------------------------------------------------------------------------------------------------------------------------------------------------------------------------
--------------------------------------------------------------------------------------------------------------------------------------------------------------------------------------------------------
---------------------------------------------------------------------------------------------------------------------------------------ooooo------------------------------------------------------------
----------------------------------------------------------------------------ooSo--------------------------------------------------------------------------------------------------------------oooo------
---------------------------------------------------------------------oo---------------------------------------------------SSooo---------ooo-------------------------------------------------------------
----------------------------------Sooooo-------------------ooSSS---------oooooo-----------------------------------oo----------------------------ooSS-----------ooo-------------------------ooooooo------
--------------------ooo------------------XXXXX--------------------XXXXXX----------ooooo------------XXX-----XXX-g------------oooo------XXXXXXX---------XXXXXX--------------XXXXX-----------------g-------
XXXXXXXXXXXXXXXXX--------------oooooooo--XXXXX---ooo----ooooooo---XXXXXXXXXXXXXXX-------XXXXXXXXXXXXXX-----XXXXXXXXXXXXX--------------XXXXXXX--oooo---XXXXXXXXXXXXX--oo---XXXXX-----oo----XXXXXXXXX-----
XXXXXXXXXXXXXXXXXXXXXXXXX----------------XXXXX---g-----------g----XXXXXXXXXXXXXXXXXXXXXXXXXXXXXXXXXXXXXXXXXXXXXXXXXXXXXXXXXXXXXXXXXXXXXXXXXXX---------XXXXXXXXXXXXX-------XXXXXXX---------XXXXXXXXX---XX
XXXXXXXXXXXXXXXXXXXXXXXXXXXXXXXXXXXXXXXXXXXXXXXXXXXXXXXXXXXXXXXXXXXXXXXXXXXXXXXXXXXXXXXXXXXXXXXXXXXXXXXXXXXXXXXXXXXXXXXXXXXXXXXXXXXXXXXXXXXXXXXXXXXXXXXXXXXXXXXXXXXXXXXXXXXXXXXXXXXXXXXXXXXXXXXXXXXXXXXX

