--------------------------------------------------------------------------------------------------------------------------------------------------------------------------------------------------------
--------------------------------------------------------------------------------------------------------------------------------------------------------------------------------------------------------
--------------------------------------------------------------------------------------------------------------------------------------------------------------------------------------------------------
--------------------------------------------------------------------------------------------------------------------------------------------------------------------------------------------------------
--------------------------------------------------------------------------------------------------------------------------------------------------------------------------------------------------------
--------------------------------------------------------------------------------------------------------------------------------------------------------------------------------------------------------
--------------------------------------------------------------------------------------------------------------------------------------------------------------------------------------------------------
--------------------------------------------------------------------------------------------------------------------------------------------------------------------------------------------------------
--------------------------------------------------------------------------------------------------------------------------------------------------------------------------------------------------------
--------------------------------------------------------------------------------------------------------------------------------------------------------------------------------------------------------
--------------------------------------------------------------------------------------------------------------------------------------------------------------------------------------------------------
--------------------------------------------------------------------------------------------------------------------------------------------------------------------------------------------------------
---------------------------------------------------------------------------------ooo--------------------------------------------------------------------------------------------------------------------
----------------------------------oooooS-------------------------Soooo---------------------------------------ooo----------------------------------------------------------------------------------------
--------------oooo-----------------------------oo---------------------------------------------------------------------------------------------------------------------------------------------------ooo-
------------------------------------oooo-------------------------oooooo--oooo---------------------------------oo---------------oo---------oooSS----------------------SSSo-------oSSoo-------------------
-------------oooo------XXXXX----------------XXXXXXXXXX---------------g--------XXXXXXX--------------------------------------------------------------XXXXXX--------------------------------XXX---------oo-
XXXXXXXXXXX---------XXXXXXXX-----XXXXXXXXXXXXXXXXXXXXXXXXXXXXXXXXXXXXXXX---oo-XXXXXXX----ooo---------oooo--XXXXXXXX----------XXXXXXXX------ooooo---XXXXXXXXXXXXXXXX----ooooo-XX-ooooo----XXX------------
XXXXXXXXXXXXXXXXXXXXXXXXXXXX-----XXXXXXXXXXXXXXXXXXXXXXXXXXXXXXXXXXXXXXX----g-XXXXXXX--------XXXXX---------XXXXXXXXXXXXXXXXXXXXXXXXXX--------------XXXXXXXXXXXXXXXX----------XX----------XXXXXXXXXXXXXXX
XXXXXXXXXXXXXXXXXXXXXXXXXXXXXXXXXXXXXXXXXXXXXXXXXXXXXXXXXXXXXXXXXXXXXXXXXXXXXXXXXXXXXXXXXXXXXXXXXXXXXXXXXXXXXXXXXXXXXXXXXXXXXXXXXXXXXXXXXXXXXXXXXXXXXXXXXXXXXXXXXXXXXXXXXXXXXXXXXXXXXXXXXXXXXXXXXXXXXXXX

