--------------------------------------------------------------------------------------------------------------------------------------------------------------------------------------------------------
--------------------------------------------------------------------------------------------------------------------------------------------------------------------------------------------------------
--------------------------------------------------------------------------------------------------------------------------------------------------------------------------------------------------------
--------------------------------------------------------------------------------------------------------------------------------------------------------------------------------------------------------
--------------------------------------------------------------------------------------------------------------------------------------------------------------------------------------------------------
--------------------------------------------------------------------------------------------------------------------------------------------------------------------------------------------------------
--------------------------------------------------------------------------------------------------------------------------------------------------------------------------------------------------------
--------------------------------------------------------------------------------------------------------------------------------------------------------------------------------------------------------
--------------------------------------------------------------------------------------------------------------------------------------------------------------------------------------------------------
--------------------------------------------------------------------------------------------------------------------------------------------------------------------------------------------------------
--------------------------------------------------------------------------------------------------------------------------------------------------------------------------------------------------------
--------------------------------------------------------------------------------------------------------------------------------------------------------------------------------------------------------
----------------------------------------------------------------SSooo-------------------------------ooo------Soo---------SoooSo-------------------------------------------------------------------------
--------------------------------------------------------------------------------------------------------------------------------------------------------------------------------------------------------
-----------------------------------------------------------------oo----------------------------------------ooo-----------ooo-------------Soo----------------------oSoSo---------------------------------
---------------oSooo------------oSSSo--------------------------------------------oooooSS-------------------g------------------------------------oooo---oooo-----------------oooo-------------ooSooo-----
--------------------------XXX------------------XXXX----------XXXXXXXXXX---XX---------------XXXX---XXXXXXXXXXXXXXX----XXXXXXXXXXX------ooooo------------g---------ooooo----------------------------------
---------------------XXXXXXXX---ooooo--oooo----XXXX----------XXXXXXXXXX---XX-------oooo----XXXX---XXXXXXXXXXXXXXX----XXXXXXXXXXXXXXXX-------------oo--XXXXXXXXX-------------oooo-------------ooooooo----
XXXXXXXXXXXXXX-------XXXXXXXX------------------XXXXXXXXX-----XXXXXXXXXX---XXXXXX-----------XXXX---XXXXXXXXXXXXXXXXXXXXXXXXXXXXXXXXXXXXXXXXXXXXX-------XXXXXXXXXXXXXXXXXX-------------XXXXX--------------
XXXXXXXXXXXXXXXXXXXXXXXXXXXXXXXXXXXXXXXXXXXXXXXXXXXXXXXXXXXXXXXXXXXXXXXXXXXXXXXXXXXXXXXXXXXXXXXXXXXXXXXXXXXXXXXXXXXXXXXXXXXXXXXXXXXXXXXXXXXXXXXXXXXXXXXXXXXXXXXXXXXXXXXXXXXXXXXXXXXXXXXXXXXXXXXXXXXXXXXX

