--------------------------------------------------------------------------------------------------------------------------------------------------------------------------------------------------------
--------------------------------------------------------------------------------------------------------------------------------------------------------------------------------------------------------
--------------------------------------------------------------------------------------------------------------------------------------------------------------------------------------------------------
--------------------------------------------------------------------------------------------------------------------------------------------------------------------------------------------------------
--------------------------------------------------------------------------------------------------------------------------------------------------------------------------------------------------------
--------------------------------------------------------------------------------------------------------------------------------------------------------------------------------------------------------
--------------------------------------------------------------------------------------------------------------------------------------------------------------------------------------------------------
--------------------------------------------------------------------------------------------------------------------------------------------------------------------------------------------------------
--------------------------------------------------------------------------------------------------------------------------------------------------------------------------------------------------------
--------------------------------------------------------------------------------------------------------------------------------------------------------------------------------------------------------
--------------------------------------------------------------------------------------------------------------------------------------------------------------------------------------------------------
--------------------------------------------------------------------------------------------------------------------------------------------------------------------------------------------------------
--------------------------------------Sooooo-----------------------------------------ooSooo---------------------------------------------------------------------------oooo------------------------------
---------------------------oSo----------------ooSooS--------------------------Soo--------------------------------------SoSSSo---oooo--------------------------------------------------------------------
----------------ooSo--------------------oooo-----------------------------------------oooooooo------SSo------------------------------------------ooooo------ooo---------ooo---ooo-------------oSo--------
-------------------------------------------------oooo--------oSooooo----------oo-----------------------------------------ooo---------------------------------------------------------oooo---------------
------------------oo---XXX------XXXXXXXXXXXXX---------------------------------------XXXXXXXXXXXXX----oo--------------------------g------ooo----XXXXXXXXXXXXXXXXX----XXXXXXXXXXXXXX---------oo-----ooooo-
-------------XX--------XXXXXXXXXXXXXXXXXXXXXXXXXXXXXXXXXXXXX----ooooo--XXXXXXXXXXXXXXXXXXXXXXXXXX----------------ooo-XXXXXXXXXXXXXXXX----------XXXXXXXXXXXXXXXXX----XXXXXXXXXXXXXX---ooo----------------
XXXXXXXXXXXXXXXXXXXXXXXXXXXXXXXXXXXXXXXXXXXXXXXXXXXXXXXXXXXX-----------XXXXXXXXXXXXXXXXXXXXXXXXXXXXXXXXXXX-----------XXXXXXXXXXXXXXXXXXXXXXXXXXXXXXXXXXXXXXXXXXX----XXXXXXXXXXXXXX--------XXXXXXXXXXXXXX
XXXXXXXXXXXXXXXXXXXXXXXXXXXXXXXXXXXXXXXXXXXXXXXXXXXXXXXXXXXXXXXXXXXXXXXXXXXXXXXXXXXXXXXXXXXXXXXXXXXXXXXXXXXXXXXXXXXXXXXXXXXXXXXXXXXXXXXXXXXXXXXXXXXXXXXXXXXXXXXXXXXXXXXXXXXXXXXXXXXXXXXXXXXXXXXXXXXXXXXX

