--------------------------------------------------------------------------------------------------------------------------------------------------------------------------------------------------------
--------------------------------------------------------------------------------------------------------------------------------------------------------------------------------------------------------
--------------------------------------------------------------------------------------------------------------------------------------------------------------------------------------------------------
--------------------------------------------------------------------------------------------------------------------------------------------------------------------------------------------------------
--------------------------------------------------------------------------------------------------------------------------------------------------------------------------------------------------------
--------------------------------------------------------------------------------------------------------------------------------------------------------------------------------------------------------
--------------------------------------------------------------------------------------------------------------------------------------------------------------------------------------------------------
--------------------------------------------------------------------------------------------------------------------------------------------------------------------------------------------------------
--------------------------------------------------------------------------------------------------------------------------------------------------------------------------------------------------------
--------------------------------------------------------------------------------------------------------------------------------------------------------------------------------------------------------
--------------------------------------------------------------------------------------------------------------------------------------------------------------------------------------------------------
--------------------------------------------------------------------------------------------------------------------------------------------------------------------------------------------------------
-----------------------oSoooo-----------------------------------------------------Soo---ooo-------------------------------------------------------------------------------------------------------------
-------------------------------------------------------------------------ooooo--------------------------------oSo----oSSooS----------------ooSoo--------------------------------------------------------
----------------SSo---oooooo-------------oSSoSoo-----SSoSo----ooooSo-------------------------------------------------------------------------------------------------------------------oSoSo------------
--------------------------------SSoSo--------------------------------------------g---------------------------ooooo---ooooo-----oooooSoo-----oooo-------------------------oSoSoo-------------------------
---------------ooo--XXXXXXXXXX-------------oooo-----ooo-------oooooo-----------XXXXXXXXXXXXX---------------------------------------------------------------------oooo-------------------ooo-------------
--------------------XXXXXXXXXX-ooooo----------g-------------------------XXXXXXXXXXXXXXXXXXXX-ooooo---XXXXXXXXXXXXXXXXXXXXXXXXX--oooooo---XXXXXXXXX----ooooooo--------------ooooo--------------oooo------
--------------XXXXXXXXXXXXXXXX---g------XXXXXXXXXXXXXXXXXXXXXXXXXXXXXXXXXXXXXXXXXXXXXXXXXXXX---------XXXXXXXXXXXXXXXXXXXXXXXXX-----------XXXXXXXXX------------XXXXXXXXXX-----------XXXXXXXXXX-----------
XXXXXXXXXXXXXXXXXXXXXXXXXXXXXXXXXXXXXXXXXXXXXXXXXXXXXXXXXXXXXXXXXXXXXXXXXXXXXXXXXXXXXXXXXXXXXXXXXXXXXXXXXXXXXXXXXXXXXXXXXXXXXXXXXXXXXXXXXXXXXXXXXXXXXXXXXXXXXXXXXXXXXXXXXXXXXXXXXXXXXXXXXXXXXXXXXXXXXXXX

