--------------------------------------------------------------------------------------------------------------------------------------------------------------------------------------------------------
--------------------------------------------------------------------------------------------------------------------------------------------------------------------------------------------------------
--------------------------------------------------------------------------------------------------------------------------------------------------------------------------------------------------------
--------------------------------------------------------------------------------------------------------------------------------------------------------------------------------------------------------
--------------------------------------------------------------------------------------------------------------------------------------------------------------------------------------------------------
--------------------------------------------------------------------------------------------------------------------------------------------------------------------------------------------------------
--------------------------------------------------------------------------------------------------------------------------------------------------------------------------------------------------------
--------------------------------------------------------------------------------------------------------------------------------------------------------------------------------------------------------
--------------------------------------------------------------------------------------------------------------------------------------------------------------------------------------------------------
--------------------------------------------------------------------------------------------------------------------------------------------------------------------------------------------------------
--------------------------------------------------------------------------------------------------------------------------------------------------------------------------------------------------------
--------------------------------------------------------------------------------------------------------------------------------------------------------------------------------------------------------
-----------------------------------------------------------oSooS---------------------oSoS--------------------------ooooSo--------------------------------------SoSoS------------------------------------
-------------------------oSS--------------------------------------------------------------------------------------------------oSooSo--------------------------------------------------------------------
------------------oo--------------------------------------oooo-----------------------oooo---------------------------ooooo------------------------------------oooooo---------------------ooSo------------
----------------------------oo----------ooooooo------------------------------------------------------ooo---------------------oooooo----------------ooSoo-----------------------oooSooo------------------
------------XXXXXXXXXXXX---------------------------------XXXXXXXXX-----------------XXXXXXXXXX--------------------XXXXXXXXXX-----------XXX-ooooo------------XXXXXXXXXXX----------------------------------
------------XXXXXXXXXXXXXXXXXXX-------XXXXXXXXXX---------XXXXXXXXX--------------XXXXXXXXXXXXXXXXXXXXXXXXX--------XXXXXXXXXXXXXXXXXXXXXXXX---------ooooooo--XXXXXXXXXXX--------oooooo--------------XXX---
XXXXXXXXXXXXXXXXXXXXXXXXXXXXXXXXXXXXXXXXXXXXXXXXXXXX-----XXXXXXXXXXXXXXXXXXXXXXXXXXXXXXXXXXXXXXXXXXXXXXXXXXXX----XXXXXXXXXXXXXXXXXXXXXXXXXXXXXXXX----------XXXXXXXXXXXXX---------------XXXXXXX----XXX---
XXXXXXXXXXXXXXXXXXXXXXXXXXXXXXXXXXXXXXXXXXXXXXXXXXXXXXXXXXXXXXXXXXXXXXXXXXXXXXXXXXXXXXXXXXXXXXXXXXXXXXXXXXXXXXXXXXXXXXXXXXXXXXXXXXXXXXXXXXXXXXXXXXXXXXXXXXXXXXXXXXXXXXXXXXXXXXXXXXXXXXXXXXXXXXXXXXXXXXXX

