--------------------------------------------------------------------------------------------------------------------------------------------------------------------------------------------------------
--------------------------------------------------------------------------------------------------------------------------------------------------------------------------------------------------------
--------------------------------------------------------------------------------------------------------------------------------------------------------------------------------------------------------
--------------------------------------------------------------------------------------------------------------------------------------------------------------------------------------------------------
--------------------------------------------------------------------------------------------------------------------------------------------------------------------------------------------------------
--------------------------------------------------------------------------------------------------------------------------------------------------------------------------------------------------------
--------------------------------------------------------------------------------------------------------------------------------------------------------------------------------------------------------
--------------------------------------------------------------------------------------------------------------------------------------------------------------------------------------------------------
--------------------------------------------------------------------------------------------------------------------------------------------------------------------------------------------------------
--------------------------------------------------------------------------------------------------------------------------------------------------------------------------------------------------------
--------------------------------------------------------------------------------------------------------------------------------------------------------------------------------------------------------
--------------------------------------------------------------------------------------------------------------------------------------------------------------------------------------------------------
-----------------------------------------------oSo-------------------------------ooooSSooo---------------------------------------------------------------ooSS-------------------------------------------
--------------------------------------------------------------------------------------------------------------------------------------------------SSooo--------------ooo--------------------------------
----------------------------------------------oooo--------------------------------ooooo----------------------ooSS-----oooo----------------------------------oo------------------------------------------
---------------oooo---------oSoS------------------------oo---------------oSoSS----------------------SSS------------------------------Soooo--------ooooo-----g--------oooo--oooo--------SoooSS-----------
--------------------------------------------XXXXXXX-----------------------------XXXXXXXXXXX----------------------------oo----XXXXX----------------------XXXXXXXXX---------------------------------------
-------------XXXXXXXXX-----ooooooo----ooo---XXXXXXXXXXXXXXXX-------XXXXX----ooo-XXXXXXXXXXXXX-----ooooo----------------------XXXXX--oooooo-----XXXXXXXXXXXXXXXXXXXXXXXXXXXXXXXXXXX-------ooo---XXXXXXXXX
XXXXXXXXXXXXXXXXXXXXXX-----gg---------------XXXXXXXXXXXXXXXXXXXXXXXXXXXX--------XXXXXXXXXXXXXXX-----------XXXXXXXXXXXXXXXXXXXXXXXX-------------XXXXXXXXXXXXXXXXXXXXXXXXXXXXXXXXXXX-------------XXXXXXXXX
XXXXXXXXXXXXXXXXXXXXXXXXXXXXXXXXXXXXXXXXXXXXXXXXXXXXXXXXXXXXXXXXXXXXXXXXXXXXXXXXXXXXXXXXXXXXXXXXXXXXXXXXXXXXXXXXXXXXXXXXXXXXXXXXXXXXXXXXXXXXXXXXXXXXXXXXXXXXXXXXXXXXXXXXXXXXXXXXXXXXXXXXXXXXXXXXXXXXXXXX

