--------------------------------------------------------------------------------------------------------------------------------------------------------------------------------------------------------
--------------------------------------------------------------------------------------------------------------------------------------------------------------------------------------------------------
--------------------------------------------------------------------------------------------------------------------------------------------------------------------------------------------------------
--------------------------------------------------------------------------------------------------------------------------------------------------------------------------------------------------------
--------------------------------------------------------------------------------------------------------------------------------------------------------------------------------------------------------
--------------------------------------------------------------------------------------------------------------------------------------------------------------------------------------------------------
--------------------------------------------------------------------------------------------------------------------------------------------------------------------------------------------------------
--------------------------------------------------------------------------------------------------------------------------------------------------------------------------------------------------------
--------------------------------------------------------------------------------------------------------------------------------------------------------------------------------------------------------
--------------------------------------------------------------------------------------------------------------------------------------------------------------------------------------------------------
--------------------------------------------------------------------------------------------------------------------------------------------------------------------------------------------------------
--------------------------------------------------------------------------------------------------------------------------------------------------------------------------------------------------------
-----------------------------Sooo-------------------------------------------------------------------------oooSoo----------------------------------------------------------------------------------------
-------------------------------------------------------------------------------oooooo-------------------------------------------------------------------------------------------------------------------
---------------oooSoo--------ooooo-----------------------ooooo---------------------------oSoo--------------ooooo-----ooo----SoSS----Soooo-----------------------SoSo------------------------------------
-------------------------------------------------------------------------------ooooo--------------------------------------------------------------SSo----------------------------oSSooSo----------------
---------------ooooo-------XXXXXXXX-----------XXXXXXXXXX---oo----XXXXXXXXXXXX------------ooooo--------XXXXXXXXXXX-----------oo--------------------------------oooo-----------------------XXXXX-------XXX
---------------------------XXXXXXXX-----XXXXXXXXXXXXXXXX-g-------XXXXXXXXXXXXXXXXXXXXXXX----g---------XXXXXXXXXXX-----g-------------------------oooo---------------------------oooooooo--XXXXX-------XXX
XXXXXXXXXXXXXXXXXXXXXXXXXXXXXXXXXXXXXXXXXXXXXXXXXXXXXXXXXXXXXXXXXXXXXXXXXXXXXXXXXXXXXXXXXXXXXXXXXXXXXXXXXXXXXXXXXXXXXXXXXXXXXXXXXXXXXXXXXXXXXX--------XXXXXXXXXXXXXXXX---XXXXX-----------XXXXX-------XXX
XXXXXXXXXXXXXXXXXXXXXXXXXXXXXXXXXXXXXXXXXXXXXXXXXXXXXXXXXXXXXXXXXXXXXXXXXXXXXXXXXXXXXXXXXXXXXXXXXXXXXXXXXXXXXXXXXXXXXXXXXXXXXXXXXXXXXXXXXXXXXXXXXXXXXXXXXXXXXXXXXXXXXXXXXXXXXXXXXXXXXXXXXXXXXXXXXXXXXXXX

