--------------------------------------------------------------------------------------------------------------------------------------------------------------------------------------------------------
--------------------------------------------------------------------------------------------------------------------------------------------------------------------------------------------------------
--------------------------------------------------------------------------------------------------------------------------------------------------------------------------------------------------------
--------------------------------------------------------------------------------------------------------------------------------------------------------------------------------------------------------
--------------------------------------------------------------------------------------------------------------------------------------------------------------------------------------------------------
--------------------------------------------------------------------------------------------------------------------------------------------------------------------------------------------------------
--------------------------------------------------------------------------------------------------------------------------------------------------------------------------------------------------------
--------------------------------------------------------------------------------------------------------------------------------------------------------------------------------------------------------
--------------------------------------------------------------------------------------------------------------------------------------------------------------------------------------------------------
--------------------------------------------------------------------------------------------------------------------------------------------------------------------------------------------------------
--------------------------------------------------------------------------------------------------------------------------------------------------------------------------------------------------------
--------------------------------------------------------------------------------------------------------------------------------------------------------------------------------------------------------
------------------------------------------oooooo---------------------------------------oSoooo-----------------------------------------------------SSSoo-----ooSSo-----------ooo-------------------------
-----------------------------------------------g---------oSoo---------------------------------------------------------------------------------------------------------Soo---------------------------ooo-
-------------------------oo--------------%%%%%%%------------------------------------------oooo-------------------------------------------ooS------oooooooo----------------------------------------------
------------------SSSo-------------------|||||||--------ooooo-----Soo--------oSoSo----------------ooSoSooo-------------------------------------------g---------------oooo-----gg--------------oo--------
------------------------XXXXXX----------XXXXXXXXXXXXXXX-------------------------------XXXXXXXXXX----------------XXXXX-------------------oooo----XXXXXXXXXXXXXXXXXX---------XXXXXXXX---------------g-----
XXXXXXXXXXXXXX-ooooooo--XXXXXX-----oooo-XXXXXXXXXXXXXXXXXXXXXXX--ooooo--XX------oo----XXXXXXXXXX----oooo--------XXXXXXX-------------------------XXXXXXXXXXXXXXXXXXXXXXXXXXXXXXXXXXX-------XXXXXXXXXXXXXX
XXXXXXXXXXXXXX----------XXXXXX----------XXXXXXXXXXXXXXXXXXXXXXX---------XX------------XXXXXXXXXX---g-------XXXXXXXXXXXXXXXXXXXXXXXXXXXXXXXXXXXXXXXXXXXXXXXXXXXXXXXXXXXXXXXXXXXXXXXX-------XXXXXXXXXXXXXX
XXXXXXXXXXXXXXXXXXXXXXXXXXXXXXXXXXXXXXXXXXXXXXXXXXXXXXXXXXXXXXXXXXXXXXXXXXXXXXXXXXXXXXXXXXXXXXXXXXXXXXXXXXXXXXXXXXXXXXXXXXXXXXXXXXXXXXXXXXXXXXXXXXXXXXXXXXXXXXXXXXXXXXXXXXXXXXXXXXXXXXXXXXXXXXXXXXXXXXXX

