--------------------------------------------------------------------------------------------------------------------------------------------------------------------------------------------------------
--------------------------------------------------------------------------------------------------------------------------------------------------------------------------------------------------------
--------------------------------------------------------------------------------------------------------------------------------------------------------------------------------------------------------
--------------------------------------------------------------------------------------------------------------------------------------------------------------------------------------------------------
--------------------------------------------------------------------------------------------------------------------------------------------------------------------------------------------------------
--------------------------------------------------------------------------------------------------------------------------------------------------------------------------------------------------------
--------------------------------------------------------------------------------------------------------------------------------------------------------------------------------------------------------
--------------------------------------------------------------------------------------------------------------------------------------------------------------------------------------------------------
--------------------------------------------------------------------------------------------------------------------------------------------------------------------------------------------------------
--------------------------------------------------------------------------------------------------------------------------------------------------------------------------------------------------------
--------------------------------------------------------------------------------------------------------------------------------------------------------------------------------------------------------
--------------------------------------------------------------------------------------------------------------------------------------------------------------------------------------------------------
---------------------------------------------------Sooo-------------------------------------oooo--------------oSoSoo--------------------------------------------SSo--------------------ooS--------------
--------------oooooo----------------------------------------------------------------------------------------------------ooooo------------------------------------------oSS----------------------Soo-----
--------------------------------------oooooo--------oo--------------oSo--------ooo------------------------------oo---------------------oooo------------------oooo---------------------------------------
------------oooooo------------SSoooo-----------------------ooo----------------------------------------ooo------g-------ooooo----------------------oSo-----------------ooooo----SooS-----------oooooo----
-----------------------------------------oooo---XXXXXXXXXX---------oo--------------XXXX----XXXXXXXX----------XXXXXXXX-g---g--------------ooooo----------XXXXXXXXXXXXX--g--g-----------XXXXXX------------
-----------XXXXXXXXXX--------ooooo--------------XXXXXXXXXXXXXXXXXX-----------------XXXX----XXXXXXXX-ooooooo--XXXXXXXXXXXXXXXXXXX----------------oooo----XXXXXXXXXXXXXXXXXXXXX---------XXXXXXXXXXXXXXXXXX
XXXXXXXXXXXXXXXXXXXXXXXXXXXX---------XXXXXXXXXXXXXXXXXXXXXXXXXXXXXXXXXXXXXXXXXXXXXXXXXXXXXXXXXXXXXX----------XXXXXXXXXXXXXXXXXXXXXXXXXXXXXXXXXX---------XXXXXXXXXXXXXXXXXXXXX---------XXXXXXXXXXXXXXXXXX
XXXXXXXXXXXXXXXXXXXXXXXXXXXXXXXXXXXXXXXXXXXXXXXXXXXXXXXXXXXXXXXXXXXXXXXXXXXXXXXXXXXXXXXXXXXXXXXXXXXXXXXXXXXXXXXXXXXXXXXXXXXXXXXXXXXXXXXXXXXXXXXXXXXXXXXXXXXXXXXXXXXXXXXXXXXXXXXXXXXXXXXXXXXXXXXXXXXXXXXX

