--------------------------------------------------------------------------------------------------------------------------------------------------------------------------------------------------------
--------------------------------------------------------------------------------------------------------------------------------------------------------------------------------------------------------
--------------------------------------------------------------------------------------------------------------------------------------------------------------------------------------------------------
--------------------------------------------------------------------------------------------------------------------------------------------------------------------------------------------------------
--------------------------------------------------------------------------------------------------------------------------------------------------------------------------------------------------------
--------------------------------------------------------------------------------------------------------------------------------------------------------------------------------------------------------
--------------------------------------------------------------------------------------------------------------------------------------------------------------------------------------------------------
--------------------------------------------------------------------------------------------------------------------------------------------------------------------------------------------------------
--------------------------------------------------------------------------------------------------------------------------------------------------------------------------------------------------------
--------------------------------------------------------------------------------------------------------------------------------------------------------------------------------------------------------
--------------------------------------------------------------------------------------------------------------------------------------------------------------------------------------------------------
--------------------------------------------------------------------------------------------------------------------------------------------------------------------------------------------------------
-----------------------------------------------------ooSooo-------------------------------Soo-----------------------------ooo---------------------------------------------------------------------------
----------------------------------------oSo-------------------------------------------------------------------------------------------------------------------------------------------------------------
---------------------------------oo-----------------ooooo-----------oSoo--------------------------------------SSoo--------------------------------------------------------------------------------------
------------oSSoo--------------------g---ooo----------------------------------------------------------Soo------------------------oSoSo--ooSSSoSo--------oooo--------------------------------------------
XXXXXXXXXX----------XX---------XXXXXXXX------------XXXXXXXXXX-------ooooooo------------XXXXXXX--------------ooooo----XXXXXXXXX------------------------------------XXXX-----------XXXXXXXXX-----XX-------
XXXXXXXXXX----oooo--XX---------XXXXXXXXXXXXXX---g--XXXXXXXXXX--------------------------XXXXXXX--------ooo------------XXXXXXXXX-oooooo---ooooo----------oo----XXXXXXXXX-------XXXXXXXXXXXXX-----XX--XXXXX
XXXXXXXXXX----------XXXXXXXX---XXXXXXXXXXXXXXXXXXXXXXXXXXXXXXXX--XXXXXXXXXXXXXXXX------XXXXXXX-------g--g-XXXXXXXXXXXXXXXXXXXX-------------------XXXXX-------XXXXXXXXX-----XXXXXXXXXXXXXXX-----XX--XXXXX
XXXXXXXXXXXXXXXXXXXXXXXXXXXXXXXXXXXXXXXXXXXXXXXXXXXXXXXXXXXXXXXXXXXXXXXXXXXXXXXXXXXXXXXXXXXXXXXXXXXXXXXXXXXXXXXXXXXXXXXXXXXXXXXXXXXXXXXXXXXXXXXXXXXXXXXXXXXXXXXXXXXXXXXXXXXXXXXXXXXXXXXXXXXXXXXXXXXXXXXX

