--------------------------------------------------------------------------------------------------------------------------------------------------------------------------------------------------------
--------------------------------------------------------------------------------------------------------------------------------------------------------------------------------------------------------
--------------------------------------------------------------------------------------------------------------------------------------------------------------------------------------------------------
--------------------------------------------------------------------------------------------------------------------------------------------------------------------------------------------------------
--------------------------------------------------------------------------------------------------------------------------------------------------------------------------------------------------------
--------------------------------------------------------------------------------------------------------------------------------------------------------------------------------------------------------
--------------------------------------------------------------------------------------------------------------------------------------------------------------------------------------------------------
--------------------------------------------------------------------------------------------------------------------------------------------------------------------------------------------------------
--------------------------------------------------------------------------------------------------------------------------------------------------------------------------------------------------------
--------------------------------------------------------------------------------------------------------------------------------------------------------------------------------------------------------
--------------------------------------------------------------------------------------------------------------------------------------------------------------------------------------------------------
--------------------------------------------------------------------------------------------------------------------------------------------------------------------------------------------------------
--------------------------------------------------ooo-------------------------------------------------------------ooo---------------------------------------------------------oSSoo---------------------
-------------------------------------------------------oooooo----------------------------------------------------------------------------------------------------------------------------ooSoSoo--------
---------------ooSSS------------------------------------------------------------------------SSSo---------ooS---oooo---------------------------------oSSoooS-------------------ooo-----------------------
------------------------ooooo-----------------------------------oooS--------ooSSSSooo----------------------------------------------oooo----oooo-----------------------ooo------------------oo-----------
XXXXXXXXXXX-oooooo-----------------------------XXXXXXX----------------XXXXX-----------XX--oooo----------oooo--XXXXXXXX--XXXXX------------------------ooooo----------------XXXXXXXXXX-----------g--------
XXXXXXXXXXX---------------ooooo----------------XXXXXXXXXXXXXXX--------XXXXX-oooooo----XX----------------------XXXXXXXX--XXXXX-----XXXXXXXX----ooo-----g--------------oooo-XXXXXXXXXXXXXXXXXXXXXXXXXXXXXX
XXXXXXXXXXXXXXXXXXXXXX---g-------XXXXXX--------XXXXXXXXXXXXXXX--------XXXXX-----------XXXXXXXXXXXXXXXXXXXXXXXXXXXXXXXXXXXXXXX-----XXXXXXXX---------XXXXXXXXXXXXXXX--------XXXXXXXXXXXXXXXXXXXXXXXXXXXXXX
XXXXXXXXXXXXXXXXXXXXXXXXXXXXXXXXXXXXXXXXXXXXXXXXXXXXXXXXXXXXXXXXXXXXXXXXXXXXXXXXXXXXXXXXXXXXXXXXXXXXXXXXXXXXXXXXXXXXXXXXXXXXXXXXXXXXXXXXXXXXXXXXXXXXXXXXXXXXXXXXXXXXXXXXXXXXXXXXXXXXXXXXXXXXXXXXXXXXXXXX

