--------------------------------------------------------------------------------------------------------------------------------------------------------------------------------------------------------
--------------------------------------------------------------------------------------------------------------------------------------------------------------------------------------------------------
--------------------------------------------------------------------------------------------------------------------------------------------------------------------------------------------------------
--------------------------------------------------------------------------------------------------------------------------------------------------------------------------------------------------------
--------------------------------------------------------------------------------------------------------------------------------------------------------------------------------------------------------
--------------------------------------------------------------------------------------------------------------------------------------------------------------------------------------------------------
--------------------------------------------------------------------------------------------------------------------------------------------------------------------------------------------------------
--------------------------------------------------------------------------------------------------------------------------------------------------------------------------------------------------------
--------------------------------------------------------------------------------------------------------------------------------------------------------------------------------------------------------
--------------------------------------------------------------------------------------------------------------------------------------------------------------------------------------------------------
--------------------------------------------------------------------------------------------------------------------------------------------------------------------------------------------------------
--------------------------------------------------------------------------------------------------------------------------------------------------------------------------------------------------------
-------------------------------------------------------------------------------------------------------------------------ooSS----------------ooooo------------------------------------------------------
--------------------------------------------------------------------------------------------------------------------------------------------------------------------------------ooSSoSo-----------------
------------------SSo-----------------------------------ooooooo----------ooS--------------------------SoSoo--------------ooooo---------------oooo----------------oooSS----oooo--------------------------
---------------------------------oSo----oSoS------------------------------------oooooSo--------------------------------------g---------------------------------------------------oooo-------------------
---------------ooooooo------------------------------------ooooo-----------oo------------XXX--XXXXX-ooooooo-------XXXXXXXXXXXXXXXX-----------XXXXXXXXX------------oooo-----oo-----------------------XXXXX
-----------------------------------------oooo----------------------------------oooooo---XXX--XXXXX---------------XXXXXXXXXXXXXXXXXXXXXXXXXXXXXXXXXXXX---XXXXXXX----------------XXXXXXXXX------XXXXXXXXXX
XXXXXXXXXXXXXXXXXXXXXXXX-----------------------XXX----XXXXXXXXXXXX----XXXXXXXX----------XXX--XXXXXXXXXXXXXXXX----XXXXXXXXXXXXXXXXXXXXXXXXXXXXXXXXXXXX---XXXXXXXXXXXXXXXXXXXXXXXXXXXXXXXXXX----XXXXXXXXXX
XXXXXXXXXXXXXXXXXXXXXXXXXXXXXXXXXXXXXXXXXXXXXXXXXXXXXXXXXXXXXXXXXXXXXXXXXXXXXXXXXXXXXXXXXXXXXXXXXXXXXXXXXXXXXXXXXXXXXXXXXXXXXXXXXXXXXXXXXXXXXXXXXXXXXXXXXXXXXXXXXXXXXXXXXXXXXXXXXXXXXXXXXXXXXXXXXXXXXXXX

