--------------------------------------------------------------------------------------------------------------------------------------------------------------------------------------------------------
--------------------------------------------------------------------------------------------------------------------------------------------------------------------------------------------------------
--------------------------------------------------------------------------------------------------------------------------------------------------------------------------------------------------------
--------------------------------------------------------------------------------------------------------------------------------------------------------------------------------------------------------
--------------------------------------------------------------------------------------------------------------------------------------------------------------------------------------------------------
--------------------------------------------------------------------------------------------------------------------------------------------------------------------------------------------------------
--------------------------------------------------------------------------------------------------------------------------------------------------------------------------------------------------------
--------------------------------------------------------------------------------------------------------------------------------------------------------------------------------------------------------
--------------------------------------------------------------------------------------------------------------------------------------------------------------------------------------------------------
--------------------------------------------------------------------------------------------------------------------------------------------------------------------------------------------------------
--------------------------------------------------------------------------------------------------------------------------------------------------------------------------------------------------------
--------------------------------------------------------------------------------------------------------------------------------------------------------------------------------------------------------
-------------------------------------------------------------------ooooo--------------------------------------------------------------------------------------------------------------------------------
---------------------------------------------------------------------------------------oooo----------------------------------------------------------------------------------------------oooSo----------
----------------------------------------------------------SSoS-----ooooooo---------------------------------------------------oooS--------------------ooo---------oSo------------------------------------
---------------------------ooooo----------------SoSoo---------------------------------ooooo---------oooSSo-----ooo------------------------oSoooo--g---------------------------------------oooo----------
---------------------oooo-------------------------------ooooooo--XXXXXXXXXXXXXXXXX------------XX----------------------------oooo----XXXXX--------XXXXXXXX--------oooooo---------------------------------
--------------------------XXXXXXX--------XXX---ooooo-------------XXXXXXXXXXXXXXXXX---XXXXXXXXXXX----oooooo---ooooo------------------XXXXX--------XXXXXXXX---ooo----------------------XXXXXXXXXX-----XXXX
----------XXXXXXXXXXXXXXXXXXXXXXXXXXXXXXXXXX----------XXXXXXXXXXXXXXXXXXXXXXXXXXXXXXXXXXXXXXXXXX--------------------XXXX---XXXXXXXXXXXXXX--------XXXXXXXX--g----XXXXXXXXXXXXXXXXXXXXXXXXXXXXXXX-----XXXX
XXXXXXXXXXXXXXXXXXXXXXXXXXXXXXXXXXXXXXXXXXXXXXXXXXXXXXXXXXXXXXXXXXXXXXXXXXXXXXXXXXXXXXXXXXXXXXXXXXXXXXXXXXXXXXXXXXXXXXXXXXXXXXXXXXXXXXXXXXXXXXXXXXXXXXXXXXXXXXXXXXXXXXXXXXXXXXXXXXXXXXXXXXXXXXXXXXXXXXXX

