--------------------------------------------------------------------------------------------------------------------------------------------------------------------------------------------------------
--------------------------------------------------------------------------------------------------------------------------------------------------------------------------------------------------------
--------------------------------------------------------------------------------------------------------------------------------------------------------------------------------------------------------
--------------------------------------------------------------------------------------------------------------------------------------------------------------------------------------------------------
--------------------------------------------------------------------------------------------------------------------------------------------------------------------------------------------------------
--------------------------------------------------------------------------------------------------------------------------------------------------------------------------------------------------------
--------------------------------------------------------------------------------------------------------------------------------------------------------------------------------------------------------
--------------------------------------------------------------------------------------------------------------------------------------------------------------------------------------------------------
--------------------------------------------------------------------------------------------------------------------------------------------------------------------------------------------------------
--------------------------------------------------------------------------------------------------------------------------------------------------------------------------------------------------------
--------------------------------------------------------------------------------------------------------------------------------------------------------------------------------------------------------
--------------------------------------------------------------------------------------------------------------------------------------------------------------------------------------------------------
------------------------------------------ooSoo------oooS------------------oooSSo---------------------------------------------SSo-----------------------------SSoS----------------oooooSooo-------------
-----------------------oSo-------------------------------------SSooS-------------------------------------------------------------------Sooo-------------------------------------------------------------
-------------------oo-----------------------oooo------oooooo---------------oooooo------------------oooSSo--------------------ooooo---------------------------oooooo---------------oooooo----------------
--------------------------oo---oooooSSo--------------------------oooo-----------------ooSo-----------------oSoSSSoo--------------------ooo--------------------------------ooooSo------------------------
XXXXXXXXXXXXXXXXXXXXXX------------------XXXXXXXXXXXXXXXXXXXXX---------XXXXXXXXXXXXXXX----------------ooo-------------------XXXXXXXXXX-------XX--------------XXXXXXXXXX-----------XXXXXXXXXXX------oo----
XXXXXXXXXXXXXXXXXXXXXXXXXXXXXX----ooo---XXXXXXXXXXXXXXXXXXXXXXXXXXXXXXXXXXXXXXXXXXXXX--------XXXXX-g----g--ooooooo---------XXXXXXXXXXXXXXXXXXX----------ooo-XXXXXXXXXX--ooooooo--XXXXXXXXXXXXXXX--------
XXXXXXXXXXXXXXXXXXXXXXXXXXXXXX----------XXXXXXXXXXXXXXXXXXXXXXXXXXXXXXXXXXXXXXXXXXXXX--------XXXXXXXXXXXXX-----------------XXXXXXXXXXXXXXXXXXXXXXXXXX-------XXXXXXXXXX-----g--g--XXXXXXXXXXXXXXXXXXXXXXX
XXXXXXXXXXXXXXXXXXXXXXXXXXXXXXXXXXXXXXXXXXXXXXXXXXXXXXXXXXXXXXXXXXXXXXXXXXXXXXXXXXXXXXXXXXXXXXXXXXXXXXXXXXXXXXXXXXXXXXXXXXXXXXXXXXXXXXXXXXXXXXXXXXXXXXXXXXXXXXXXXXXXXXXXXXXXXXXXXXXXXXXXXXXXXXXXXXXXXXXX

