--------------------------------------------------------------------------------------------------------------------------------------------------------------------------------------------------------
--------------------------------------------------------------------------------------------------------------------------------------------------------------------------------------------------------
--------------------------------------------------------------------------------------------------------------------------------------------------------------------------------------------------------
--------------------------------------------------------------------------------------------------------------------------------------------------------------------------------------------------------
--------------------------------------------------------------------------------------------------------------------------------------------------------------------------------------------------------
--------------------------------------------------------------------------------------------------------------------------------------------------------------------------------------------------------
--------------------------------------------------------------------------------------------------------------------------------------------------------------------------------------------------------
--------------------------------------------------------------------------------------------------------------------------------------------------------------------------------------------------------
--------------------------------------------------------------------------------------------------------------------------------------------------------------------------------------------------------
--------------------------------------------------------------------------------------------------------------------------------------------------------------------------------------------------------
--------------------------------------------------------------------------------------------------------------------------------------------------------------------------------------------------------
--------------------------------------------------------------------------------------------------------------------------------------------------------------------------------------------------------
-----------------------------------------------------oSSoooo--------------------------------------------------------------------------------------------------------------------------------------------
------------------------------------------------------------------------------------------------------------------------------SSSoS-------------------ooo-----------------------------------------------
----------------------------------oSoS----------------oooooo-----------------ooSSS------------------oSSoSoo------------------------------ooS----------------------------------------------ooo-----------
-------------ooo---ooo------------------------------------------------ooooo-----------oSSSoSooo---------------ooSoSo-----------ooooo----------------oooooo----------------ooo---------------------------
XXXXXXXXXXX------------------------ooooo----------XXXXXXXXXXX------------g---ooooo------------------oooooo----------------------g---------ooo------------g-------oooo-------------------oooooo----------
XXXXXXXXXXX------XXXXXXXXX----------------XXXXXXXXXXXXXXXXXXX------XXXXXXXXX-----------oooooooo-XXX-g---------oooooo--------XXXXXXXXXXX---------XXXXXXXXXXXXX-------------oo------------g---------ooo---
XXXXXXXXXXX------XXXXXXXXX------XXXXXXXXXXXXXXXXXXXXXXXXXXXXXXXXXXXXXXXXXXXXXXXXXXXXX-----------XXXXXXXXXXXXX-----------XXXXXXXXXXXXXXXXXXXXXXXXXXXXXXXXXXXXXXXXXXXXXXXX--g-------XXXXXXXXXXXXXX--------
XXXXXXXXXXXXXXXXXXXXXXXXXXXXXXXXXXXXXXXXXXXXXXXXXXXXXXXXXXXXXXXXXXXXXXXXXXXXXXXXXXXXXXXXXXXXXXXXXXXXXXXXXXXXXXXXXXXXXXXXXXXXXXXXXXXXXXXXXXXXXXXXXXXXXXXXXXXXXXXXXXXXXXXXXXXXXXXXXXXXXXXXXXXXXXXXXXXXXXXX

