--------------------------------------------------------------------------------------------------------------------------------------------------------------------------------------------------------
--------------------------------------------------------------------------------------------------------------------------------------------------------------------------------------------------------
--------------------------------------------------------------------------------------------------------------------------------------------------------------------------------------------------------
--------------------------------------------------------------------------------------------------------------------------------------------------------------------------------------------------------
--------------------------------------------------------------------------------------------------------------------------------------------------------------------------------------------------------
--------------------------------------------------------------------------------------------------------------------------------------------------------------------------------------------------------
--------------------------------------------------------------------------------------------------------------------------------------------------------------------------------------------------------
--------------------------------------------------------------------------------------------------------------------------------------------------------------------------------------------------------
--------------------------------------------------------------------------------------------------------------------------------------------------------------------------------------------------------
--------------------------------------------------------------------------------------------------------------------------------------------------------------------------------------------------------
--------------------------------------------------------------------------------------------------------------------------------------------------------------------------------------------------------
--------------------------------------------------------------------------------------------------------------------------------------------------------------------------------------------------------
----------------------SoSSooo-----------------------------------------------------------------------------------------------ooS-------------------------------------------------------------------------
--------------------------------------------------------------------------------------------------------------------------------------------------------------------------------------------------------
-----------oooo------oooooooo-----------------------------------------------------------------------ooo---------------------------------------------------------oo--------------------------------------
------------------------------------oooSSo-------------------SSooo------------------------------------------ooS-----------------------------------oooo-------------------SoSoSo---------------SoS-------
XXXXXXXXXX--ooo----XXXXXXXXXXX--XX--------------------------------------------------ooooo----------------------------------XXXXXXX--------XXXXXXX-------------XXXXXXX-----------------XX---------------X
XXXXXXXXXX---------XXXXXXXXXXXXXXX--oooooo----ooooo-XXXXX---oooo----XXXX-ooooo-XXX--------XXXXX----------ooooooooo-XXXXX---XXXXXXXXXXXXXXXXXXXXXX-----------XXXXXXXXX--oooooo---------XX-----oooo--XXXXX
XXXXXXXXXXXXXXXXXXXXXXXXXXXXXXXXXX------------------XXXXX----g------XXXX-------XXXXXXXXXXXXXXXX---XXXXXX---g-------XXXXXXXXXXXXXXXXXXXXXXXXXXXXXX-----------XXXXXXXXX-----------------XXXX---------XXXXX
XXXXXXXXXXXXXXXXXXXXXXXXXXXXXXXXXXXXXXXXXXXXXXXXXXXXXXXXXXXXXXXXXXXXXXXXXXXXXXXXXXXXXXXXXXXXXXXXXXXXXXXXXXXXXXXXXXXXXXXXXXXXXXXXXXXXXXXXXXXXXXXXXXXXXXXXXXXXXXXXXXXXXXXXXXXXXXXXXXXXXXXXXXXXXXXXXXXXXXXX

