--------------------------------------------------------------------------------------------------------------------------------------------------------------------------------------------------------
--------------------------------------------------------------------------------------------------------------------------------------------------------------------------------------------------------
--------------------------------------------------------------------------------------------------------------------------------------------------------------------------------------------------------
--------------------------------------------------------------------------------------------------------------------------------------------------------------------------------------------------------
--------------------------------------------------------------------------------------------------------------------------------------------------------------------------------------------------------
--------------------------------------------------------------------------------------------------------------------------------------------------------------------------------------------------------
--------------------------------------------------------------------------------------------------------------------------------------------------------------------------------------------------------
--------------------------------------------------------------------------------------------------------------------------------------------------------------------------------------------------------
--------------------------------------------------------------------------------------------------------------------------------------------------------------------------------------------------------
--------------------------------------------------------------------------------------------------------------------------------------------------------------------------------------------------------
--------------------------------------------------------------------------------------------------------------------------------------------------------------------------------------------------------
--------------------------------------------------------------------------------------------------------------------------------------------------------------------------------------------------------
----------------------------SoSSoSoo-----------ooooo----------------------------ooooSS----------------------------------------------------------------------------------------------------oSo-----------
-----------------------------------------------------------------------SSS------------------------------------------------------------------------------------------------------------------------------
-----------------------------oooooo-------------ooooo---------------------------ooooo-------Soooo------------------oSSooo-------------------------------------------------------------------------------
------------------------------------------------------------------------oooo---------------------------------------------------oooo--oooSSSo----oo-------Soo--------------------------------------------
------------------------XXXXXXXXXXXXX---------XXXXXXXX------------------------XXXXXXXXXXX----oooo----g---XXXXXXXXX---oooooo------------------------------------oo---XX-------oooo-------XXXXXX-ooooo--XX
XXXXXXXXXXXXXXXX--------XXXXXXXXXXXXX------XXXXXXXXXXX---ooo-XXXXX---XXXXXXXXXXXXXXXXXXXX----------XXXXXXXXXXXXXXX---------------------oooo--XXXXXXXXX---oo---------XX------------------XXXXXX-g------XX
XXXXXXXXXXXXXXXX--------XXXXXXXXXXXXXXXX---XXXXXXXXXXX---g---XXXXXXXXXXXXXXXXXXXXXXXXXXXXXXXXXXXXXXXXXXXXXXXXXXXXXXXXXXXXXXX-----------------XXXXXXXXX--------XXXXXXXXXXXXXXXXXXXXXXXXXXXXXXXXXXXXXXXXXX
XXXXXXXXXXXXXXXXXXXXXXXXXXXXXXXXXXXXXXXXXXXXXXXXXXXXXXXXXXXXXXXXXXXXXXXXXXXXXXXXXXXXXXXXXXXXXXXXXXXXXXXXXXXXXXXXXXXXXXXXXXXXXXXXXXXXXXXXXXXXXXXXXXXXXXXXXXXXXXXXXXXXXXXXXXXXXXXXXXXXXXXXXXXXXXXXXXXXXXXX

