--------------------------------------------------------------------------------------------------------------------------------------------------------------------------------------------------------
--------------------------------------------------------------------------------------------------------------------------------------------------------------------------------------------------------
--------------------------------------------------------------------------------------------------------------------------------------------------------------------------------------------------------
--------------------------------------------------------------------------------------------------------------------------------------------------------------------------------------------------------
--------------------------------------------------------------------------------------------------------------------------------------------------------------------------------------------------------
--------------------------------------------------------------------------------------------------------------------------------------------------------------------------------------------------------
--------------------------------------------------------------------------------------------------------------------------------------------------------------------------------------------------------
--------------------------------------------------------------------------------------------------------------------------------------------------------------------------------------------------------
--------------------------------------------------------------------------------------------------------------------------------------------------------------------------------------------------------
--------------------------------------------------------------------------------------------------------------------------------------------------------------------------------------------------------
--------------------------------------------------------------------------------------------------------------------------------------------------------------------------------------------------------
--------------------------------------------------------------------------------------------------------------------------------------------------------------------------------------------------------
-------------------------ooooSSoo--------------------------------------------------------ooS--------------------------------------------------------------------------ooSo------------------------------
----------------------------------------oSSoS----------------------------------------------------oSoooo--------------------------------------------------------------------------ooo--------------------
--------------------------ooooo-----------------ooSoSSooo-------------------ooSo---------ooooo-------------------------oooo-----oooo--------------------------------ooo----------------------------SoS--
-----------------ooooSo----------------ooooooo--------------------oSoSS--------------------------oooooo---------------------------------ooo-----------ooSoo--oo---------------------oo------------------
------------------------XXXXXXXXXXX----------------ooo---------------------ooooooo-XXXXXXXXXXXXX------------------XX----ooo-----ooo-------------------------------XXXXXXXXX-----------------ooo----oo---
---------------oooooo---XXXXXXXXXXX---XXXXXXXXX---------------------ooooo----------XXXXXXXXXXXXXXXXXXXXXX---oo----XX--------------------oooo---------oooooo-XXXXXXXXXXXXXXX-----XXXXXXXX----------------
------------------------XXXXXXXXXXX---XXXXXXXXXXXXXXXXXXXXXXXXXXX---------XXXXXXXXXXXXXXXXXXXXXXXXXXXXXXX------g--XXXXXXXXXXXXXXXXXXXXX---------------------XXXXXXXXXXXXXXX-----XXXXXXXXXXXXXXXXXXXXXXXX
XXXXXXXXXXXXXXXXXXXXXXXXXXXXXXXXXXXXXXXXXXXXXXXXXXXXXXXXXXXXXXXXXXXXXXXXXXXXXXXXXXXXXXXXXXXXXXXXXXXXXXXXXXXXXXXXXXXXXXXXXXXXXXXXXXXXXXXXXXXXXXXXXXXXXXXXXXXXXXXXXXXXXXXXXXXXXXXXXXXXXXXXXXXXXXXXXXXXXXXX

