--------------------------------------------------------------------------------------------------------------------------------------------------------------------------------------------------------
--------------------------------------------------------------------------------------------------------------------------------------------------------------------------------------------------------
--------------------------------------------------------------------------------------------------------------------------------------------------------------------------------------------------------
--------------------------------------------------------------------------------------------------------------------------------------------------------------------------------------------------------
--------------------------------------------------------------------------------------------------------------------------------------------------------------------------------------------------------
--------------------------------------------------------------------------------------------------------------------------------------------------------------------------------------------------------
--------------------------------------------------------------------------------------------------------------------------------------------------------------------------------------------------------
--------------------------------------------------------------------------------------------------------------------------------------------------------------------------------------------------------
--------------------------------------------------------------------------------------------------------------------------------------------------------------------------------------------------------
--------------------------------------------------------------------------------------------------------------------------------------------------------------------------------------------------------
--------------------------------------------------------------------------------------------------------------------------------------------------------------------------------------------------------
--------------------------------------------------------------------------------------------------------------------------------------------------------------------------------------------------------
----------------ooSSo-----------------------------------------------ooSo-------------------------------------------------------------------------------oooS---------------------------------------------
--------------------------------------------------------------------------------------------------------------------------------------------oooooooo------------SooS------------------Soooo-------------
-----------------ooo---------------------------------------------oooooooo----------------------------------------------------oSo-----Sooo------------------------------------oo----------------oSSSo----
--------------------------------------------oooooo--------------------------------SooSo------ooo---------oSoooo----oSS-----------------------ooooo--------g-----oo---------------------oooo-------------
--------------XXXXXXXXXX-oo----XXXXX--------------------XXXXXXXXXXXXXXXXXXX----------------------XX------------------------oooo----ooooooo------------XXXXXXX---------XXXXXXXXXXXXX-----gg--------------
--------------XXXXXXXXXX--g----XXXXX-------XXXXXXXXXXXXXXXXXXXXXXXXXXXXXXXXXXXXX-ooooooooo-XXXXXXXX--------ooo---ooooooo-------g----g------XXXXXXXXXXXXXXXXXXXXXXXXXXXXXXXXXXXXXXXXXXXXXXXXXXX----------
XXXXXXXXXXXXXXXXXXXXXXXXXXXXXXXXXXXXXXXXXXXXXXXXXXXXXXXXXXXXXXXXXXXXXXXXXXXXXXXX-----------XXXXXXXXXXXXX------------------XXXXXXXXXXXXXXXXXXXXXXXXXXXXXXXXXXXXXXXXXXXXXXXXXXXXXXXXXXXXXXXXXXXXXXXXXXXXXX
XXXXXXXXXXXXXXXXXXXXXXXXXXXXXXXXXXXXXXXXXXXXXXXXXXXXXXXXXXXXXXXXXXXXXXXXXXXXXXXXXXXXXXXXXXXXXXXXXXXXXXXXXXXXXXXXXXXXXXXXXXXXXXXXXXXXXXXXXXXXXXXXXXXXXXXXXXXXXXXXXXXXXXXXXXXXXXXXXXXXXXXXXXXXXXXXXXXXXXXX

