--------------------------------------------------------------------------------------------------------------------------------------------------------------------------------------------------------
--------------------------------------------------------------------------------------------------------------------------------------------------------------------------------------------------------
--------------------------------------------------------------------------------------------------------------------------------------------------------------------------------------------------------
--------------------------------------------------------------------------------------------------------------------------------------------------------------------------------------------------------
--------------------------------------------------------------------------------------------------------------------------------------------------------------------------------------------------------
--------------------------------------------------------------------------------------------------------------------------------------------------------------------------------------------------------
--------------------------------------------------------------------------------------------------------------------------------------------------------------------------------------------------------
--------------------------------------------------------------------------------------------------------------------------------------------------------------------------------------------------------
--------------------------------------------------------------------------------------------------------------------------------------------------------------------------------------------------------
--------------------------------------------------------------------------------------------------------------------------------------------------------------------------------------------------------
--------------------------------------------------------------------------------------------------------------------------------------------------------------------------------------------------------
--------------------------------------------------------------------------------------------------------------------------------------------------------------------------------------------------------
---------------------------------------------------------------ooo-------------------------SoSSooo------------------------------------------------------------------------------------------------------
--------------------------------------------------------------------------------------------------------------------------------------------------------------------------------------------------------
------------------------------------------------------------ooooo-------------------------ooooooo------------------------------ooooooS------------------------------------------------------------------
--------------ooSo------------Soo--------------------------------g-----oSoSoo------ooooo----g---g-----oooSS---------oSS----------------------oooSSSS-----ooo-------------------------------------ooSS---
-------------------------------------------------ooo-------XXXXXXXX----------------------XXXXXXXXXXX----------XXXXX--------XXX-oooooo------------------g-------------XXXX----------------XXXXX----------
------------oooooo------XXXX-oooooo------XXXX---------XXXXXXXXXXXXX-oooooo----XXXXXXXXXXXXXXXXXXXXXX-ooooooo--XXXXX-ooooo--XXX----------------ooooooo-XXXXXXXX-------XXXX---------XXX----XXXXX--oooooo--
------------------------XXXX--------XXXXXXXXXXXXXXXXXXXXXXXXXXXXXXX---g-------XXXXXXXXXXXXXXXXXXXXXX----------XXXXX--------XXXXXXXXXXXXXX-------------XXXXXXXX-------XXXX---------XXXXXXXXXXXX----g-----
XXXXXXXXXXXXXXXXXXXXXXXXXXXXXXXXXXXXXXXXXXXXXXXXXXXXXXXXXXXXXXXXXXXXXXXXXXXXXXXXXXXXXXXXXXXXXXXXXXXXXXXXXXXXXXXXXXXXXXXXXXXXXXXXXXXXXXXXXXXXXXXXXXXXXXXXXXXXXXXXXXXXXXXXXXXXXXXXXXXXXXXXXXXXXXXXXXXXXXXX

