--------------------------------------------------------------------------------------------------------------------------------------------------------------------------------------------------------
--------------------------------------------------------------------------------------------------------------------------------------------------------------------------------------------------------
--------------------------------------------------------------------------------------------------------------------------------------------------------------------------------------------------------
--------------------------------------------------------------------------------------------------------------------------------------------------------------------------------------------------------
--------------------------------------------------------------------------------------------------------------------------------------------------------------------------------------------------------
--------------------------------------------------------------------------------------------------------------------------------------------------------------------------------------------------------
--------------------------------------------------------------------------------------------------------------------------------------------------------------------------------------------------------
--------------------------------------------------------------------------------------------------------------------------------------------------------------------------------------------------------
--------------------------------------------------------------------------------------------------------------------------------------------------------------------------------------------------------
--------------------------------------------------------------------------------------------------------------------------------------------------------------------------------------------------------
--------------------------------------------------------------------------------------------------------------------------------------------------------------------------------------------------------
--------------------------------------------------------------------------------------------------------------------------------------------------------------------------------------------------------
------------------------------------------------------------------------------------------------oSSo-------------------------------------Sooo-----------------------------------------------------------
------------------------------------------------------------------------------------------------------------------------------------------------ooooo---------------------------------------------------
-----------------------------ooSooSo-------------------------------------------------------------ooo---------------------------ooSSoo-----------------------------------------------oooSS---------------
-------------oSSSooo-------------------oooooo----------oSo--------------ooSSooSS----------------------------------------------------------g-----ooo-----oooooo---------Soo-------------------oooo-------
-----------------------------ooooooo--------------------------------oo------------------XXXXXXXXXXXXXXXXXXXXX----------------oooooooo-XXXXXXXX----------------------------------------ooooo-------------
-------------oooooooo-XXX-------------XXXXXXXX---------------------------oooooo-----oo--XXXXXXXXXXXXXXXXXXXXXXXXX---------------------XXXXXXXXXXXXXXXXX--ooooo--------ooooo-------------------ooo---XXXX
----------------------XXXXXXXXXXXXXXXXXXXXXXXXXXXXXXXX-----------XXXXXX-----------------XXXXXXXXXXXXXXXXXXXXXXXXX----------XXXXXXXXXXXXXXXXXXXXXXXXXXXX---------------g-----------XXXXXXXXXX--------XXXX
XXXXXXXXXXXXXXXXXXXXXXXXXXXXXXXXXXXXXXXXXXXXXXXXXXXXXXXXXXXXXXXXXXXXXXXXXXXXXXXXXXXXXXXXXXXXXXXXXXXXXXXXXXXXXXXXXXXXXXXXXXXXXXXXXXXXXXXXXXXXXXXXXXXXXXXXXXXXXXXXXXXXXXXXXXXXXXXXXXXXXXXXXXXXXXXXXXXXXXXX

