--------------------------------------------------------------------------------------------------------------------------------------------------------------------------------------------------------
--------------------------------------------------------------------------------------------------------------------------------------------------------------------------------------------------------
--------------------------------------------------------------------------------------------------------------------------------------------------------------------------------------------------------
--------------------------------------------------------------------------------------------------------------------------------------------------------------------------------------------------------
--------------------------------------------------------------------------------------------------------------------------------------------------------------------------------------------------------
--------------------------------------------------------------------------------------------------------------------------------------------------------------------------------------------------------
--------------------------------------------------------------------------------------------------------------------------------------------------------------------------------------------------------
--------------------------------------------------------------------------------------------------------------------------------------------------------------------------------------------------------
--------------------------------------------------------------------------------------------------------------------------------------------------------------------------------------------------------
--------------------------------------------------------------------------------------------------------------------------------------------------------------------------------------------------------
--------------------------------------------------------------------------------------------------------------------------------------------------------------------------------------------------------
--------------------------------------------------------------------------------------------------------------------------------------------------------------------------------------------------------
------------------------oooSoo----------------------------------------------------------------------------------------------------------------------------------------------------------ooo-------------
------------------------------------------------------------------------------------------------------------------------------------ooooo---------------------------------------------------------------
------------------------oooo-----oooooooo---oSooSo-----------------------------------------------------------------------------------------------oooooSS-----oSoooSSoo----------------------------------
-------------oSoooo-----------------------------------oSo-----------------------------------oooS------------------ooooo----ooo------oooo-----------------------------------Soo------------------ooooo---
---------------------XXXXXXXXXX---oooooo------ooo-----------------------XXXXXXXXXXXXXX------------------XXXXXXX------------------------------------oooo---XX--oooooo-------------------XXXXXXXX---------
---------------oooo--XXXXXXXXXX------------------------ooo--------------XXXXXXXXXXXXXX------oooo--------XXXXXXXXXXXXXXXXXXXXXXXXXXXXXXXXXXX---------------XX-------------ooooooo-------XXXXXXXXXXXXXXXXX
---------------------XXXXXXXXXXXXXXXXXXXXXXXXXXXXXX---g---------XXXXX---XXXXXXXXXXXXXXXXXXX-------------XXXXXXXXXXXXXXXXXXXXXXXXXXXXXXXXXXX-----XXXXXXXXXXXXXXXXXXXXXXX-----------XXXXXXXXXXXXXXXXXXXXXX
XXXXXXXXXXXXXXXXXXXXXXXXXXXXXXXXXXXXXXXXXXXXXXXXXXXXXXXXXXXXXXXXXXXXXXXXXXXXXXXXXXXXXXXXXXXXXXXXXXXXXXXXXXXXXXXXXXXXXXXXXXXXXXXXXXXXXXXXXXXXXXXXXXXXXXXXXXXXXXXXXXXXXXXXXXXXXXXXXXXXXXXXXXXXXXXXXXXXXXXX

