--------------------------------------------------------------------------------------------------------------------------------------------------------------------------------------------------------
--------------------------------------------------------------------------------------------------------------------------------------------------------------------------------------------------------
--------------------------------------------------------------------------------------------------------------------------------------------------------------------------------------------------------
--------------------------------------------------------------------------------------------------------------------------------------------------------------------------------------------------------
--------------------------------------------------------------------------------------------------------------------------------------------------------------------------------------------------------
--------------------------------------------------------------------------------------------------------------------------------------------------------------------------------------------------------
--------------------------------------------------------------------------------------------------------------------------------------------------------------------------------------------------------
--------------------------------------------------------------------------------------------------------------------------------------------------------------------------------------------------------
--------------------------------------------------------------------------------------------------------------------------------------------------------------------------------------------------------
--------------------------------------------------------------------------------------------------------------------------------------------------------------------------------------------------------
--------------------------------------------------------------------------------------------------------------------------------------------------------------------------------------------------------
--------------------------------------------------------------------------------------------------------------------------------------------------------------------------------------------------------
------------------------------------------SoSo---oSSS-----ooSSoS-----------------------------------------------------------------------Soo--------------------------------------------------------------
-------------------------------------------------------------------------ooSo------------------------------ooooo----oooSS-------------------------------------------------------------------------------
-----------------ooSooooo---oo-----------oo-----oooooo----ooooo----------------------------------oSoo-------------------------------oooooooo--oooooooo----------------------ooo-------------------------
-----------------------------------------------------------------------ooooooo---------------------------oooo--------ooo---------------------------------------------------------------oSSSo------------
XXXXXXXXXXXXXXXX---oooo---XXXXXXXX------XXXXXXXXXXXXXXXXXXXXXXXXXXX--------------oo-------XXXXX---oooo-----------------------------XXXXXXXXXX----ooo----ooo-----------XX-oooo---------------------------
XXXXXXXXXXXXXXXX----------XXXXXXXX------XXXXXXXXXXXXXXXXXXXXXXXXXXXXXXXXXXXXXXX-----------XXXXX---------XXXXXXXXXXXXXXXXXXX--------XXXXXXXXXX--------------------ooo--XX---------------oooo---XXXXXXXXXX
XXXXXXXXXXXXXXXXXXXXXXXXXXXXXXXXXX------XXXXXXXXXXXXXXXXXXXXXXXXXXXXXXXXXXXXXXXXXXXXXXXXXXXXXXXXXXXXXXXXXXXXXXXXXXXXXXXXXXXXXXXXXXXXXXXXXXXXXXXXXXXXXXXXXXXXXXX-------XXXXXXXXXXX-------------XXXXXXXXXX
XXXXXXXXXXXXXXXXXXXXXXXXXXXXXXXXXXXXXXXXXXXXXXXXXXXXXXXXXXXXXXXXXXXXXXXXXXXXXXXXXXXXXXXXXXXXXXXXXXXXXXXXXXXXXXXXXXXXXXXXXXXXXXXXXXXXXXXXXXXXXXXXXXXXXXXXXXXXXXXXXXXXXXXXXXXXXXXXXXXXXXXXXXXXXXXXXXXXXXXX

