--------------------------------------------------------------------------------------------------------------------------------------------------------------------------------------------------------
--------------------------------------------------------------------------------------------------------------------------------------------------------------------------------------------------------
--------------------------------------------------------------------------------------------------------------------------------------------------------------------------------------------------------
--------------------------------------------------------------------------------------------------------------------------------------------------------------------------------------------------------
--------------------------------------------------------------------------------------------------------------------------------------------------------------------------------------------------------
--------------------------------------------------------------------------------------------------------------------------------------------------------------------------------------------------------
--------------------------------------------------------------------------------------------------------------------------------------------------------------------------------------------------------
--------------------------------------------------------------------------------------------------------------------------------------------------------------------------------------------------------
--------------------------------------------------------------------------------------------------------------------------------------------------------------------------------------------------------
--------------------------------------------------------------------------------------------------------------------------------------------------------------------------------------------------------
--------------------------------------------------------------------------------------------------------------------------------------------------------------------------------------------------------
--------------------------------------------------------------------------------------------------------------------------------------------------------------------------------------------------------
-----------------------------------------------oSoSooo-------------------------------------------ooS-----------------------oSoSo--------------------------------------------oSooSoo--------Soo----------
--------------------------------------------------------------------------------------------------------------------ooS---------------------------------------------------------------------------------
-------------------oSooS--------------oSS-------oooo-----ooo------ooo----------------------------oo---------oooo----------ooooooooo------------------------------ooooo-----ooooooo-------oooooo---------
-----------------------------------------------g--------------------------------------ooo----------------------------oo------------------------------------g----g------------------------g--------------
-----------------ooooo----XXXXXXXX----ooooo--XXXXXXXXXXX----ooo------------------------------XXXXXXXXXX------oo----------XXXXXXXXXXX--------------------XXXXXXXXXXXXXXX---XXXXXXXXXX--XXXXXXXXXXX-------
------------oo------------XXXXXXXX-----------XXXXXXXXXXX--------------------ooooo-XXXXXXXX---XXXXXXXXXX------------XXXXXXXXXXXXXXXXX--XXX-ooooo---------XXXXXXXXXXXXXXXXXXXXXXXXXXXXXXXXXXXXXXXXX-------
----------------XXXXXXXXXXXXXXXXXXXXXXXXXXXXXXXXXXXXXXXXXXXXXXXXXXXXXXXXXXX-------XXXXXXXX---XXXXXXXXXXXXXXXXXXXXXXXXXXXXXXXXXXXXXXX--XXX---------------XXXXXXXXXXXXXXXXXXXXXXXXXXXXXXXXXXXXXXXXX----XXX
XXXXXXXXXXXXXXXXXXXXXXXXXXXXXXXXXXXXXXXXXXXXXXXXXXXXXXXXXXXXXXXXXXXXXXXXXXXXXXXXXXXXXXXXXXXXXXXXXXXXXXXXXXXXXXXXXXXXXXXXXXXXXXXXXXXXXXXXXXXXXXXXXXXXXXXXXXXXXXXXXXXXXXXXXXXXXXXXXXXXXXXXXXXXXXXXXXXXXXXX

