--------------------------------------------------------------------------------------------------------------------------------------------------------------------------------------------------------
--------------------------------------------------------------------------------------------------------------------------------------------------------------------------------------------------------
--------------------------------------------------------------------------------------------------------------------------------------------------------------------------------------------------------
--------------------------------------------------------------------------------------------------------------------------------------------------------------------------------------------------------
--------------------------------------------------------------------------------------------------------------------------------------------------------------------------------------------------------
--------------------------------------------------------------------------------------------------------------------------------------------------------------------------------------------------------
--------------------------------------------------------------------------------------------------------------------------------------------------------------------------------------------------------
--------------------------------------------------------------------------------------------------------------------------------------------------------------------------------------------------------
--------------------------------------------------------------------------------------------------------------------------------------------------------------------------------------------------------
--------------------------------------------------------------------------------------------------------------------------------------------------------------------------------------------------------
--------------------------------------------------------------------------------------------------------------------------------------------------------------------------------------------------------
--------------------------------------------------------------------------------------------------------------------------------------------------------------------------------------------------------
--------------------------------------------------------------------------------------------------------------------------------------------------------------------------SSooSo------------------------
---------------------ooooooSoo------------------------------------------------ooo---------------------SSo------ooo------------------------------------------------------------------SoSS--------oSoo----
-------------------------------------------------------------------------------------ooo--------------------------------------SSSSS-------------------------------------ooooooo-------------------------
--------------ooSo---oooooooo--------ooooo------------ooooSo---ooSSS--------ooo----------------------ooooooo----------------------------oooS-----------------SSSSo-------------------ooooo------oo------
-----------------------------------------------------------------------------------XXXXXXXXXXXX--------------------------------oo---------------------oo---------------XXXXXXXXXX-----g-----------------
XXXXXXXXXXX--oooooo-XXXXXXXXXXX-----XXXXXXXXXXXXXXX--ooooooo-----ooooo---XXXXXXXXXXXXXXXXXXXXXX-----XXXXXXXXXXXXXXX------XXX-----------oooo---XXXX-----------oooooo----XXXXXXXXXXXXXXXXXXXXXXXXXXXXXX---
XXXXXXXXXXX---------XXXXXXXXXXX-----XXXXXXXXXXXXXXX--------------------XXXXXXXXXXXXXXXXXXXXXXXX-----XXXXXXXXXXXXXXXXXXXXXXXXXXXXXXXXX-----g---XXXXXXXXXXX-----------XXXXXXXXXXXXXXXXXXXXXXXXXXXXXXXXXXXX
XXXXXXXXXXXXXXXXXXXXXXXXXXXXXXXXXXXXXXXXXXXXXXXXXXXXXXXXXXXXXXXXXXXXXXXXXXXXXXXXXXXXXXXXXXXXXXXXXXXXXXXXXXXXXXXXXXXXXXXXXXXXXXXXXXXXXXXXXXXXXXXXXXXXXXXXXXXXXXXXXXXXXXXXXXXXXXXXXXXXXXXXXXXXXXXXXXXXXXXX

