--------------------------------------------------------------------------------------------------------------------------------------------------------------------------------------------------------
--------------------------------------------------------------------------------------------------------------------------------------------------------------------------------------------------------
--------------------------------------------------------------------------------------------------------------------------------------------------------------------------------------------------------
--------------------------------------------------------------------------------------------------------------------------------------------------------------------------------------------------------
--------------------------------------------------------------------------------------------------------------------------------------------------------------------------------------------------------
--------------------------------------------------------------------------------------------------------------------------------------------------------------------------------------------------------
--------------------------------------------------------------------------------------------------------------------------------------------------------------------------------------------------------
--------------------------------------------------------------------------------------------------------------------------------------------------------------------------------------------------------
--------------------------------------------------------------------------------------------------------------------------------------------------------------------------------------------------------
--------------------------------------------------------------------------------------------------------------------------------------------------------------------------------------------------------
--------------------------------------------------------------------------------------------------------------------------------------------------------------------------------------------------------
--------------------------------------------------------------------------------------------------------------------------------------------------------------------------------------------------------
-------------------------------------------------ooSSoooo--------------oSS-----------oooS---------------------------------------------------------------ooo---------------------------------------------
-----------------------------------------------------------------------------------------------SoS------------------------------------------------------------------------------------------------------
--------------oooo---------------------------------ooooooo-------------ooo-------------ooo------------------oSooS---------oooooo-----oo--oSoo-----------ooooo-----oooo-------------------ooo------------
----------------------oo---------------ooooSSoo-----------------------------------------------ooooooo----------------------------------------------------------------------ooSoSS---------------Sooo----
------------oooo------------XXXXX---------------XXXXXXXXXXX-g---------XXXXXXXX-----XXXXXXXX------------------ooo------------ooo--XXXXXXX-oo----------XXXXXXXXXX-ooooooo---------------ooooo-------------
--------------------XXXXXXXXXXXXX--------ooo----XXXXXXXXXXXXXXXXXXXXXXXXXXXXXX-----XXXXXXXXXXXXXXXXXXX-------------XXXXX-----g---XXXXXXX-------------XXXXXXXXXX---------------oooooo------------oooo---X
-----------XXXXXXXXXXXXXXXXXXXXXX---------g-----XXXXXXXXXXXXXXXXXXXXXXXXXXXXXX-----XXXXXXXXXXXXXXXXXXX----XXXXXXXXXXXXXXXXXXXXXXXXXXXXXXXXXXXXXXXXXXXXXXXXXXXXXXXXXXXXXXXX-----------XXXXXXXXX---------X
XXXXXXXXXXXXXXXXXXXXXXXXXXXXXXXXXXXXXXXXXXXXXXXXXXXXXXXXXXXXXXXXXXXXXXXXXXXXXXXXXXXXXXXXXXXXXXXXXXXXXXXXXXXXXXXXXXXXXXXXXXXXXXXXXXXXXXXXXXXXXXXXXXXXXXXXXXXXXXXXXXXXXXXXXXXXXXXXXXXXXXXXXXXXXXXXXXXXXXXX

