--------------------------------------------------------------------------------------------------------------------------------------------------------------------------------------------------------
--------------------------------------------------------------------------------------------------------------------------------------------------------------------------------------------------------
--------------------------------------------------------------------------------------------------------------------------------------------------------------------------------------------------------
--------------------------------------------------------------------------------------------------------------------------------------------------------------------------------------------------------
--------------------------------------------------------------------------------------------------------------------------------------------------------------------------------------------------------
--------------------------------------------------------------------------------------------------------------------------------------------------------------------------------------------------------
--------------------------------------------------------------------------------------------------------------------------------------------------------------------------------------------------------
--------------------------------------------------------------------------------------------------------------------------------------------------------------------------------------------------------
--------------------------------------------------------------------------------------------------------------------------------------------------------------------------------------------------------
--------------------------------------------------------------------------------------------------------------------------------------------------------------------------------------------------------
--------------------------------------------------------------------------------------------------------------------------------------------------------------------------------------------------------
--------------------------------------------------------------------------------------------------------------------------------------------------------------------------------------------------------
----------------------------------------------------------ooo---------------------------------ooSo------------------------------------------------------------------------------------------------------
---------------------------------------oSo-------------------------------------------oooS-----------oooS--------------------------ooS-------------ooSS--------------------------------------------------
--------------------SSSooo----------------------ooooSo----oo-----------------ooSSo-------------------------oooSoo-------------------------------------------------------------------oSSS----------------
-----------------------------oooS-------------------------------oSooSooSo------------oo----------g---------------------------------ooo-------------ooooo-------------------ooooS-----------------Soo----
-------------------ooooo------------XX-------XX-ooooo----XXXXXX--------------ooooo---------XXXXXXXX--------oooooooo--XXXX-------------g---------------g-------------XXXXXX----------ooo-----------------
------------------------------oooo--XXXXXXXXXXX----------XXXXXX----ooooo-----------XXXXXXXXXXXXXXXXXXXXXXX-----------XXXX----XXXXXXXXXXXXXXXXXXXXXXXXXXXXX----------XXXXXX-ooooooo---------XXXX-ooooooo-
-----------------XXXXXXXXXX---------XXXXXXXXXXXXXXXXXXXXXXXXXXX-----------XXXXXXXXXXXXXXXXXXXXXXXXXXXXXXXXXXXXXXXXXXXXXXXXXXXXXXXXXXXXXXXXXXXXXXXXXXXXXXXXXXXXXXXXXXXXXXXX---------XXXXXXXXXXXX---------
XXXXXXXXXXXXXXXXXXXXXXXXXXXXXXXXXXXXXXXXXXXXXXXXXXXXXXXXXXXXXXXXXXXXXXXXXXXXXXXXXXXXXXXXXXXXXXXXXXXXXXXXXXXXXXXXXXXXXXXXXXXXXXXXXXXXXXXXXXXXXXXXXXXXXXXXXXXXXXXXXXXXXXXXXXXXXXXXXXXXXXXXXXXXXXXXXXXXXXXX

