--------------------------------------------------------------------------------------------------------------------------------------------------------------------------------------------------------
--------------------------------------------------------------------------------------------------------------------------------------------------------------------------------------------------------
--------------------------------------------------------------------------------------------------------------------------------------------------------------------------------------------------------
--------------------------------------------------------------------------------------------------------------------------------------------------------------------------------------------------------
--------------------------------------------------------------------------------------------------------------------------------------------------------------------------------------------------------
--------------------------------------------------------------------------------------------------------------------------------------------------------------------------------------------------------
--------------------------------------------------------------------------------------------------------------------------------------------------------------------------------------------------------
--------------------------------------------------------------------------------------------------------------------------------------------------------------------------------------------------------
--------------------------------------------------------------------------------------------------------------------------------------------------------------------------------------------------------
--------------------------------------------------------------------------------------------------------------------------------------------------------------------------------------------------------
--------------------------------------------------------------------------------------------------------------------------------------------------------------------------------------------------------
--------------------------------------------------------------------------------------------------------------------------------------------------------------------------------------------------------
------------------------SSooo-----------------------------------oSS-----------------------------------------------------------------------------------------------------------------------------ooSoSS--
---------------ooSS-----------------------------------------------------------------------------------------------ooS-------ooS-------ooooS----------------------------------oooSo----------------------
-----------------------oooooooo----SSoSS------------------------ooo--------ooooSoS------------------ooooo---------------------------------------------Soo---------ooSSSSo------------------------oooo---
---------------oooooo----------------------------------------------------------------oSooo--oSSS------------------ooo--------oooo--ooooooo----------------------------------ooooo-----oooo--------------
----------------------XXXXXXXXXXX---ooo----------------------XXXXXXXXXX------ooooo-----------------XXXXXXXXXXX------------------g---------------------oo----------oooo-------------------------XXXXXXXXX
--------------XXXXXXXXXXXXXXXXXXX----------------------------XXXXXXXXXX--------------ooo-------oo--XXXXXXXXXXXXXXXXXXXXXXXXXXXXXXXXXXXXXXXXXXXXXXXX-----------------------XXXXXXXXXXX-oooooo---XXXXXXXXX
--------------XXXXXXXXXXXXXXXXXXXXXXXXXXXXX-------XXXX---XXXXXXXXXXXXXXXXXXXXXXXXXXX---------------XXXXXXXXXXXXXXXXXXXXXXXXXXXXXXXXXXXXXXXXXXXXXXXXXXXXXXXX--XXXXXXXXXXXXXXXXXXXXXXXX--------XXXXXXXXXXX
XXXXXXXXXXXXXXXXXXXXXXXXXXXXXXXXXXXXXXXXXXXXXXXXXXXXXXXXXXXXXXXXXXXXXXXXXXXXXXXXXXXXXXXXXXXXXXXXXXXXXXXXXXXXXXXXXXXXXXXXXXXXXXXXXXXXXXXXXXXXXXXXXXXXXXXXXXXXXXXXXXXXXXXXXXXXXXXXXXXXXXXXXXXXXXXXXXXXXXXX

