--------------------------------------------------------------------------------------------------------------------------------------------------------------------------------------------------------
--------------------------------------------------------------------------------------------------------------------------------------------------------------------------------------------------------
--------------------------------------------------------------------------------------------------------------------------------------------------------------------------------------------------------
--------------------------------------------------------------------------------------------------------------------------------------------------------------------------------------------------------
--------------------------------------------------------------------------------------------------------------------------------------------------------------------------------------------------------
--------------------------------------------------------------------------------------------------------------------------------------------------------------------------------------------------------
--------------------------------------------------------------------------------------------------------------------------------------------------------------------------------------------------------
--------------------------------------------------------------------------------------------------------------------------------------------------------------------------------------------------------
--------------------------------------------------------------------------------------------------------------------------------------------------------------------------------------------------------
--------------------------------------------------------------------------------------------------------------------------------------------------------------------------------------------------------
--------------------------------------------------------------------------------------------------------------------------------------------------------------------------------------------------------
--------------------------------------------------------------------------------------------------------------------------------------------------------------------------------------------------------
----------------------------------------------------------------------------------------------------------------------------------------------------------------------ooooSo----------------------------
---------------------------------------------------------------------------------------------------------------ooooSo-----------------------------------------------------------------------------------
-----------------------------------------------------------------------------------------oooooo---------------------------------------------ooo---------------oSo-------ooooo---------------------------
---------------------------oo-------------------------------------------------oSooo--------------oooo--------oooooooo---ooo------ooSoS------------------------------------------------------------------
XXXXXXXXXXXXXXXX---g-----------------------------------XXXX-------------------------------ooo------------------------------------------------------------------------XXXXXXXXXX--------ooo--------------
XXXXXXXXXXXXXXXXXXXXXXXXXXXXXXXXXXX--------------------XXXX-oo---XXXXXXX-------oo---XX-------------oo-----XXXXXXXXXXXXXXXXXXX----ooooo------------XXXXXXX------------XXXXXXXXXX--ooo-----g--------------
XXXXXXXXXXXXXXXXXXXXXXXXXXXXXXXXXXX----g-------XXX-----XXXX---g--XXXXXXX------------XXXXXXXXXXXX------XXXXXXXXXXXXXXXXXXXXXXX-----------XXXXXXXX--XXXXXXXXXXXXXXXXXXXXXXXXXXXXX-------XXXXXXXXXX--------
XXXXXXXXXXXXXXXXXXXXXXXXXXXXXXXXXXXXXXXXXXXXXXXXXXXXXXXXXXXXXXXXXXXXXXXXXXXXXXXXXXXXXXXXXXXXXXXXXXXXXXXXXXXXXXXXXXXXXXXXXXXXXXXXXXXXXXXXXXXXXXXXXXXXXXXXXXXXXXXXXXXXXXXXXXXXXXXXXXXXXXXXXXXXXXXXXXXXXXXX

