--------------------------------------------------------------------------------------------------------------------------------------------------------------------------------------------------------
--------------------------------------------------------------------------------------------------------------------------------------------------------------------------------------------------------
--------------------------------------------------------------------------------------------------------------------------------------------------------------------------------------------------------
--------------------------------------------------------------------------------------------------------------------------------------------------------------------------------------------------------
--------------------------------------------------------------------------------------------------------------------------------------------------------------------------------------------------------
--------------------------------------------------------------------------------------------------------------------------------------------------------------------------------------------------------
--------------------------------------------------------------------------------------------------------------------------------------------------------------------------------------------------------
--------------------------------------------------------------------------------------------------------------------------------------------------------------------------------------------------------
--------------------------------------------------------------------------------------------------------------------------------------------------------------------------------------------------------
--------------------------------------------------------------------------------------------------------------------------------------------------------------------------------------------------------
--------------------------------------------------------------------------------------------------------------------------------------------------------------------------------------------------------
--------------------------------------------------------------------------------------------------------------------------------------------------------------------------------------------------------
------------------------------------------------------------------------------------------------------------------------ooooS---------------------------------------------------------------------------
-------------------------ooooS------------------------------------------------------------------------------SooS----------------------------oooo----------------------oooo------------------------------
---------------------------------------------oSoSoo----------oSSoSo-------------------oooo---ooo-------------------------ooooo----------------------------------------------------SSoo---ooSooSS--------
-------------SSoooo------oooooooo---oooo----------------------------------oooo----------------------------oooooo-----------g--------SooSS---ooo-----ooSSoo----------------------------------------------
-------------------------g------g------------ooo-------------oooooo--XXXX-----------XXXXXXXX---oo----------------------XXXXXXXX----------------g------------------------------------ooo-----ooo---------
--------------oooo------XXXXXXXXXXXXXXXXX--------------oooo------g---XXXX--ooo------XXXXXXXX-------XXXXXXXXXXXXXXXXXXXXXXXXXXXXXXX---ooooo-XXXXXX-----ooooo----------XXXXXX------------------------XXXX-
XXXXXXXXXX----------XXXXXXXXXXXXXXXXXXXXXXXXXXXXXXXX--------XXXXXXXXXXXXX-g-----XXXXXXXXXXXXXXXXXXXXXXXXXXXXXXXXXXXXXXXXXXXXXXXXXX---------XXXXXXXX------g-----------XXXXXXXXXXXXXXXXXXXXXXXXXXXXXXXXXXX
XXXXXXXXXXXXXXXXXXXXXXXXXXXXXXXXXXXXXXXXXXXXXXXXXXXXXXXXXXXXXXXXXXXXXXXXXXXXXXXXXXXXXXXXXXXXXXXXXXXXXXXXXXXXXXXXXXXXXXXXXXXXXXXXXXXXXXXXXXXXXXXXXXXXXXXXXXXXXXXXXXXXXXXXXXXXXXXXXXXXXXXXXXXXXXXXXXXXXXXX

