--------------------------------------------------------------------------------------------------------------------------------------------------------------------------------------------------------
--------------------------------------------------------------------------------------------------------------------------------------------------------------------------------------------------------
--------------------------------------------------------------------------------------------------------------------------------------------------------------------------------------------------------
--------------------------------------------------------------------------------------------------------------------------------------------------------------------------------------------------------
--------------------------------------------------------------------------------------------------------------------------------------------------------------------------------------------------------
--------------------------------------------------------------------------------------------------------------------------------------------------------------------------------------------------------
--------------------------------------------------------------------------------------------------------------------------------------------------------------------------------------------------------
--------------------------------------------------------------------------------------------------------------------------------------------------------------------------------------------------------
--------------------------------------------------------------------------------------------------------------------------------------------------------------------------------------------------------
--------------------------------------------------------------------------------------------------------------------------------------------------------------------------------------------------------
--------------------------------------------------------------------------------------------------------------------------------------------------------------------------------------------------------
--------------------------------------------------------------------------------------------------------------------------------------------------------------------------------------------------------
--------------------------------------------------------------------------------------------------oooooSS-----oooSS--------------------------------------------------SSooSo-----------------------------
-----------------------ooooo---------------ooooSoo--------------------------------------------------------------------oSSoS---------------------------------SoS--------------------------oooSS----------
-------------------------------------------------------------SooSoS------------------------------ooooooo----oooooo----------------------------------------------------ooo-------------------------------
---------------------ooooooooo---------------oooooo--ooooo-----------------Sooo------------------------------------------oo-------Soo----------ooS-------oooooo-------------------------ooooooo---------
---------------oooo-----g------XXX----------g----------------oooooo-----------------------------XXXXXXXXXXXXXXXXXXXXX------------------XXXXXX----------------------XXXXXXXXXX---oooo--------------------
--------------------XXXXXXXXXXXXXXXXXXX--XXXXXXXXXXXXXXXXXX-------------------------------------XXXXXXXXXXXXXXXXXXXXXXXXXXXXXXX---oo---XXXXXX--ooo------XXXXXXXXXXXXXXXXXXXXX---g----XXXXXXXXXXXXXXXXXXX
--------------XXXXXXXXXXXXXXXXXXXXXXXXX--XXXXXXXXXXXXXXXXXXXXXXXXXXXXXXX---------XXXXXXXXXXXXXXXXXXXXXXXXXXXXXXXXXXXXXXXXXXXXXX-----g--XXXXXX-----------XXXXXXXXXXXXXXXXXXXXXXXXXXXXXXXXXXXXXXXXXXXXXXXX
XXXXXXXXXXXXXXXXXXXXXXXXXXXXXXXXXXXXXXXXXXXXXXXXXXXXXXXXXXXXXXXXXXXXXXXXXXXXXXXXXXXXXXXXXXXXXXXXXXXXXXXXXXXXXXXXXXXXXXXXXXXXXXXXXXXXXXXXXXXXXXXXXXXXXXXXXXXXXXXXXXXXXXXXXXXXXXXXXXXXXXXXXXXXXXXXXXXXXXXX

