--------------------------------------------------------------------------------------------------------------------------------------------------------------------------------------------------------
--------------------------------------------------------------------------------------------------------------------------------------------------------------------------------------------------------
--------------------------------------------------------------------------------------------------------------------------------------------------------------------------------------------------------
--------------------------------------------------------------------------------------------------------------------------------------------------------------------------------------------------------
--------------------------------------------------------------------------------------------------------------------------------------------------------------------------------------------------------
--------------------------------------------------------------------------------------------------------------------------------------------------------------------------------------------------------
--------------------------------------------------------------------------------------------------------------------------------------------------------------------------------------------------------
--------------------------------------------------------------------------------------------------------------------------------------------------------------------------------------------------------
--------------------------------------------------------------------------------------------------------------------------------------------------------------------------------------------------------
--------------------------------------------------------------------------------------------------------------------------------------------------------------------------------------------------------
--------------------------------------------------------------------------------------------------------------------------------------------------------------------------------------------------------
--------------------------------------------------------------------------------------------------------------------------------------------------------------------------------------------------------
----------------------------------------------Soo-------------------------------------------------------------------------------------------------------------------------------------------------------
--------------------------------ooSoSo----------------------SSS--------------------------------------------------ooooo----------------------------------------------------------------------------------
------------------------ooo------------------------------------------------------------------------------------------------------------------------------oooSooo------------ooSo----------------g-------
--------------oooooo------------oooooooo---------------------oo---------%%%--------------------------------------oooo----------------ooSoo-----------------------------------------------------%%%%-----
------------------------------------------XXXXXXXX--oooo----------------|||-----------------------ooooooo-------------------------------------------XXX----ooo----XXXXXXXXX---oooo---------XXX-||||-----
------------ooooooo--XX--------XXXXXXXXXXXXXXXXXXX-------XXXXXXXXXXXXXXXXXXXXXXXXXXX----XXX-------------------XXXXXXXXX--------------oo-------XXX---XXX-----------XXXXXXXXX-------g---ooo--XXX-||||-----
-------------g-------XXXXXXXXXXXXXXXXXXXXXXXXXXXXXXXXXXXXXXXXXXXXXXXXXXXXXXXXXXXXXXX----XXXXXXXXXXXXXXXXXX----XXXXXXXXX-----XXXXX----------XXXXXX---XXXXXXXXXXXXXXXXXXXXXXXXXXXXXXXX-------XXXXXXXXXXXXX
XXXXXXXXXXXXXXXXXXXXXXXXXXXXXXXXXXXXXXXXXXXXXXXXXXXXXXXXXXXXXXXXXXXXXXXXXXXXXXXXXXXXXXXXXXXXXXXXXXXXXXXXXXXXXXXXXXXXXXXXXXXXXXXXXXXXXXXXXXXXXXXXXXXXXXXXXXXXXXXXXXXXXXXXXXXXXXXXXXXXXXXXXXXXXXXXXXXXXXXX

