--------------------------------------------------------------------------------------------------------------------------------------------------------------------------------------------------------
--------------------------------------------------------------------------------------------------------------------------------------------------------------------------------------------------------
--------------------------------------------------------------------------------------------------------------------------------------------------------------------------------------------------------
--------------------------------------------------------------------------------------------------------------------------------------------------------------------------------------------------------
--------------------------------------------------------------------------------------------------------------------------------------------------------------------------------------------------------
--------------------------------------------------------------------------------------------------------------------------------------------------------------------------------------------------------
--------------------------------------------------------------------------------------------------------------------------------------------------------------------------------------------------------
--------------------------------------------------------------------------------------------------------------------------------------------------------------------------------------------------------
--------------------------------------------------------------------------------------------------------------------------------------------------------------------------------------------------------
--------------------------------------------------------------------------------------------------------------------------------------------------------------------------------------------------------
--------------------------------------------------------------------------------------------------------------------------------------------------------------------------------------------------------
--------------------------------------------------------------------------------------------------------------------------------------------------------------------------------------------------------
-----------------------------------------------------oSSSSS---------------------------------------------------------------------------------------------------------------oSo---------------------------
-----------------oSo----------------------------------------------------------SSoo-----------------------------------------------------ooooSo-----------------------------------------------------------
-------------------------------------------oSoo--------oooooo------------------------------------oSSoo------------------------------------------------------ooooSoo-------------------------------------
-----------------------ooo--------------------------------------ooo------------ooooo-----ooSooo--------------ooSooS----Soo------------ooooooo-------SoS--------------------------ooo--------------------
------------------------------XXXX--------oo-------XXXXXXXXXXX-g------ooooo-------------------------ooo----------------------ooooo-----------------------------ooo-------XXXXXX------XXXXXX-------------
----------------XXXXXX--------XXXXXXXXX---------XXXXXXXXXXXXXXXXXXXX--------XXXXXXXXXX----oo---------------ooooooo-----oo------------XXXXXXXXXXX---ooo-------------------XXXXXX-oooo-XXXXXXXXXXXXXXXXXX-
----------------XXXXXX--------XXXXXXXXXXXXXXXXXXXXXXXXXXXXXXXXXXXXXXXXXXXXXXXXXXXXXXXX----------XXXXXXXXXX--------g---------XXXXXXXXXXXXXXXXXXXX-----g-----XXXXXXXXXXXXXXXXXXXX------XXXXXXXXXXXXXXXXXX-
XXXXXXXXXXXXXXXXXXXXXXXXXXXXXXXXXXXXXXXXXXXXXXXXXXXXXXXXXXXXXXXXXXXXXXXXXXXXXXXXXXXXXXXXXXXXXXXXXXXXXXXXXXXXXXXXXXXXXXXXXXXXXXXXXXXXXXXXXXXXXXXXXXXXXXXXXXXXXXXXXXXXXXXXXXXXXXXXXXXXXXXXXXXXXXXXXXXXXXXX

