--------------------------------------------------------------------------------------------------------------------------------------------------------------------------------------------------------
--------------------------------------------------------------------------------------------------------------------------------------------------------------------------------------------------------
--------------------------------------------------------------------------------------------------------------------------------------------------------------------------------------------------------
--------------------------------------------------------------------------------------------------------------------------------------------------------------------------------------------------------
--------------------------------------------------------------------------------------------------------------------------------------------------------------------------------------------------------
--------------------------------------------------------------------------------------------------------------------------------------------------------------------------------------------------------
--------------------------------------------------------------------------------------------------------------------------------------------------------------------------------------------------------
--------------------------------------------------------------------------------------------------------------------------------------------------------------------------------------------------------
--------------------------------------------------------------------------------------------------------------------------------------------------------------------------------------------------------
--------------------------------------------------------------------------------------------------------------------------------------------------------------------------------------------------------
--------------------------------------------------------------------------------------------------------------------------------------------------------------------------------------------------------
--------------------------------------------------------------------------------------------------------------------------------------------------------------------------------------------------------
------------------------------------------------------------------------------ooooSo----------------------------oSS----------------------------------------------------------------------ooSoSoo--------
-----------------------------------------------------------ooS----------------------------------------oSo-----------------------------------------------------------------------------------------------
------------oooo-----------------------------------------------------------------ooo-------oSSo---------------oooooo------oooo--ooo--------oSSoS-------------------oooo--------------------ooooo--------
-------------------------------ooooo------SoSoooo----ooo------ooo--oSoSoSooo-------------------------ooooooo-------------------------------------------------------------------SSSoo---------------oo---
-----------------------------------------------------------------------------XXXXXXXXXXX--oooooooo-----------XXXXXXXXXX--XXXXXX------XX-----oooo-----------------ooooooooo-----------XXXXXXXXXXXX-------
XXXXXXXXXX------------XXXXXX----oooooo----oooooo--XXXXXXXXXXXXXXXX--oooooooo-XXXXXXXXXXX-----------XXXXXXXXXXXXXXXXXXXX--XXXXXX------XX-------------ooo------------g-----------ooooo-XXXXXXXXXXXXXXXXXXX
XXXXXXXXXXXXXXXXXXXXXXXXXXXX-----gg--g------------XXXXXXXXXXXXXXXX-----------XXXXXXXXXXXXXXXXXXXXXXXXXXXXXXXXXXXXXXXXXXXXXXXXXXXXXXXXXXXXXXXXXXXXXX-------------XXXXXXXXXXX----------XXXXXXXXXXXXXXXXXXX
XXXXXXXXXXXXXXXXXXXXXXXXXXXXXXXXXXXXXXXXXXXXXXXXXXXXXXXXXXXXXXXXXXXXXXXXXXXXXXXXXXXXXXXXXXXXXXXXXXXXXXXXXXXXXXXXXXXXXXXXXXXXXXXXXXXXXXXXXXXXXXXXXXXXXXXXXXXXXXXXXXXXXXXXXXXXXXXXXXXXXXXXXXXXXXXXXXXXXXXX

