--------------------------------------------------------------------------------------------------------------------------------------------------------------------------------------------------------
--------------------------------------------------------------------------------------------------------------------------------------------------------------------------------------------------------
--------------------------------------------------------------------------------------------------------------------------------------------------------------------------------------------------------
--------------------------------------------------------------------------------------------------------------------------------------------------------------------------------------------------------
--------------------------------------------------------------------------------------------------------------------------------------------------------------------------------------------------------
--------------------------------------------------------------------------------------------------------------------------------------------------------------------------------------------------------
--------------------------------------------------------------------------------------------------------------------------------------------------------------------------------------------------------
--------------------------------------------------------------------------------------------------------------------------------------------------------------------------------------------------------
--------------------------------------------------------------------------------------------------------------------------------------------------------------------------------------------------------
--------------------------------------------------------------------------------------------------------------------------------------------------------------------------------------------------------
--------------------------------------------------------------------------------------------------------------------------------------------------------------------------------------------------------
--------------------------------------------------------------------------------------------------------------------------------------------------------------------------------------------------------
------------------------------------oSoSoSSo-----------oSoo------------------ooooo-----------------------------------------------------------------------------------------------------oSoo-------------
------------------------------------------------------------------------------------oSoo--------------------------ooo-------------------------------------oSSSoo----------------------------------------
---------------------oSoo-----------oooooo----------------oo------------------------------------------------------------oooooS-----SooSoSoo--------------------------oooo-------ooS----oooo-------------
-----------------------------------------------------------------------ooo--------------------------------------ooo------------------------------------ooooooooo----------------------------------------
XXXXXXXXXXXX-------oooo------------XXXXXXXXXX-ooooo---XXXXXXXXX-------------XXXXXXX--------oo------g-------XXX-----------ooooooo--oooooo-----------------------------ooooo-----------XXXXXXX---oo-------
XXXXXXXXXXXX-------------------oo--XXXXXXXXXX---------XXXXXXXXX-----g-XXXXXXXXXXXXXXXXXXX---------XXXXXXXXXXXXXXXXXXXXX-------------------------------XXXXXXXXXXXXXX---g------g------XXXXXXX------------
XXXXXXXXXXXXXXXXXXXXXXXXXXXXX------XXXXXXXXXXXXXXXXXXXXXXXXXXXXXXXXXXXXXXXXXXXXXXXXXXXXXXXXXXXXXXXXXXXXXXXXXXXXXXXXXXXXXXXXXXXXXXXXXXXXXXXXX-----XXXXXXXXXXXXXXXXXXXXXXXXXXXXXXXXXXXXXXXXXXXXXXXXXXXXXXX
XXXXXXXXXXXXXXXXXXXXXXXXXXXXXXXXXXXXXXXXXXXXXXXXXXXXXXXXXXXXXXXXXXXXXXXXXXXXXXXXXXXXXXXXXXXXXXXXXXXXXXXXXXXXXXXXXXXXXXXXXXXXXXXXXXXXXXXXXXXXXXXXXXXXXXXXXXXXXXXXXXXXXXXXXXXXXXXXXXXXXXXXXXXXXXXXXXXXXXXX

