--------------------------------------------------------------------------------------------------------------------------------------------------------------------------------------------------------
--------------------------------------------------------------------------------------------------------------------------------------------------------------------------------------------------------
--------------------------------------------------------------------------------------------------------------------------------------------------------------------------------------------------------
--------------------------------------------------------------------------------------------------------------------------------------------------------------------------------------------------------
--------------------------------------------------------------------------------------------------------------------------------------------------------------------------------------------------------
--------------------------------------------------------------------------------------------------------------------------------------------------------------------------------------------------------
--------------------------------------------------------------------------------------------------------------------------------------------------------------------------------------------------------
--------------------------------------------------------------------------------------------------------------------------------------------------------------------------------------------------------
--------------------------------------------------------------------------------------------------------------------------------------------------------------------------------------------------------
--------------------------------------------------------------------------------------------------------------------------------------------------------------------------------------------------------
--------------------------------------------------------------------------------------------------------------------------------------------------------------------------------------------------------
--------------------------------------------------------------------------------------------------------------------------------------------------------------------------------------------------------
----------------------------------oSooSoSo------------------------------oooooo-------------------------oooo-----------------------SoS-------------------------------------------------------------------
---------------------------------------------oooSoooo-----------------------------------------------------------oSSS-------------------------------------------------------------------oSS--------------
--------------------------ooooo------oo-----------------------oSSooo-----ooo------------------------ooooooooo----------------------------oSSoo-------------------------------------------------oooS-----
----------------SooSo-------------------------oooooo-------------------------------------oooo------------------ooooo-------------------------------------------------------------------oo---------------
XXXXXXXXXXXXXX-------------oo----XXXXXXXXXX------------------ooooo----XXXXXXXXX--------------------XXXXXXXXXXX------------------XXXXXXX----oooo--------------------------------------------------oooo---
XXXXXXXXXXXXXX--ooooooo----------XXXXXXXXXXXXXXXXXXXXX----------------XXXXXXXXXXXXXXX--ooooooo--XXXXXXXXXXXXXXXXXXXXXXX----XXXXXXXXXXXX----g----g-XXXXXX--------XX-----------------XXXXXXXXXX----------X
XXXXXXXXXXXXXX-----------XXXXXXXXXXXXXXXXXXXXXXXXXXXXXXXXXXXXXXXXXXXXXXXXXXXXXXXXXXXX-------g---XXXXXXXXXXXXXXXXXXXXXXXXXXXXXXXXXXXXXXXXXXXXXXXXXXXXXXXX--------XXXXXXXXXXXXXXX----XXXXXXXXXXXXXXXXXXXXX
XXXXXXXXXXXXXXXXXXXXXXXXXXXXXXXXXXXXXXXXXXXXXXXXXXXXXXXXXXXXXXXXXXXXXXXXXXXXXXXXXXXXXXXXXXXXXXXXXXXXXXXXXXXXXXXXXXXXXXXXXXXXXXXXXXXXXXXXXXXXXXXXXXXXXXXXXXXXXXXXXXXXXXXXXXXXXXXXXXXXXXXXXXXXXXXXXXXXXXXX

