--------------------------------------------------------------------------------------------------------------------------------------------------------------------------------------------------------
--------------------------------------------------------------------------------------------------------------------------------------------------------------------------------------------------------
--------------------------------------------------------------------------------------------------------------------------------------------------------------------------------------------------------
--------------------------------------------------------------------------------------------------------------------------------------------------------------------------------------------------------
--------------------------------------------------------------------------------------------------------------------------------------------------------------------------------------------------------
--------------------------------------------------------------------------------------------------------------------------------------------------------------------------------------------------------
--------------------------------------------------------------------------------------------------------------------------------------------------------------------------------------------------------
--------------------------------------------------------------------------------------------------------------------------------------------------------------------------------------------------------
--------------------------------------------------------------------------------------------------------------------------------------------------------------------------------------------------------
--------------------------------------------------------------------------------------------------------------------------------------------------------------------------------------------------------
--------------------------------------------------------------------------------------------------------------------------------------------------------------------------------------------------------
--------------------------------------------------------------------------------------------------------------------------------------------------------------------------------------------------------
--------------oSSoo------------------------------------------------------------oSoooSooo-------------------oooS--------------------oooSSSSo--ooooo-----------Soooo--------------------------------------
---------------------oooSSo------------------------------------------------------------------------------------------------------------------------------------------------------------oSSooooo---------
----------------ooo--------------------------------------------------oSo---------oooooo-----------------------------------------------oooo---oooooo---------ooooooo-------------------------------------
------------------g-----ooo---oSSo--------------------ooooo---------------------------------SSo------------------------------ooo---g----------------------------------ooo---ooSSooooo-----ooooo-----ooo-
XXXXXXXXXXXXXXXXXXXX--------------------XXX------------------ooooo------------XXXXXXXXXXX----------XXXXXXXXXXXXXXXXXXXXXXX--------XXXXXXXXXXXXXXXXXX------XXXXXXXXXXX-----------------------------------
XXXXXXXXXXXXXXXXXXXXXXXXXXXX----oo------XXX--------XXXXXXXXX------------------XXXXXXXXXXX----------XXXXXXXXXXXXXXXXXXXXXXX----ooo-XXXXXXXXXXXXXXXXXX------XXXXXXXXXXXXXXXXX---ooooooo-XXXXXXXXXXXXXXXXXX
XXXXXXXXXXXXXXXXXXXXXXXXXXXX-g----------XXX---XXXXXXXXXXXXXXXXXXXXXXXXXXXXXXXXXXXXXXXXXXX-------XXXXXXXXXXXXXXXXXXXXXXXXXX--------XXXXXXXXXXXXXXXXXXXXXXXXXXXXXXXXXXXXXXXXX-g---------XXXXXXXXXXXXXXXXXX
XXXXXXXXXXXXXXXXXXXXXXXXXXXXXXXXXXXXXXXXXXXXXXXXXXXXXXXXXXXXXXXXXXXXXXXXXXXXXXXXXXXXXXXXXXXXXXXXXXXXXXXXXXXXXXXXXXXXXXXXXXXXXXXXXXXXXXXXXXXXXXXXXXXXXXXXXXXXXXXXXXXXXXXXXXXXXXXXXXXXXXXXXXXXXXXXXXXXXXXX

