--------------------------------------------------------------------------------------------------------------------------------------------------------------------------------------------------------
--------------------------------------------------------------------------------------------------------------------------------------------------------------------------------------------------------
--------------------------------------------------------------------------------------------------------------------------------------------------------------------------------------------------------
--------------------------------------------------------------------------------------------------------------------------------------------------------------------------------------------------------
--------------------------------------------------------------------------------------------------------------------------------------------------------------------------------------------------------
--------------------------------------------------------------------------------------------------------------------------------------------------------------------------------------------------------
--------------------------------------------------------------------------------------------------------------------------------------------------------------------------------------------------------
--------------------------------------------------------------------------------------------------------------------------------------------------------------------------------------------------------
--------------------------------------------------------------------------------------------------------------------------------------------------------------------------------------------------------
--------------------------------------------------------------------------------------------------------------------------------------------------------------------------------------------------------
--------------------------------------------------------------------------------------------------------------------------------------------------------------------------------------------------------
--------------------------------------------------------------------------------------------------------------------------------------------------------------------------------------------------------
-----------------------------------------------ooooSo-----------------------------ooo-------------------------------------------------------------SoSoo--------------------ooS----oooo------------------
---------------------------SooSo-----oooSoooo-------------oooSo------------------------------ooSoS-------------------------------ooSS-------------------------------------------------------------------
--------------------------------------------------ooooo----------------------------oo---------------------ooo---ooSSSo----------------------------oooooo----------------------------ooooo---------------
----------------ooo-------oooooooo--ooooooooo---------------oooo----oSoooSS---------------oooooo--------------------------------oooooooo-----------------------------------------------g----------------
----------------------------------------------XXXXXXXXXXX------------------------XXXXXXXX-------------XXXXXXXXX------------------g-------XXXXXXXXXXXXXXXXX----XX----------XXXXXXXXXXXXXXXXXXXX----------
---------------XXXXXXXXXXXXXXXXXXXXXXXXXXXXXXXXXXXXXXXXXXXXXXXXXXXX---oooooo--XXXXXXXXXXXXXXXXXXXXXX--XXXXXXXXX----------------XXXXXXXXXXXXXXXXXXXXXXXXXXX----XXXXXXX-----XXXXXXXXXXXXXXXXXXXX----XXXXXX
XXXXXXXXXXXXXXXXXXXXXXXXXXXXXXXXXXXXXXXXXXXXXXXXXXXXXXXXXXXXXXXXXXX-----------XXXXXXXXXXXXXXXXXXXXXX--XXXXXXXXXXXXXXXXXXXXXXXXXXXXXXXXXXXXXXXXXXXXXXXXXXXXXXXXXXXXXXX-----XXXXXXXXXXXXXXXXXXXX----XXXXXX
XXXXXXXXXXXXXXXXXXXXXXXXXXXXXXXXXXXXXXXXXXXXXXXXXXXXXXXXXXXXXXXXXXXXXXXXXXXXXXXXXXXXXXXXXXXXXXXXXXXXXXXXXXXXXXXXXXXXXXXXXXXXXXXXXXXXXXXXXXXXXXXXXXXXXXXXXXXXXXXXXXXXXXXXXXXXXXXXXXXXXXXXXXXXXXXXXXXXXXXX

