--------------------------------------------------------------------------------------------------------------------------------------------------------------------------------------------------------
--------------------------------------------------------------------------------------------------------------------------------------------------------------------------------------------------------
--------------------------------------------------------------------------------------------------------------------------------------------------------------------------------------------------------
--------------------------------------------------------------------------------------------------------------------------------------------------------------------------------------------------------
--------------------------------------------------------------------------------------------------------------------------------------------------------------------------------------------------------
--------------------------------------------------------------------------------------------------------------------------------------------------------------------------------------------------------
--------------------------------------------------------------------------------------------------------------------------------------------------------------------------------------------------------
--------------------------------------------------------------------------------------------------------------------------------------------------------------------------------------------------------
--------------------------------------------------------------------------------------------------------------------------------------------------------------------------------------------------------
--------------------------------------------------------------------------------------------------------------------------------------------------------------------------------------------------------
--------------------------------------------------------------------------------------------------------------------------------------------------------------------------------------------------------
--------------------------------------------------------------------------------------------------------------------------------------------------------------------------------------------------------
------------------------oSoS-------------------------------------------------------------------------------------------------------------------------------------ooSoo----------------------------------
----------------------------------------------------------------------------------------------Soooooo-----Soo--------------------------------------ooo-------------------------------------oSoSoS-------
-------------------------ooo---------------------------------------------------oSooo-------------------------------------oooo-----------------------------------oooo------------------------------------
-----------------------------------------SoSooS------------Soooo------------------------------ooooooo----ooooo---------------------------oooSS---ooo-----------------------Sooooo----------ooooooo------
--------------XXXX----XXXXXXXXXXXXXX---------------------------------XXXXXX--oooooo-----------------------------------XXXXXXXXX---XXX----------------g-XXXXXXXXXXXXXXXX-------------XX-------------XXXXX
XXXXXXXXXXXXXXXXXX----XXXXXXXXXXXXXXXXX--ooooo-------------oooo------XXXXXX-----------------XXXXXXXXXX--XXXXXXXXX-----XXXXXXXXXXXXXXX---ooooo---XXXXXXXXXXXXXXXXXXXXXXX-oooooo------XXXXXXXXXXXXXXXXXXXX
XXXXXXXXXXXXXXXXXX----XXXXXXXXXXXXXXXXX--------------------------XXXXXXXXXXXXXXXXXXXXXXXXXXXXXXXXXXXXXXXXXXXXXXXX-----XXXXXXXXXXXXXXX-----------XXXXXXXXXXXXXXXXXXXXXXX-----------XXXXXXXXXXXXXXXXXXXXXX
XXXXXXXXXXXXXXXXXXXXXXXXXXXXXXXXXXXXXXXXXXXXXXXXXXXXXXXXXXXXXXXXXXXXXXXXXXXXXXXXXXXXXXXXXXXXXXXXXXXXXXXXXXXXXXXXXXXXXXXXXXXXXXXXXXXXXXXXXXXXXXXXXXXXXXXXXXXXXXXXXXXXXXXXXXXXXXXXXXXXXXXXXXXXXXXXXXXXXXXX

