--------------------------------------------------------------------------------------------------------------------------------------------------------------------------------------------------------
--------------------------------------------------------------------------------------------------------------------------------------------------------------------------------------------------------
--------------------------------------------------------------------------------------------------------------------------------------------------------------------------------------------------------
--------------------------------------------------------------------------------------------------------------------------------------------------------------------------------------------------------
--------------------------------------------------------------------------------------------------------------------------------------------------------------------------------------------------------
--------------------------------------------------------------------------------------------------------------------------------------------------------------------------------------------------------
--------------------------------------------------------------------------------------------------------------------------------------------------------------------------------------------------------
--------------------------------------------------------------------------------------------------------------------------------------------------------------------------------------------------------
--------------------------------------------------------------------------------------------------------------------------------------------------------------------------------------------------------
--------------------------------------------------------------------------------------------------------------------------------------------------------------------------------------------------------
--------------------------------------------------------------------------------------------------------------------------------------------------------------------------------------------------------
--------------------------------------------------------------------------------------------------------------------------------------------------------------------------------------------------------
-----------ooSSoSoo------------------------------------------------------------ooooo-------------------------oSoooSSo-----------------------------------------------------------------------------------
---------------------------------------------------Soo-----------ooSSo-----------------------------------------------------------------SSoS--------oSoo--------ooS--------------------------------------
--------------oo--------------------------------------------------------ooooo----ooo-------------------oooo--oooooooo-----------------------------------------------------ooSooo-----------------oSo----
-----------------g--------------------------------oooo-----------oooo-----------------------------------------------------------------oooooo--------oooo-------ooo------------------oSoS----------------
----------XXXXXXXXXXXXXXX------------------------------------oo---------------XXXXXXXXXX----------------ooo-XXXXXXXXXXX---------------gg-----XXXX----------------------ooooooo--------------------oooo--
XXXXXXXXXXXXXXXXXXXXXXXXX--oooo--XXXXX-ooooo---XXXXXXXXXX--g----XXXXXXX-------XXXXXXXXXX--------------------XXXXXXXXXXX----------XXXXXXXXXXXXXXXXXXXXXXXX--XXXXXXXXXXX------------oooooooo-XXX----------
XXXXXXXXXXXXXXXXXXXXXXXXX--------XXXXX---------XXXXXXXXXXXXXXXXXXXXXXXXXXXXXXXXXXXXXXXXXXXXXXXXXXXXXXXXXXXXXXXXXXXXXXXX----------XXXXXXXXXXXXXXXXXXXXXXXXXXXXXXXXXXXXXXXXXXXXXXXX---g------XXXXXXXXXXXXX
XXXXXXXXXXXXXXXXXXXXXXXXXXXXXXXXXXXXXXXXXXXXXXXXXXXXXXXXXXXXXXXXXXXXXXXXXXXXXXXXXXXXXXXXXXXXXXXXXXXXXXXXXXXXXXXXXXXXXXXXXXXXXXXXXXXXXXXXXXXXXXXXXXXXXXXXXXXXXXXXXXXXXXXXXXXXXXXXXXXXXXXXXXXXXXXXXXXXXXXX

