--------------------------------------------------------------------------------------------------------------------------------------------------------------------------------------------------------
--------------------------------------------------------------------------------------------------------------------------------------------------------------------------------------------------------
--------------------------------------------------------------------------------------------------------------------------------------------------------------------------------------------------------
--------------------------------------------------------------------------------------------------------------------------------------------------------------------------------------------------------
--------------------------------------------------------------------------------------------------------------------------------------------------------------------------------------------------------
--------------------------------------------------------------------------------------------------------------------------------------------------------------------------------------------------------
--------------------------------------------------------------------------------------------------------------------------------------------------------------------------------------------------------
--------------------------------------------------------------------------------------------------------------------------------------------------------------------------------------------------------
--------------------------------------------------------------------------------------------------------------------------------------------------------------------------------------------------------
--------------------------------------------------------------------------------------------------------------------------------------------------------------------------------------------------------
--------------------------------------------------------------------------------------------------------------------------------------------------------------------------------------------------------
--------------------------------------------------------------------------------------------------------------------------------------------------------------------------------------------------------
-----------------------------------oSSSoSo-------oSooS------------------oooo----------------------------------------------------------------------SSo---------------------------------------------------
-----------------------------------------------------------------------------------------------------------------------------ooo------ooooo---------------------------------oooo------------------------
------------------------------------ooooooo---------ooooo----------------------------------------------------Sooo---------------------------------------------------------------------------------------
--------------------------ooSSSo--------------------------------------------------------------------oooo------------------ooooooooo---oo---------------------ooo--------------ooo-----------------------
----------------------------------XXXXXXXXXXXX--XXXXXXXXXXXXXXXXXXXX---XXXXXXXXXXXXX--------XXXXXXX-----------ooo-------------------------------XXXXXX-----------XX---XXXXX------g------------XXXXX---XX
---------------------------oooooo-XXXXXXXXXXXXXXXXXXXXXXXXXXXXXXXXXXXXXXXXXXXXXXXXXX-oooooo-XXXXXXXXXXXXXX------g--------XXXXXXXXXXXXXXXXXXX----XXXXXX-----------XX---XXXXXXXXXXXXXXXXXXXXX---XXXXX---XX
-----------------XXXXXX-----------XXXXXXXXXXXXXXXXXXXXXXXXXXXXXXXXXXXXXXXXXXXXXXXXXX--------XXXXXXXXXXXXXXXXXXXXXXXXXXXXXXXXXXXXXXXXXXXXXXXX----XXXXXXXXXXX------XX---XXXXXXXXXXXXXXXXXXXXX---XXXXXXXXXX
XXXXXXXXXXXXXXXXXXXXXXXXXXXXXXXXXXXXXXXXXXXXXXXXXXXXXXXXXXXXXXXXXXXXXXXXXXXXXXXXXXXXXXXXXXXXXXXXXXXXXXXXXXXXXXXXXXXXXXXXXXXXXXXXXXXXXXXXXXXXXXXXXXXXXXXXXXXXXXXXXXXXXXXXXXXXXXXXXXXXXXXXXXXXXXXXXXXXXXXX

