--------------------------------------------------------------------------------------------------------------------------------------------------------------------------------------------------------
--------------------------------------------------------------------------------------------------------------------------------------------------------------------------------------------------------
--------------------------------------------------------------------------------------------------------------------------------------------------------------------------------------------------------
--------------------------------------------------------------------------------------------------------------------------------------------------------------------------------------------------------
--------------------------------------------------------------------------------------------------------------------------------------------------------------------------------------------------------
--------------------------------------------------------------------------------------------------------------------------------------------------------------------------------------------------------
--------------------------------------------------------------------------------------------------------------------------------------------------------------------------------------------------------
--------------------------------------------------------------------------------------------------------------------------------------------------------------------------------------------------------
--------------------------------------------------------------------------------------------------------------------------------------------------------------------------------------------------------
--------------------------------------------------------------------------------------------------------------------------------------------------------------------------------------------------------
--------------------------------------------------------------------------------------------------------------------------------------------------------------------------------------------------------
--------------------------------------------------------------------------------------------------------------------------------------------------------------------------------------------------------
----------------------------------------------------------------------------------------------------------------------------ooo---------------------------------------oSS-------------------------------
----------------------------------ooo----------------------------------------------------------------------Soo--------------------------------------------------------------------------------------ooo-
--------------------------------------------ooo--------ooo------ooo----------------------ooooo--------------------------------------------------------oSSoooo--------oooo-----ooSo----------------------
---------------------oo--------------------------oSo-------------------------oSooSSooo-------------oSS----ooo-------oooo----g------------------------------------------------------------------------oo-
------------------------------------------------------XXXXXXXXXXXXXX--------------------oooo-------------g-----------------XXXXXX-----------------------oooo------XXXXXXXXXXX-ooooooo-------------------
-------------XX-----XXXXXXX------XXXXXX------------oo-XXXXXXXXXXXXXX--XXXX-----oooooo--------------oo---XXXXXXXX-oooooo----XXXXXX-------g----------------------XXXXXXXXXXXXXX---------------------XXXXXX
-------------XX-----XXXXXXX----g-XXXXXXXXXXXXXXX------XXXXXXXXXXXXXXXXXXXX-------------XXXXXXXXX--------XXXXXXXX-------g---XXXXXXXXXXXXXXX-----XXXXXXXXXXXXXXXXXXXXXXXXXXXXXXXXXXXXXXXXXXXXXXXXXXXXXXXXX
XXXXXXXXXXXXXXXXXXXXXXXXXXXXXXXXXXXXXXXXXXXXXXXXXXXXXXXXXXXXXXXXXXXXXXXXXXXXXXXXXXXXXXXXXXXXXXXXXXXXXXXXXXXXXXXXXXXXXXXXXXXXXXXXXXXXXXXXXXXXXXXXXXXXXXXXXXXXXXXXXXXXXXXXXXXXXXXXXXXXXXXXXXXXXXXXXXXXXXXX

