--------------------------------------------------------------------------------------------------------------------------------------------------------------------------------------------------------
--------------------------------------------------------------------------------------------------------------------------------------------------------------------------------------------------------
--------------------------------------------------------------------------------------------------------------------------------------------------------------------------------------------------------
--------------------------------------------------------------------------------------------------------------------------------------------------------------------------------------------------------
--------------------------------------------------------------------------------------------------------------------------------------------------------------------------------------------------------
--------------------------------------------------------------------------------------------------------------------------------------------------------------------------------------------------------
--------------------------------------------------------------------------------------------------------------------------------------------------------------------------------------------------------
--------------------------------------------------------------------------------------------------------------------------------------------------------------------------------------------------------
--------------------------------------------------------------------------------------------------------------------------------------------------------------------------------------------------------
--------------------------------------------------------------------------------------------------------------------------------------------------------------------------------------------------------
--------------------------------------------------------------------------------------------------------------------------------------------------------------------------------------------------------
--------------------------------------------------------------------------------------------------------------------------------------------------------------------------------------------------------
------------------------SoSS---------------------------------------------------------------oooS---------------------------------------------------------------------------------------------------------
----------------------------------------------------------------------------------------------------------------------------oSooSo------------------------------------oooSSooo--------------------------
-------------------------ooooo--------------------------------------oSSS-------ooooooS-------oo---------------------------------------------------------------------------------------------------------
-----------------oooo------------------------oooSo--------------------------------------------g--------oSoS----------------oooo-------ooo------------------------------ooooooo------ooo-----oSS---------
----------------------XXXXXXXXX-----------------------oo----XXXXXXX-------XX------oooo---XXXXXXXXXX----------XXX-----------g---------------------------------ooooooo------------------------------------
XXXXXXXXXXXXX---oo----XXXXXXXXXXXX------------ooo-----------XXXXXXX-------XX-------------XXXXXXXXXX-ooooooo--XXX-ooooo--XXXXXXXXXXXXXXXXXXXXXXXXXX----g--------------XXXXXXXXXXXXX--oooo--oooooooo------
XXXXXXXXXXXXX---------XXXXXXXXXXXX---XXXXX-----------XXXXXXXXXXXXXXXXXXXXXXX--XXXXXXXXXXXXXXXXXXXXX----------XXX--------XXXXXXXXXXXXXXXXXXXXXXXXXXXXXXXXX---XXXXXXXXXXXXXXXXXXXXXX----------------------
XXXXXXXXXXXXXXXXXXXXXXXXXXXXXXXXXXXXXXXXXXXXXXXXXXXXXXXXXXXXXXXXXXXXXXXXXXXXXXXXXXXXXXXXXXXXXXXXXXXXXXXXXXXXXXXXXXXXXXXXXXXXXXXXXXXXXXXXXXXXXXXXXXXXXXXXXXXXXXXXXXXXXXXXXXXXXXXXXXXXXXXXXXXXXXXXXXXXXXXX

