--------------------------------------------------------------------------------------------------------------------------------------------------------------------------------------------------------
--------------------------------------------------------------------------------------------------------------------------------------------------------------------------------------------------------
--------------------------------------------------------------------------------------------------------------------------------------------------------------------------------------------------------
--------------------------------------------------------------------------------------------------------------------------------------------------------------------------------------------------------
--------------------------------------------------------------------------------------------------------------------------------------------------------------------------------------------------------
--------------------------------------------------------------------------------------------------------------------------------------------------------------------------------------------------------
--------------------------------------------------------------------------------------------------------------------------------------------------------------------------------------------------------
--------------------------------------------------------------------------------------------------------------------------------------------------------------------------------------------------------
--------------------------------------------------------------------------------------------------------------------------------------------------------------------------------------------------------
--------------------------------------------------------------------------------------------------------------------------------------------------------------------------------------------------------
--------------------------------------------------------------------------------------------------------------------------------------------------------------------------------------------------------
--------------------------------------------------------------------------------------------------------------------------------------------------------------------------------------------------------
--------------------------ooSoooo--------SoSo------------------------------------------------SSo--------------------------------------------------------ooo---------------------------------------------
-----------------------------------------------------------------------------------------------------------------oSSo-----------------------------------------------------------------------------------
--------------------------oooooo---------ooo---------------------------oooooooS--------------oooo------------------------SSo----------------------------oo------SoSSooo---------------------------------
------------oSSoo-----------------------------------------------------------------------------------oSSooSooo----ooooo-----------oSo----------------------------------------------------------oooo------
XXXXXXXXXXX-------------XXXXXXXXXXX---XXXXXXXXXX-------ooooo------------oooooooo----------XXXXXXXXX-------------g-------ooooo----------------oo--------XXXXXX---oooo-------XXXXXX-----------g-----------
XXXXXXXXXXX-------------XXXXXXXXXXX---XXXXXXXXXX--oo-----------XXXXXXX----g---g--------oo-XXXXXXXXX-ooooooooo-XXXXXXXXX--------------------------XXXXXXXXXXXX-----------XXXXXXXXXXXXXXXXXXXXXXXXXXXX----
XXXXXXXXXXX-------------XXXXXXXXXXX---XXXXXXXXXX----g-XXXXXXXXXXXXXXXXXXXXXXXXXXX---------XXXXXXXXX-----------XXXXXXXXXXXXXXXXXX-----------XXXXXXXXXXXXXXXXXXXXXXXXXXXXXXXXXXXXXXXXXXXXXXXXXXXXXXXXX----
XXXXXXXXXXXXXXXXXXXXXXXXXXXXXXXXXXXXXXXXXXXXXXXXXXXXXXXXXXXXXXXXXXXXXXXXXXXXXXXXXXXXXXXXXXXXXXXXXXXXXXXXXXXXXXXXXXXXXXXXXXXXXXXXXXXXXXXXXXXXXXXXXXXXXXXXXXXXXXXXXXXXXXXXXXXXXXXXXXXXXXXXXXXXXXXXXXXXXXXX

