--------------------------------------------------------------------------------------------------------------------------------------------------------------------------------------------------------
--------------------------------------------------------------------------------------------------------------------------------------------------------------------------------------------------------
--------------------------------------------------------------------------------------------------------------------------------------------------------------------------------------------------------
--------------------------------------------------------------------------------------------------------------------------------------------------------------------------------------------------------
--------------------------------------------------------------------------------------------------------------------------------------------------------------------------------------------------------
--------------------------------------------------------------------------------------------------------------------------------------------------------------------------------------------------------
--------------------------------------------------------------------------------------------------------------------------------------------------------------------------------------------------------
--------------------------------------------------------------------------------------------------------------------------------------------------------------------------------------------------------
--------------------------------------------------------------------------------------------------------------------------------------------------------------------------------------------------------
--------------------------------------------------------------------------------------------------------------------------------------------------------------------------------------------------------
--------------------------------------------------------------------------------------------------------------------------------------------------------------------------------------------------------
--------------------------------------------------------------------------------------------------------------------------------------------------------------------------------------------------------
--------------------------------------------------------------------------------------------------------------------------------------------------------------------------------------------------------
-----------------------------------------------------------------------------------------------------SoS------------------------------------------------------------------------------------------ooSS--
-------------------------ooSooSoS-------------------------------------oooo-----------------------------------------------------------------------------ooooo--------------------------oo----------------
-----------------oooo--------------------------oSoooo--oooSooo------------------------SoS-----oo-----oooooo----------oSSoooo-------SSo----------------------------------------ooooSo--g------------ooo--
XXXXXXXXXXXX-------------ooooooooo--oooo---------------------------XX---oooo-XXXXX-------------------------------XXX----------------------XXXX----oo-XXXXXXXXXXXXXXX-----------------XXXXXX-------------
XXXXXXXXXXXX----XXXXXXXX--------g----------------------oooooo------XX--------XXXXX---ooooo--XXXXXXXXXXXXXXXX-----XXX---ooooooo-----ooooo--XXXX-------XXXXXXXXXXXXXXX---g-----oooooo--XXXXXX-----XXXXXXXX
XXXXXXXXXXXX----XXXXXXXXXXXXXXXXXXXXXXXXXXXX---g----------------XXXXXXXXXXXXXXXXXX----------XXXXXXXXXXXXXXXXXXXXXXXX----------------------XXXXXXXXXXXXXXXXXXXXXXXXXXXXXXXXX----------XXXXXXXXXXXXXXXXXXX
XXXXXXXXXXXXXXXXXXXXXXXXXXXXXXXXXXXXXXXXXXXXXXXXXXXXXXXXXXXXXXXXXXXXXXXXXXXXXXXXXXXXXXXXXXXXXXXXXXXXXXXXXXXXXXXXXXXXXXXXXXXXXXXXXXXXXXXXXXXXXXXXXXXXXXXXXXXXXXXXXXXXXXXXXXXXXXXXXXXXXXXXXXXXXXXXXXXXXXXX

