--------------------------------------------------------------------------------------------------------------------------------------------------------------------------------------------------------
--------------------------------------------------------------------------------------------------------------------------------------------------------------------------------------------------------
--------------------------------------------------------------------------------------------------------------------------------------------------------------------------------------------------------
--------------------------------------------------------------------------------------------------------------------------------------------------------------------------------------------------------
--------------------------------------------------------------------------------------------------------------------------------------------------------------------------------------------------------
--------------------------------------------------------------------------------------------------------------------------------------------------------------------------------------------------------
--------------------------------------------------------------------------------------------------------------------------------------------------------------------------------------------------------
--------------------------------------------------------------------------------------------------------------------------------------------------------------------------------------------------------
--------------------------------------------------------------------------------------------------------------------------------------------------------------------------------------------------------
--------------------------------------------------------------------------------------------------------------------------------------------------------------------------------------------------------
--------------------------------------------------------------------------------------------------------------------------------------------------------------------------------------------------------
--------------------------------------------------------------------------------------------------------------------------------------------------------------------------------------------------------
-------------------------------------------------------------------------------------------------------ooo-----------------------------ooSSS------------------------------------------------------------
------------------------------------------oSoooo----------------oSooo-----------------------------------------------------------------------------------------------------------------------------------
-------------------ooo----------oooo----------------------------------------------------------oo-------ooo-----------------------------oooooooo---------------------------ooo---------------------------
-----------------------------------------ooooooo---------------oooooooo---------ooSo-----------------------------------------------------------------------------ooo-----------------ooooo--------------
-----------------------XXXX----XXXXXXX---------------------------g-------------------------XXXXXXXXXXXXXXXX---------------------------XXXXXXXXXX-------------------------oooo---------------------------
-----------------------XXXXXXXXXXXXXXXXXXXXXXXXXX------------XXXXXXXXXXXXXXXXXX---oo-------XXXXXXXXXXXXXXXX----------ooo---------XXXXXXXXXXXXXXX-----------ooo-----oo----------------ooooo-----XX-------
XXXXXXXXXXX------XXXXXXXXXXXXXXXXXXXXXXXXXXXXXXXX-------XXXXXXXXXXXXXXXXXXXXXXX--------XXXXXXXXXXXXXXXXXXXX----------------XXXXXXXXXXXXXXXXXXXXXXXXXXXX-----------------XXXXXXXXX--------g-----XXXXXXXXX
XXXXXXXXXXXXXXXXXXXXXXXXXXXXXXXXXXXXXXXXXXXXXXXXXXXXXXXXXXXXXXXXXXXXXXXXXXXXXXXXXXXXXXXXXXXXXXXXXXXXXXXXXXXXXXXXXXXXXXXXXXXXXXXXXXXXXXXXXXXXXXXXXXXXXXXXXXXXXXXXXXXXXXXXXXXXXXXXXXXXXXXXXXXXXXXXXXXXXXXX

