--------------------------------------------------------------------------------------------------------------------------------------------------------------------------------------------------------
--------------------------------------------------------------------------------------------------------------------------------------------------------------------------------------------------------
--------------------------------------------------------------------------------------------------------------------------------------------------------------------------------------------------------
--------------------------------------------------------------------------------------------------------------------------------------------------------------------------------------------------------
--------------------------------------------------------------------------------------------------------------------------------------------------------------------------------------------------------
--------------------------------------------------------------------------------------------------------------------------------------------------------------------------------------------------------
--------------------------------------------------------------------------------------------------------------------------------------------------------------------------------------------------------
--------------------------------------------------------------------------------------------------------------------------------------------------------------------------------------------------------
--------------------------------------------------------------------------------------------------------------------------------------------------------------------------------------------------------
--------------------------------------------------------------------------------------------------------------------------------------------------------------------------------------------------------
--------------------------------------------------------------------------------------------------------------------------------------------------------------------------------------------------------
--------------------------------------------------------------------------------------------------------------------------------------------------------------------------------------------------------
-------------------------------------------------------------------------------ooSoooo-----------------------oooo-----oSS--------------------------------------------------------------ooSooo-----------
-------------------------------------------------------------------------------------------------------------------------------ooSoSo-------------oooooS------------------------------------------------
-------------------------------ooo---------------------------------------ooSo---oooo----------------------------oo-----------------------------------------------------------------------ooo------------
-----------------------------------------------------------------------------------g-----------g------ooo------------------------oooo---------------ooooo----------------oooo-----g---------------------
XXXXXXXXXXXXX----------------ooooo---XXXXX-------XXXX-----XXXXX-----------ooo-XXXXXXXXX-----XXXXXXX---------XXXXXXXXXXXXXXXXX---------------------------------------------------XXXXXXXXXXXXXX----------
XXXXXXXXXXXXXXXXXXXXXX---------------XXXXX-oooo--XXXXXX---XXXXX----oo---------XXXXXXXXX-----XXXXXXXXXXXXXXXXXXXXXXXXXXXXXXXXXXXXXXXXXXXX--XXXX---XXXXXXXXXXXXXXXX-oooo-XXXXXXXXXXXXXXXXXXXXXXXXXXXXXXXXX
XXXXXXXXXXXXXXXXXXXXXX------XXXXXXXXXXXXXX--g----XXXXXXXXXXXXXX----g--XXXXXXXXXXXXXXXXXXXXXXXXXXXXXXXXXXXXXXXXXXXXXXXXXXXXXXXXXXXXXXXXXX--XXXX---XXXXXXXXXXXXXXXX------XXXXXXXXXXXXXXXXXXXXXXXXXXXXXXXXX
XXXXXXXXXXXXXXXXXXXXXXXXXXXXXXXXXXXXXXXXXXXXXXXXXXXXXXXXXXXXXXXXXXXXXXXXXXXXXXXXXXXXXXXXXXXXXXXXXXXXXXXXXXXXXXXXXXXXXXXXXXXXXXXXXXXXXXXXXXXXXXXXXXXXXXXXXXXXXXXXXXXXXXXXXXXXXXXXXXXXXXXXXXXXXXXXXXXXXXXX

