--------------------------------------------------------------------------------------------------------------------------------------------------------------------------------------------------------
--------------------------------------------------------------------------------------------------------------------------------------------------------------------------------------------------------
--------------------------------------------------------------------------------------------------------------------------------------------------------------------------------------------------------
--------------------------------------------------------------------------------------------------------------------------------------------------------------------------------------------------------
--------------------------------------------------------------------------------------------------------------------------------------------------------------------------------------------------------
--------------------------------------------------------------------------------------------------------------------------------------------------------------------------------------------------------
--------------------------------------------------------------------------------------------------------------------------------------------------------------------------------------------------------
--------------------------------------------------------------------------------------------------------------------------------------------------------------------------------------------------------
--------------------------------------------------------------------------------------------------------------------------------------------------------------------------------------------------------
--------------------------------------------------------------------------------------------------------------------------------------------------------------------------------------------------------
--------------------------------------------------------------------------------------------------------------------------------------------------------------------------------------------------------
--------------------------------------------------------------------------------------------------------------------------------------------------------------------------------------------------------
------------------------------------------------------------------------oooSo---------------------------------------------------------------------------------------------------------------------------
-----------------ooo-------------ooo------------------------------------------------ooSSS--------------------------------------------------------------ooSoooS------------------------------------------
-------------------------------------------ooo---------------------------ooooooo--------------------------SooSo----------ooSSo--------------------------------------------Soooo-------------------------
-----------------ooo--------------------------------ooSo---------------------g-g-----ooo--------------------------Soo-------------------------------------oooo------------------------ooo---------------
----------------------XXXX------------------oo------------------------XXXXXXXXXXX------------------XXXXX--oo-------------ooooo-------------------------------g------XXXX--ooooo-------------------------
------------XXXXXXXXXXXXXX-----XXXXXX---------------oo----------------XXXXXXXXXXXXXXXXXXXXXXXXXXX--XXXXX----------------------------oooo-----XXXX-----XXXXXXXXXX----XXXX---------g-----oooo---------XXXX
------------XXXXXXXXXXXXXXXXXXXXXXXXX---XXXXXXXXX--g--------XXXXXXXXXXXXXXXXXXXXXXXXXXXXXXXXXXXXXXXXXXXXXXXXXXXX-g------XXXXXXXX---------XXXXXXXX-----XXXXXXXXXXXXXXXXXXXXXXXXXXXXX------------XXXXXXXXX
XXXXXXXXXXXXXXXXXXXXXXXXXXXXXXXXXXXXXXXXXXXXXXXXXXXXXXXXXXXXXXXXXXXXXXXXXXXXXXXXXXXXXXXXXXXXXXXXXXXXXXXXXXXXXXXXXXXXXXXXXXXXXXXXXXXXXXXXXXXXXXXXXXXXXXXXXXXXXXXXXXXXXXXXXXXXXXXXXXXXXXXXXXXXXXXXXXXXXXXX

