--------------------------------------------------------------------------------------------------------------------------------------------------------------------------------------------------------
--------------------------------------------------------------------------------------------------------------------------------------------------------------------------------------------------------
--------------------------------------------------------------------------------------------------------------------------------------------------------------------------------------------------------
--------------------------------------------------------------------------------------------------------------------------------------------------------------------------------------------------------
--------------------------------------------------------------------------------------------------------------------------------------------------------------------------------------------------------
--------------------------------------------------------------------------------------------------------------------------------------------------------------------------------------------------------
--------------------------------------------------------------------------------------------------------------------------------------------------------------------------------------------------------
--------------------------------------------------------------------------------------------------------------------------------------------------------------------------------------------------------
--------------------------------------------------------------------------------------------------------------------------------------------------------------------------------------------------------
--------------------------------------------------------------------------------------------------------------------------------------------------------------------------------------------------------
--------------------------------------------------------------------------------------------------------------------------------------------------------------------------------------------------------
--------------------------------------------------------------------------------------------------------------------------------------------------------------------------------------------------------
-------------------------------------------oooooo--------------------------------------------oSS--------------oSoSo----------------------------------------------------ooo------------------------------
-----------------------------oSo----------------------SSoooSo-----------------------------------------SoS---------------------------ooo--------------------------------------------------SSSoooo--------
-----------------------------------------ooooooooo--------------------------oSooo-----ooooo--oooo---------------oooo-------oooSoSo--------------------------------------ooo-----------------------------
--------------------oSoS------oooo--------------g------oooooo-----------------------------------------oo------------------------------ooo--------------------------------------------------oooo---------
XXXXXXXXXXXXXX--------------------------XXXXXXXXXXX-----------------ooo------ooo------oo----XXXXXX------g---XXXXXXXXXXXXXX--ooo-------------------------------XXXXX---XXXXXXX---------------------------
XXXXXXXXXXXXXXXXXX--oooooo-XXXXXXXXX----XXXXXXXXXXXXXXXXXXXXXX------------------------g-----XXXXXXXXXXXXXXXXXXXXXXXXXXXXXX---------XXXXXXXX-----XXXX----------XXXXX---XXXXXXX----------XXXXXXXXXXX------
XXXXXXXXXXXXXXXXXX---------XXXXXXXXXXXXXXXXXXXXXXXXXXXXXXXXXXXXXXXXXXXXXXXXXXXXXXXXXXXXXXXXXXXXXXXXXXXXXXXXXXXXXXXXXXXXXXXXXXXXXXXXXXXXXXXX-----XXXX----------XXXXXXXXXXXXXXX----XXXXXXXXXXXXXXXXX------
XXXXXXXXXXXXXXXXXXXXXXXXXXXXXXXXXXXXXXXXXXXXXXXXXXXXXXXXXXXXXXXXXXXXXXXXXXXXXXXXXXXXXXXXXXXXXXXXXXXXXXXXXXXXXXXXXXXXXXXXXXXXXXXXXXXXXXXXXXXXXXXXXXXXXXXXXXXXXXXXXXXXXXXXXXXXXXXXXXXXXXXXXXXXXXXXXXXXXXXX

