--------------------------------------------------------------------------------------------------------------------------------------------------------------------------------------------------------
--------------------------------------------------------------------------------------------------------------------------------------------------------------------------------------------------------
--------------------------------------------------------------------------------------------------------------------------------------------------------------------------------------------------------
--------------------------------------------------------------------------------------------------------------------------------------------------------------------------------------------------------
--------------------------------------------------------------------------------------------------------------------------------------------------------------------------------------------------------
--------------------------------------------------------------------------------------------------------------------------------------------------------------------------------------------------------
--------------------------------------------------------------------------------------------------------------------------------------------------------------------------------------------------------
--------------------------------------------------------------------------------------------------------------------------------------------------------------------------------------------------------
--------------------------------------------------------------------------------------------------------------------------------------------------------------------------------------------------------
--------------------------------------------------------------------------------------------------------------------------------------------------------------------------------------------------------
--------------------------------------------------------------------------------------------------------------------------------------------------------------------------------------------------------
--------------------------------------------------------------------------------------------------------------------------------------------------------------------------------------------------------
--------------------------------------------------------------------------------oSSoSoo-------------------------------------------------------ooo-------------------------------------------------------
------------------ooSo-----------------------------oSSoS-----------------------------------------------------------------------------------------------------------------------------oSoSo--------------
--------------------------oooo----------------------------------------------------oooo------------ooSSooo------------------------------------------------------------oooo-------------------------------
---------------------------------------------------ooo--------oooo--oooSoo----------------------------------------------------------------------------ooooSo---------------------------ooooo------------
XXXXXXXXXXXXX----------XX-ooo-----oooooo-------------g----------------------XXXXXXXXXXXX------XXX----oooooo---------------------------------XXXXXX------------XXXXXX------------------------------------
XXXXXXXXXXXXXXXXXXXXXXXXX--g--------------------XXXXXXXXXX--oooo-----oooo---XXXXXXXXXXXX------XXX----------------XXX-oooo-------------------XXXXXX---ooooooo--XXXXXX-----g----ooo---XXXXXXXXXXXXXXXX----
XXXXXXXXXXXXXXXXXXXXXXXXXXXXXXXXXXXXXXXXXXX-----XXXXXXXXXX-----------g------XXXXXXXXXXXX------XXXXXXXXXXXXXX-----XXX-------XXXX-------XXXXXXXXXXXXXX----------XXXXXXXXXXXXXXX-------XXXXXXXXXXXXXXXXXXXX
XXXXXXXXXXXXXXXXXXXXXXXXXXXXXXXXXXXXXXXXXXXXXXXXXXXXXXXXXXXXXXXXXXXXXXXXXXXXXXXXXXXXXXXXXXXXXXXXXXXXXXXXXXXXXXXXXXXXXXXXXXXXXXXXXXXXXXXXXXXXXXXXXXXXXXXXXXXXXXXXXXXXXXXXXXXXXXXXXXXXXXXXXXXXXXXXXXXXXXXX

