--------------------------------------------------------------------------------------------------------------------------------------------------------------------------------------------------------
--------------------------------------------------------------------------------------------------------------------------------------------------------------------------------------------------------
--------------------------------------------------------------------------------------------------------------------------------------------------------------------------------------------------------
--------------------------------------------------------------------------------------------------------------------------------------------------------------------------------------------------------
--------------------------------------------------------------------------------------------------------------------------------------------------------------------------------------------------------
--------------------------------------------------------------------------------------------------------------------------------------------------------------------------------------------------------
--------------------------------------------------------------------------------------------------------------------------------------------------------------------------------------------------------
--------------------------------------------------------------------------------------------------------------------------------------------------------------------------------------------------------
--------------------------------------------------------------------------------------------------------------------------------------------------------------------------------------------------------
--------------------------------------------------------------------------------------------------------------------------------------------------------------------------------------------------------
--------------------------------------------------------------------------------------------------------------------------------------------------------------------------------------------------------
--------------------------------------------------------------------------------------------------------------------------------------------------------------------------------------------------------
------------------------------------------------------------------------------------------------------------SoSoSo--------------------------------------------------------------------------------------
------------------------------------oSooSoo------------oSSoSo-----------------------------------------------------------------------------ooooooS----------oooo-----------------------------------------
-----------ooo------------------------------------------------------------------------------------------------ooo--------ooo--------------------------------------------------SSooooS-------------------
-------------------------------------ooo-------------ooooooo--------------------------oSoo----Soo--------------------------------------------ooooo---------ooooo---oSS-----------------------oooooo-----
----------XXXXXX----------------------------------------------------------XXXX----------------------------XXXXXXXXXXXXXXXXXXXXXXX--oo---------------XXXX-g-------------------oooooooo-------------------
----------XXXXXXXX---oooo---------XXXXXXXXXX---oo---XXXXXXXXXXX-ooo---XX--XXXXXXXXX--ooooo----oooo---XXXXXXXXXXXXXXXXXXXXXXXXXXXX--------XXXXXXXXXXXXXXXXXXXXXXXXX---oo-------g-----------------oooooo--
XXXXXXXXXXXXXXXXXX-g--------------XXXXXXXXXX------XXXXXXXXXXXXX-------XXXXXXXXXXXXX-----g------------XXXXXXXXXXXXXXXXXXXXXXXXXXXXXXXXXXXXXXXXXXXXXXXXXXXXXXXXXXXXX--------XXXXXXXXXXXXX----------------X
XXXXXXXXXXXXXXXXXXXXXXXXXXXXXXXXXXXXXXXXXXXXXXXXXXXXXXXXXXXXXXXXXXXXXXXXXXXXXXXXXXXXXXXXXXXXXXXXXXXXXXXXXXXXXXXXXXXXXXXXXXXXXXXXXXXXXXXXXXXXXXXXXXXXXXXXXXXXXXXXXXXXXXXXXXXXXXXXXXXXXXXXXXXXXXXXXXXXXXXX

