--------------------------------------------------------------------------------------------------------------------------------------------------------------------------------------------------------
--------------------------------------------------------------------------------------------------------------------------------------------------------------------------------------------------------
--------------------------------------------------------------------------------------------------------------------------------------------------------------------------------------------------------
--------------------------------------------------------------------------------------------------------------------------------------------------------------------------------------------------------
--------------------------------------------------------------------------------------------------------------------------------------------------------------------------------------------------------
--------------------------------------------------------------------------------------------------------------------------------------------------------------------------------------------------------
--------------------------------------------------------------------------------------------------------------------------------------------------------------------------------------------------------
--------------------------------------------------------------------------------------------------------------------------------------------------------------------------------------------------------
--------------------------------------------------------------------------------------------------------------------------------------------------------------------------------------------------------
--------------------------------------------------------------------------------------------------------------------------------------------------------------------------------------------------------
--------------------------------------------------------------------------------------------------------------------------------------------------------------------------------------------------------
--------------------------------------------------------------------------------------------------------------------------------------------------------------------------------------------------------
-----------oooooooo---------------oooS-----------------Soooo----------------------------------------------------SoS-------------------------------------------oSoooo------------------SoSSSo------------
--------------------------------------------------------------------------------------------------------SSS---------------------------------------------------------------------------------------------
--------------ooooo----------------------------------ooooooo----oSo------------SooSSSSo--------------------------oooo---------------------oooo----------------oooo----------ooooo----oooooo-------------
----------------------------oooo---------------------------------------------------------oSoSSo-------------------------oooo----oSS--------------------------------------------------------g------------
----------XXXXXXXXXX-------------XXXXXXX--------XXXXXXXXXXXXXXX-ooooo-----------oooooo------------------------XXXXXXXX---------------------ooo---XXXXXXXX---XXXXXXXXX------XXXXXXXXXXXXXXXXXX-----------
----------XXXXXXXXXX-------------XXXXXXX----ooo-XXXXXXXXXXXXXXX---------g-------------------oooooo----XXXXXXXXXXXXXXXX-oooo-----ooo--------------XXXXXXXX---XXXXXXXXX---XXXXXXXXXXXXXXXXXXXXX-----------
XXXXXXXXXXXXXXXXXXXXXXXXX-----g--XXXXXXX--------XXXXXXXXXXXXXXXXXXXXXXXXXXXXXXXXXXXXXXXX-----------XXXXXXXXXXXXXXXXXXX-------------------XXXXXXXXXXXXXXXXXXXXXXXXXXXX---XXXXXXXXXXXXXXXXXXXXX------XXXXX
XXXXXXXXXXXXXXXXXXXXXXXXXXXXXXXXXXXXXXXXXXXXXXXXXXXXXXXXXXXXXXXXXXXXXXXXXXXXXXXXXXXXXXXXXXXXXXXXXXXXXXXXXXXXXXXXXXXXXXXXXXXXXXXXXXXXXXXXXXXXXXXXXXXXXXXXXXXXXXXXXXXXXXXXXXXXXXXXXXXXXXXXXXXXXXXXXXXXXXXX

