--------------------------------------------------------------------------------------------------------------------------------------------------------------------------------------------------------
--------------------------------------------------------------------------------------------------------------------------------------------------------------------------------------------------------
--------------------------------------------------------------------------------------------------------------------------------------------------------------------------------------------------------
--------------------------------------------------------------------------------------------------------------------------------------------------------------------------------------------------------
--------------------------------------------------------------------------------------------------------------------------------------------------------------------------------------------------------
--------------------------------------------------------------------------------------------------------------------------------------------------------------------------------------------------------
--------------------------------------------------------------------------------------------------------------------------------------------------------------------------------------------------------
--------------------------------------------------------------------------------------------------------------------------------------------------------------------------------------------------------
--------------------------------------------------------------------------------------------------------------------------------------------------------------------------------------------------------
--------------------------------------------------------------------------------------------------------------------------------------------------------------------------------------------------------
--------------------------------------------------------------------------------------------------------------------------------------------------------------------------------------------------------
--------------------------------------------------------------------------------------------------------------------------------------------------------------------------------------------------------
------------------------------------------------------------oSSSo---------------------------------------------------------------------------------------------------------------------------------Soo---
----------------------------------------------ooo-------------------------------------------------------------------------------------------------------------------------------------------------------
----------------------------------------------------------oooooo-------------------------------------oSoo------------------------SSoo-------------oSSoo---------------ooooooo----------------------oooo-
------------------------oooooooo--oooS--------------------------------------------------------------------------------SoS-------------------oooo-------------------------------------ooo----------g-----
---------------------------------------------------------XXXXXXXXXXX-------------XXX--oo------------oo-------------------------ooo-----------------oooo---------XXX----ooooo-------------------XXXXXXXXX
-----------------ooo---XXXXXXXXXX----------XXXXXXXX------XXXXXXXXXXX-------XXXXXXXXX---------ooo---------------XXXXX--oooo------g-----XXX----oo-----------------XXX---------g-------oo---XXX---XXXXXXXXX
XXXXXXXXXXXXXXX--------XXXXXXXXXX----------XXXXXXXX------XXXXXXXXXXX-------XXXXXXXXXXXXXXX--------XXXXXXXXXXXXXXXXXX---------XXXXXXXXXXXX------g-XXXXXXXXXX-----XXXXXXXXXXXXXX-----------XXX---XXXXXXXXX
XXXXXXXXXXXXXXXXXXXXXXXXXXXXXXXXXXXXXXXXXXXXXXXXXXXXXXXXXXXXXXXXXXXXXXXXXXXXXXXXXXXXXXXXXXXXXXXXXXXXXXXXXXXXXXXXXXXXXXXXXXXXXXXXXXXXXXXXXXXXXXXXXXXXXXXXXXXXXXXXXXXXXXXXXXXXXXXXXXXXXXXXXXXXXXXXXXXXXXXX

