--------------------------------------------------------------------------------------------------------------------------------------------------------------------------------------------------------
--------------------------------------------------------------------------------------------------------------------------------------------------------------------------------------------------------
--------------------------------------------------------------------------------------------------------------------------------------------------------------------------------------------------------
--------------------------------------------------------------------------------------------------------------------------------------------------------------------------------------------------------
--------------------------------------------------------------------------------------------------------------------------------------------------------------------------------------------------------
--------------------------------------------------------------------------------------------------------------------------------------------------------------------------------------------------------
--------------------------------------------------------------------------------------------------------------------------------------------------------------------------------------------------------
--------------------------------------------------------------------------------------------------------------------------------------------------------------------------------------------------------
--------------------------------------------------------------------------------------------------------------------------------------------------------------------------------------------------------
--------------------------------------------------------------------------------------------------------------------------------------------------------------------------------------------------------
--------------------------------------------------------------------------------------------------------------------------------------------------------------------------------------------------------
------------------------------------------------------------------------------------------------------------------------------------------------------------------------------------------%%%%%%--------
--------------------------------------------SoSSoo----------------------------------------------------------------------------------------------------------------------------------------||||||--------
-----------------------------------------------------------------------------------oSoSSSSo-----------------------Sooo----------------------ooSoSoo--------------------------oSo----------||||||--------
------------------------SSS----------ooo--ooooooo--------------------ooooo-------------------------------------------------oSSoSSoo-----------------------------------------------------%%%%%%%|--------
------------oooo--------------------------------g------------------------------------oooooo------------------------ooo---------------------oooooo--------oooo---------------------------||||||||--------
--------------g----------oo---------oo---XXXXXXXXXX--------ooo--XXXXXXXXXXX-----------------------------oooo--------------ooooooo--------------------XXX-------XXXX--------------XX-----||||||||--------
-----------XXXXXXX--XX-------------------XXXXXXXXXXXXXXXX-------XXXXXXXXXXXXXXXXXXXXXXXXXXXX-----------------XXXXXXXXXXXX--------------XXXXXXXXXXXXXXXXXXXXXXXXXXXX-------XXXXXXXXX-----||||||||--------
-----------XXXXXXX--XXXXXXXXXXXXXXXXXXXXXXXXXXXXXXXXXXXXXXXXXXXXXXXXXXXXXXXXXXXXXXXXXXXXXXXXXXXXXXXXXXXXXXXXXXXXXXXXXXXXXXXXXXXXXXXXXXXXXXXXXXXXXXXXXXXXXXXXXXXXXXXXXXXXXXXXXXXXXXXXXXXXXXXXXXXXXXXXX---
XXXXXXXXXXXXXXXXXXXXXXXXXXXXXXXXXXXXXXXXXXXXXXXXXXXXXXXXXXXXXXXXXXXXXXXXXXXXXXXXXXXXXXXXXXXXXXXXXXXXXXXXXXXXXXXXXXXXXXXXXXXXXXXXXXXXXXXXXXXXXXXXXXXXXXXXXXXXXXXXXXXXXXXXXXXXXXXXXXXXXXXXXXXXXXXXXXXXXXXX

