--------------------------------------------------------------------------------------------------------------------------------------------------------------------------------------------------------
--------------------------------------------------------------------------------------------------------------------------------------------------------------------------------------------------------
--------------------------------------------------------------------------------------------------------------------------------------------------------------------------------------------------------
--------------------------------------------------------------------------------------------------------------------------------------------------------------------------------------------------------
--------------------------------------------------------------------------------------------------------------------------------------------------------------------------------------------------------
--------------------------------------------------------------------------------------------------------------------------------------------------------------------------------------------------------
--------------------------------------------------------------------------------------------------------------------------------------------------------------------------------------------------------
--------------------------------------------------------------------------------------------------------------------------------------------------------------------------------------------------------
--------------------------------------------------------------------------------------------------------------------------------------------------------------------------------------------------------
--------------------------------------------------------------------------------------------------------------------------------------------------------------------------------------------------------
--------------------------------------------------------------------------------------------------------------------------------------------------------------------------------------------------------
--------------------------------------------------------------------------------------------------------------------------------------------------------------------------------------------------------
---------------------------------------SSo----------------------------------------------------------------------------------------------------------------ooooSoo---------------------------------------
------------oooSSooo----oSSo------------------------------------------Soo--------------------------------------------------------------oSSS-------------------------------------------------------------
----------------------------------------oooo-----------------ooo-------------ooo---------------------------------------------oooooo-----------------------ooooo-----------------------------------------
-----------ooooooo------ooo--------------------oSSo------------------ooooo-------------oooo----------------------------------------------oo---------------------g---------------oooS--------------------
-----------------------------XXX-----XXXXXXXXX--------------ooooo-----------XXXXXX---------------XX-------------ooo---ooo---oooooo----------------XXX---XXXXXXXXXX--------------------------------------
----------XXXXXXXXXXXXXXXXXXXXXX-----XXXXXXXXX--------oooo----------XXXXXXXXXXXXXXXXXXXXXXXXXXXXXXX--XXXXXXX----------g------------g-XXXXXXXXXXXXXXXX---XXXXXXXXXX----------XX---ooooo-XXXXXXXXXXXXXXXXX
----------XXXXXXXXXXXXXXXXXXXXXX-----XXXXXXXXX-------------XXXXXXXXXXXXXXXXXXXXXXXXXXXXXXXXXXXXXXXX--XXXXXXXXXXXXXXXXXXXXXXXXXXXXXXXXXXXXXXXXXXXXXXXXXXXXXXXXXXXXXXXXXX-----XX---------XXXXXXXXXXXXXXXXX
XXXXXXXXXXXXXXXXXXXXXXXXXXXXXXXXXXXXXXXXXXXXXXXXXXXXXXXXXXXXXXXXXXXXXXXXXXXXXXXXXXXXXXXXXXXXXXXXXXXXXXXXXXXXXXXXXXXXXXXXXXXXXXXXXXXXXXXXXXXXXXXXXXXXXXXXXXXXXXXXXXXXXXXXXXXXXXXXXXXXXXXXXXXXXXXXXXXXXXXX

