--------------------------------------------------------------------------------------------------------------------------------------------------------------------------------------------------------
--------------------------------------------------------------------------------------------------------------------------------------------------------------------------------------------------------
--------------------------------------------------------------------------------------------------------------------------------------------------------------------------------------------------------
--------------------------------------------------------------------------------------------------------------------------------------------------------------------------------------------------------
--------------------------------------------------------------------------------------------------------------------------------------------------------------------------------------------------------
--------------------------------------------------------------------------------------------------------------------------------------------------------------------------------------------------------
--------------------------------------------------------------------------------------------------------------------------------------------------------------------------------------------------------
--------------------------------------------------------------------------------------------------------------------------------------------------------------------------------------------------------
--------------------------------------------------------------------------------------------------------------------------------------------------------------------------------------------------------
--------------------------------------------------------------------------------------------------------------------------------------------------------------------------------------------------------
--------------------------------------------------------------------------------------------------------------------------------------------------------------------------------------------------------
--------------------------------------------------------------------------------------------------------------------------------------------------------------------------------------------------------
--------------------------------------------------------------oSSooo---------------------------------------------------------------------------------------ooSooSooo------------------------------------
------------------------------------------------------------------------------------------------oooooo----------oooSS-----------------------------oSSoS---------------ooSoooo---------------------------
---------------------------------------------------------------oooo-------------------------------------oo-----------------oooo----oSooo-------------------oooooo-----------------------oSooooo---------
---------------Soo------------------oooo----------------ooo------------------------------------ooooo------------oooo-------------------------------ooo----------------oooooo----------------------------
---------------------------oo--------------------------------XXXXXXXXXX-----------------------g--------XXXXXXX-----------oooo-----oooo--------------------XXXXXXXXXXX--------------------oooo-------oo--
-------------ooo--------------------oo----------------XXXXXXXXXXXXXXXXX----------XX----ooo--XXXXXXXXXXXXXXXXXXXXXXXXXXXX-----------------------XXXXXXXXXXXXXXXXXXXXXXXXXXXXXXX--XXXXXX------------------
------------------------XXXXXXXX---------XXX------XX--XXXXXXXXXXXXXXXXXXXXXXX----XXXXX------XXXXXXXXXXXXXXXXXXXXXXXXXXXXXXXXXXXXXXXXXXXXXXXXXXXXXXXXXXXXXXXXXXXXXXXXXXXXXXXXXX--XXXXXXXXXXXXXXXXXXXXXXXX
XXXXXXXXXXXXXXXXXXXXXXXXXXXXXXXXXXXXXXXXXXXXXXXXXXXXXXXXXXXXXXXXXXXXXXXXXXXXXXXXXXXXXXXXXXXXXXXXXXXXXXXXXXXXXXXXXXXXXXXXXXXXXXXXXXXXXXXXXXXXXXXXXXXXXXXXXXXXXXXXXXXXXXXXXXXXXXXXXXXXXXXXXXXXXXXXXXXXXXXX

