--------------------------------------------------------------------------------------------------------------------------------------------------------------------------------------------------------
--------------------------------------------------------------------------------------------------------------------------------------------------------------------------------------------------------
--------------------------------------------------------------------------------------------------------------------------------------------------------------------------------------------------------
--------------------------------------------------------------------------------------------------------------------------------------------------------------------------------------------------------
--------------------------------------------------------------------------------------------------------------------------------------------------------------------------------------------------------
--------------------------------------------------------------------------------------------------------------------------------------------------------------------------------------------------------
--------------------------------------------------------------------------------------------------------------------------------------------------------------------------------------------------------
--------------------------------------------------------------------------------------------------------------------------------------------------------------------------------------------------------
--------------------------------------------------------------------------------------------------------------------------------------------------------------------------------------------------------
--------------------------------------------------------------------------------------------------------------------------------------------------------------------------------------------------------
--------------------------------------------------------------------------------------------------------------------------------------------------------------------------------------------------------
--------------------------------------------------------------------------------------------------------------------------------------------------------------------------------------------------------
-------------------oooSo-----------ooo------------------------------------------------------oooSoooo-----oSSo------------------------------------------------------oooo---------------------------------
-------------SoSo---------------------------------------------------------------oooSoSo-----------------------------------------------------------------------------------------------------------------
--------------------oo-------------------SooSooo---------------ooSSSo-----------------------oooooo----ooooo--------------------------------------Soo---ooooSSo----------------------------------oo------
--------------oo-----------------------------------------------------------------------------------------------------------oo-------------------------------------------------oooooooS------------------
------------------XXXXXXX-------XXXXXXX----ooooo---------------ooooo-----------------------XXXXXXXXXXXXXXXXXXX--oo---XXX---------------------------------oo----XXXXXXXXXXXXXX----------------XXXXXXXX---
----------XXXXXXXXXXXXXXX-------XXXXXXX-----------XXXXX------------------------XXXXXXXXX---XXXXXXXXXXXXXXXXXXX-------XXXXXXXXXXXXXX----------------------------XXXXXXXXXXXXXX---ooooo--------XXXXXXXX---
----------XXXXXXXXXXXXXXX-----XXXXXXXXXXXXXXXXXXXXXXXXX------XXXXXXXXXXXXX--XXXXXXXXXXXXXXXXXXXXXXXXXXXXXXXXXXXXXXXXXXXXXXXXXXXXXXX------XXXXXXXXXXXXXXXXXXXXXXXXXXXXXXXXXXXX--g--------XXXXXXXXXXXXXXXX
XXXXXXXXXXXXXXXXXXXXXXXXXXXXXXXXXXXXXXXXXXXXXXXXXXXXXXXXXXXXXXXXXXXXXXXXXXXXXXXXXXXXXXXXXXXXXXXXXXXXXXXXXXXXXXXXXXXXXXXXXXXXXXXXXXXXXXXXXXXXXXXXXXXXXXXXXXXXXXXXXXXXXXXXXXXXXXXXXXXXXXXXXXXXXXXXXXXXXXXX

