--------------------------------------------------------------------------------------------------------------------------------------------------------------------------------------------------------
--------------------------------------------------------------------------------------------------------------------------------------------------------------------------------------------------------
--------------------------------------------------------------------------------------------------------------------------------------------------------------------------------------------------------
--------------------------------------------------------------------------------------------------------------------------------------------------------------------------------------------------------
--------------------------------------------------------------------------------------------------------------------------------------------------------------------------------------------------------
--------------------------------------------------------------------------------------------------------------------------------------------------------------------------------------------------------
--------------------------------------------------------------------------------------------------------------------------------------------------------------------------------------------------------
--------------------------------------------------------------------------------------------------------------------------------------------------------------------------------------------------------
--------------------------------------------------------------------------------------------------------------------------------------------------------------------------------------------------------
--------------------------------------------------------------------------------------------------------------------------------------------------------------------------------------------------------
--------------------------------------------------------------------------------------------------------------------------------------------------------------------------------------------------------
--------------------------------------------------------------------------------------------------------------------------------------------------------------------------------------------------------
----------------oooo-----------------------------------------------------------oooSo--------------------------------------------------------------------------------------------ooo---------------------
---------------------------------SSoS----------oSoo---------------Sooo---------------------------------------------------SSooo------------------------------------------------------------------ooSoS---
--------------ooooooo-----------------------------------------------------------ooo--------------------ooSooSoo---------------------------------------oSSS--------oooo----------oooooo------------------
--------------------------------oooo------------oooo----------------oo--------------------------ooSoo-------------------ooooo------------------------------------------------------------------oooooooo-
------------XXXXXXXXXX-ooooo-------g---------------------oooo-----g---------XXXXXXXXXXX-------------------oooooo--------------------------------------ooooooo---ooooo----------XXXXXXXXXXXX-------------
----------XXXXXXXXXXXX--------XXXXXXXXXX----XXXXXXXXXXX---------XXXXXXXXXXXXXXXXXXXXXXX-----XXX---oo----g--------XXXXXXXXXXXXXXXX-ooo-----oo----------------------------XXXXXXXXXXXXXXXXXXXXXXXXXXXXXXXX
XXXXXXXXXXXXXXXXXXXXXXXXXXXXXXXXXXXXXXXX----XXXXXXXXXXXXXXXXXXXXXXXXXXXXXXXXXXXXXXXXXXX-----XXX-------XXXXXXXXXXXXXXXXXXXXXXXXXXX---g----------------XXXXXXXXXXXXXXXXXXXXXXXXXXXXXXXXXXXXXXXXXXXXXXXXXXX
XXXXXXXXXXXXXXXXXXXXXXXXXXXXXXXXXXXXXXXXXXXXXXXXXXXXXXXXXXXXXXXXXXXXXXXXXXXXXXXXXXXXXXXXXXXXXXXXXXXXXXXXXXXXXXXXXXXXXXXXXXXXXXXXXXXXXXXXXXXXXXXXXXXXXXXXXXXXXXXXXXXXXXXXXXXXXXXXXXXXXXXXXXXXXXXXXXXXXXXX

