--------------------------------------------------------------------------------------------------------------------------------------------------------------------------------------------------------
--------------------------------------------------------------------------------------------------------------------------------------------------------------------------------------------------------
--------------------------------------------------------------------------------------------------------------------------------------------------------------------------------------------------------
--------------------------------------------------------------------------------------------------------------------------------------------------------------------------------------------------------
--------------------------------------------------------------------------------------------------------------------------------------------------------------------------------------------------------
--------------------------------------------------------------------------------------------------------------------------------------------------------------------------------------------------------
--------------------------------------------------------------------------------------------------------------------------------------------------------------------------------------------------------
--------------------------------------------------------------------------------------------------------------------------------------------------------------------------------------------------------
--------------------------------------------------------------------------------------------------------------------------------------------------------------------------------------------------------
--------------------------------------------------------------------------------------------------------------------------------------------------------------------------------------------------------
--------------------------------------------------------------------------------------------------------------------------------------------------------------------------------------------------------
--------------------------------------------------------------------------------------------------------------------------------------------------------------------------------------------------------
------------------------------------------------------------------------------------------------------------------Soo-----------ooooSo------------------------------------------------------------------
---------------------------------------------ooo-------oooSo-------------oooooo-------------------------------------------ooo--------------------------ooooS-------------------------------oSooo--------
----------------------------------------------------------------oo--------------------------ooo-----------------------------------ooooo----SSoo-------------------oSooo---------------------------------
--------------------------------------------------------oooo-------g----ooooo----oooooooS-----------ooSo------------------------------------------Soo--ooooo--------------ooSoSS--------------ooo-------
XXXXXXXXXX--------------------------ooo----------XXX----------XXXXXXX-----------------------------------------XXXXXXXX--------XXXXXXXXXXX-------------------------oo------------------------------------
XXXXXXXXXXXXXX------------XXXXXXXX--------XXXXXXXXXXXXXXXXXXXXXXXXXXXXXXXXXXXXXX--oooooooo-----------oo--XXXXXXXXXXXXXXXXXXXXXXXXXXXXXXXX--------ooo--XXXXXXXXXX------g---oooooo------oo--XXXXXXXXX-----
XXXXXXXXXXXXXXXXXXXXX-----XXXXXXXXXXXXXXXXXXXXXXXXXXXXXXXXXXXXXXXXXXXXXXXXXXXXXX-g---------XXXXXX--------XXXXXXXXXXXXXXXXXXXXXXXXXXXXXXXXXXXXXXX------XXXXXXXXXXXXXXXXXX----------XX------XXXXXXXXXXXXXX
XXXXXXXXXXXXXXXXXXXXXXXXXXXXXXXXXXXXXXXXXXXXXXXXXXXXXXXXXXXXXXXXXXXXXXXXXXXXXXXXXXXXXXXXXXXXXXXXXXXXXXXXXXXXXXXXXXXXXXXXXXXXXXXXXXXXXXXXXXXXXXXXXXXXXXXXXXXXXXXXXXXXXXXXXXXXXXXXXXXXXXXXXXXXXXXXXXXXXXXX

