--------------------------------------------------------------------------------------------------------------------------------------------------------------------------------------------------------
--------------------------------------------------------------------------------------------------------------------------------------------------------------------------------------------------------
--------------------------------------------------------------------------------------------------------------------------------------------------------------------------------------------------------
--------------------------------------------------------------------------------------------------------------------------------------------------------------------------------------------------------
--------------------------------------------------------------------------------------------------------------------------------------------------------------------------------------------------------
--------------------------------------------------------------------------------------------------------------------------------------------------------------------------------------------------------
--------------------------------------------------------------------------------------------------------------------------------------------------------------------------------------------------------
--------------------------------------------------------------------------------------------------------------------------------------------------------------------------------------------------------
--------------------------------------------------------------------------------------------------------------------------------------------------------------------------------------------------------
--------------------------------------------------------------------------------------------------------------------------------------------------------------------------------------------------------
--------------------------------------------------------------------------------------------------------------------------------------------------------------------------------------------------------
--------------------------------------------------------------------------------------------------------------------------------------------------------------------------------------------------------
----------------------ooooo------------------------------oooSSoo----------------------------------------------------------------------------------------------------------------------------------------
-------------------------------SoSoo-------------oooSS-------------------------------------------------------------------------------------------------oooooS--------------Soo--------------------------
------------------------oooo--------------------------------oo------------oSoSoo--------oooo--------------------------------%%%----------------------------------------------------oooSoSo--------------
--------------oSooSo----------oooooo---ooSo-------ooooo---------------------------------------------------SSooS-------------|||-------oSSooo--------------ooooo----------ooooo--------------------------
XXXXXXXXXXX----------XXXXXXXX---------------------------XXXXXXXXX-----------ooooo----------------XXXXXXX-----------XXX------|||-----------------------------------------------------ooo-----------------
XXXXXXXXXXX--ooooooo-XXXXXXXXXXXXXXXX----oo---XXXXXXXXXXXXXXXXXXX-oo-----------------------------XXXXXXX--ooooooo--XXXXXXXXXXXXXX-----ooooo---XXXXXXXXXXXXXXXXXXX------XXXXXXXXX--------------g----XXXXX
XXXXXXXXXXX--------g-XXXXXXXXXXXXXXXX---------XXXXXXXXXXXXXXXXXXX-------XXXXXXXXXXXXXXXXXXXXX----XXXXXXX-----------XXXXXXXXXXXXXXXXX---g------XXXXXXXXXXXXXXXXXXX------XXXXXXXXXXXXXXXXXXXXXXXXXXXXXXXXX
XXXXXXXXXXXXXXXXXXXXXXXXXXXXXXXXXXXXXXXXXXXXXXXXXXXXXXXXXXXXXXXXXXXXXXXXXXXXXXXXXXXXXXXXXXXXXXXXXXXXXXXXXXXXXXXXXXXXXXXXXXXXXXXXXXXXXXXXXXXXXXXXXXXXXXXXXXXXXXXXXXXXXXXXXXXXXXXXXXXXXXXXXXXXXXXXXXXXXXXX

