--------------------------------------------------------------------------------------------------------------------------------------------------------------------------------------------------------
--------------------------------------------------------------------------------------------------------------------------------------------------------------------------------------------------------
--------------------------------------------------------------------------------------------------------------------------------------------------------------------------------------------------------
--------------------------------------------------------------------------------------------------------------------------------------------------------------------------------------------------------
--------------------------------------------------------------------------------------------------------------------------------------------------------------------------------------------------------
--------------------------------------------------------------------------------------------------------------------------------------------------------------------------------------------------------
--------------------------------------------------------------------------------------------------------------------------------------------------------------------------------------------------------
--------------------------------------------------------------------------------------------------------------------------------------------------------------------------------------------------------
--------------------------------------------------------------------------------------------------------------------------------------------------------------------------------------------------------
--------------------------------------------------------------------------------------------------------------------------------------------------------------------------------------------------------
--------------------------------------------------------------------------------------------------------------------------------------------------------------------------------------------------------
--------------------------------------------------------------------------------------------------------------------------------------------------------------------------------------------------------
----------------------------------------------------------oSo-------------------------------------------------------------------------------------------------------------------------------------------
-----------------------oooS------------------oooSo---------------------------------------------------------oooS--------------------------------------------------oooo-----------------------------------
---------------------------------------oooo-----------------------------------ooo-----------------------------------------------------------Soooo-----------------------------------------ooooSooo------
----------------------ooo--------------------oooooooo-------------------------------------------------------ooo----------------------------------------------------ooo------------ooo-------------------
---------------------------g----ooo--XXXXXXX----------XXXXXXXX--------ooo---ooo---XXX---oooo-------------------------------oooo---------------oooo---XXX-------------------------------------ooooo------
--------------------XXXXXXXXX--------XXXXXXXXXXXXXXXXXXXXXXXXX--------------------XXX---------------------XXXXXXX------------------------------------XXX--XXXXXXXXXXXXXXX---------ooooo--------g---XXXXX
-------------XXXXXXXXXXXXXXXXXXXXXXXXXXXXXXXXXXXXXXXXXXXXXXXXXXXXXXXXXXXXXXXXXXXXXXXXXXXXXXXX---XXXXXXXXXXXXXXXXX--------XXXXXXXXXXXX-----XXXXXXXXXXXXXX--XXXXXXXXXXXXXXXXXXXXX----------XXXXXXXXXXXXXXX
XXXXXXXXXXXXXXXXXXXXXXXXXXXXXXXXXXXXXXXXXXXXXXXXXXXXXXXXXXXXXXXXXXXXXXXXXXXXXXXXXXXXXXXXXXXXXXXXXXXXXXXXXXXXXXXXXXXXXXXXXXXXXXXXXXXXXXXXXXXXXXXXXXXXXXXXXXXXXXXXXXXXXXXXXXXXXXXXXXXXXXXXXXXXXXXXXXXXXXXX

