--------------------------------------------------------------------------------------------------------------------------------------------------------------------------------------------------------
--------------------------------------------------------------------------------------------------------------------------------------------------------------------------------------------------------
--------------------------------------------------------------------------------------------------------------------------------------------------------------------------------------------------------
--------------------------------------------------------------------------------------------------------------------------------------------------------------------------------------------------------
--------------------------------------------------------------------------------------------------------------------------------------------------------------------------------------------------------
--------------------------------------------------------------------------------------------------------------------------------------------------------------------------------------------------------
--------------------------------------------------------------------------------------------------------------------------------------------------------------------------------------------------------
--------------------------------------------------------------------------------------------------------------------------------------------------------------------------------------------------------
--------------------------------------------------------------------------------------------------------------------------------------------------------------------------------------------------------
--------------------------------------------------------------------------------------------------------------------------------------------------------------------------------------------------------
--------------------------------------------------------------------------------------------------------------------------------------------------------------------------------------------------------
--------------------------------------------------------------------------------------------------------------------------------------------------------------------------------------------------------
---------------------------------------------------ooS----ooS--------------------------------------------------------------------oooo------------------------------------------------Soo----------------
--------------------------------------------oSo--------------------------------------------------------------------------------------------------------SooS---------------------------------------------
--------------------------------------------------oooo---oooo-------ooSo--------------------------------------------------------ooo------------------------------------------------ooo------------oooo--
----------------------oooSoo----------------oo-------g--------------------------------ooooooS----oooo---------SooSo----------------------oooo---------ooooooo----------ooSoS----------------------------
-------------XXXXX---------------------------g--XXXXXXXXXXXXXXXXX---------oo-------------------------------------------------XXXXXXXXX--------XXXXXX--------------------------XXXXXXXXXXX------XXXXXXXXX
XXXXXXXXXXXXXXXXXX---oooo---------XXXXXXXXXXXXXXXXXXXXXXXXXXXXXXX---------------XXXXX--oooooo------oo--XXX---oooo------------XXXXXXXXX----oo--XXXXXXXXXXXXXXXXX---ooo-----oo--XXXXXXXXXXX------XXXXXXXXX
XXXXXXXXXXXXXXXXXX----------------XXXXXXXXXXXXXXXXXXXXXXXXXXXXXXXXXXXXXXXXXXXXXXXXXXX------------------XXX------g----XXXXX---XXXXXXXXX--------XXXXXXXXXXXXXXXXX---------------XXXXXXXXXXX------XXXXXXXXX
XXXXXXXXXXXXXXXXXXXXXXXXXXXXXXXXXXXXXXXXXXXXXXXXXXXXXXXXXXXXXXXXXXXXXXXXXXXXXXXXXXXXXXXXXXXXXXXXXXXXXXXXXXXXXXXXXXXXXXXXXXXXXXXXXXXXXXXXXXXXXXXXXXXXXXXXXXXXXXXXXXXXXXXXXXXXXXXXXXXXXXXXXXXXXXXXXXXXXXXX

