--------------------------------------------------------------------------------------------------------------------------------------------------------------------------------------------------------
--------------------------------------------------------------------------------------------------------------------------------------------------------------------------------------------------------
--------------------------------------------------------------------------------------------------------------------------------------------------------------------------------------------------------
--------------------------------------------------------------------------------------------------------------------------------------------------------------------------------------------------------
--------------------------------------------------------------------------------------------------------------------------------------------------------------------------------------------------------
--------------------------------------------------------------------------------------------------------------------------------------------------------------------------------------------------------
--------------------------------------------------------------------------------------------------------------------------------------------------------------------------------------------------------
--------------------------------------------------------------------------------------------------------------------------------------------------------------------------------------------------------
--------------------------------------------------------------------------------------------------------------------------------------------------------------------------------------------------------
--------------------------------------------------------------------------------------------------------------------------------------------------------------------------------------------------------
--------------------------------------------------------------------------------------------------------------------------------------------------------------------------------------------------------
--------------------------------------------------------------------------------------------------------------------------------------------------------------------------------------------------------
-------------------------oSoooo---------------------------------------------SSoS-----------------ooo----oooSooo----------------------------Soo---------SSooooo------------------------------------------
----------------------------------------------------oooo------------oSSoo--------------------------------------------------------------------------------------------------------------------------oSoo-
------------------ooooo--oooo-----Sooo------oooo----------------------------ooooo----------------oooo---ooooo-------------ooo---------------ooo-------ooooo---------------------------------------------
---------------------------------------------------ooooo-----------oooo---------g---------------g-------g--------oooSooo----g------------------------------------SSSoo-----------------SooSS------------
------------------------XXXXXXXX---oo------XXXXXX---------XXXX------------XXXXXXXXX------------XXXXXXXXXXXXXXXXX---------XXXXXX---------XXXXXXXX----XXXXXXXXXXX------------oo---------------------------
------------------------XXXXXXXX------g----XXXXXXXXXXXXXXXXXXX--XXXXXXXXXXXXXXXXXXXXXXXXX------XXXXXXXXXXXXXXXXX---ooooo-XXXXXX---------XXXXXXXX----XXXXXXXXXXX--ooooo--------------oooooo-------XXXXXXX
----------XXXXXXXXXXXXXXXXXXXXXXXXXXXXXX---XXXXXXXXXXXXXXXXXXXXXXXXXXXXXXXXXXXXXXXXXXXXXXXXXXXXXXXXXXXXXXXXXXXXX---------XXXXXXXXXXXXXXXXXXXXXXXXXXXXXXXXXXXXXX--------XXXXXXXX-----g------------XXXXXXX
XXXXXXXXXXXXXXXXXXXXXXXXXXXXXXXXXXXXXXXXXXXXXXXXXXXXXXXXXXXXXXXXXXXXXXXXXXXXXXXXXXXXXXXXXXXXXXXXXXXXXXXXXXXXXXXXXXXXXXXXXXXXXXXXXXXXXXXXXXXXXXXXXXXXXXXXXXXXXXXXXXXXXXXXXXXXXXXXXXXXXXXXXXXXXXXXXXXXXXXX

