--------------------------------------------------------------------------------------------------------------------------------------------------------------------------------------------------------
--------------------------------------------------------------------------------------------------------------------------------------------------------------------------------------------------------
--------------------------------------------------------------------------------------------------------------------------------------------------------------------------------------------------------
--------------------------------------------------------------------------------------------------------------------------------------------------------------------------------------------------------
--------------------------------------------------------------------------------------------------------------------------------------------------------------------------------------------------------
--------------------------------------------------------------------------------------------------------------------------------------------------------------------------------------------------------
--------------------------------------------------------------------------------------------------------------------------------------------------------------------------------------------------------
--------------------------------------------------------------------------------------------------------------------------------------------------------------------------------------------------------
--------------------------------------------------------------------------------------------------------------------------------------------------------------------------------------------------------
--------------------------------------------------------------------------------------------------------------------------------------------------------------------------------------------------------
--------------------------------------------------------------------------------------------------------------------------------------------------------------------------------------------------------
--------------------------------------------------------------------------------------------------------------------------------------------------------------------------------------------------------
-----------------oSSo----------------------------------------------------------------------------------------------------------------------------------------------------------------------------ooooo--
------------------------------------------------oSSooo--------------------------------------------------------------------oSSoooo------------------------------ooooo-----SSo----------------------------
---------------ooooo----------------ooooSooo-----------------------------------------------------------------------------------------------------------------------------------------------------oooo---
-----------------------------------------------ooooo-------------------------------------------------oSSoSoS---------------oooo----ooSSSo-----oooSoo----------oooo--------ooooo-------------------------
XXXXXXXXXXXXXXXXXXXXXXXX------------oooooooo-------------XXXXX------XXXXXX--oooo-----------------XX-----------XXXXX-------------------------------------------g-------------------------XXXXXXXXXXXXXXXX
XXXXXXXXXXXXXXXXXXXXXXXX-----XXXXXX---g-------XXXXXXXXXXXXXXXX--oo--XXXXXX----------ooo-----XXXXXXX----oooo---XXXXX-----XXXXXXXXXX--oooooo-----oooo--XXXXXXXXXXXXXXXXXXXXXXXXXXX--------XXXXXXXXXXXXXXXX
XXXXXXXXXXXXXXXXXXXXXXXXXXXXXXXXXXXXXXXXXXXXXXXXXXXXXXXXXXXXXX------XXXXXXXXXXXXX-----------XXXXXXX-----------XXXXX-----XXXXXXXXXX-----g-------------XXXXXXXXXXXXXXXXXXXXXXXXXXXXXXXXXXXXXXXXXXXXXXXXXXX
XXXXXXXXXXXXXXXXXXXXXXXXXXXXXXXXXXXXXXXXXXXXXXXXXXXXXXXXXXXXXXXXXXXXXXXXXXXXXXXXXXXXXXXXXXXXXXXXXXXXXXXXXXXXXXXXXXXXXXXXXXXXXXXXXXXXXXXXXXXXXXXXXXXXXXXXXXXXXXXXXXXXXXXXXXXXXXXXXXXXXXXXXXXXXXXXXXXXXXXX

