--------------------------------------------------------------------------------------------------------------------------------------------------------------------------------------------------------
--------------------------------------------------------------------------------------------------------------------------------------------------------------------------------------------------------
--------------------------------------------------------------------------------------------------------------------------------------------------------------------------------------------------------
--------------------------------------------------------------------------------------------------------------------------------------------------------------------------------------------------------
--------------------------------------------------------------------------------------------------------------------------------------------------------------------------------------------------------
--------------------------------------------------------------------------------------------------------------------------------------------------------------------------------------------------------
--------------------------------------------------------------------------------------------------------------------------------------------------------------------------------------------------------
--------------------------------------------------------------------------------------------------------------------------------------------------------------------------------------------------------
--------------------------------------------------------------------------------------------------------------------------------------------------------------------------------------------------------
--------------------------------------------------------------------------------------------------------------------------------------------------------------------------------------------------------
--------------------------------------------------------------------------------------------------------------------------------------------------------------------------------------------------------
--------------------------------------------------------------------------------------------------------------------------------------------------------------------------------------------------------
----------------------------------------------------------------------------------------------------------------------------------------------Soo--oooS--------------oooSoo--oSoSo----------------------
------------------------------------------------------------------------ooSSooo------------------------------------------------Soo------------------------oSo-------------------------------------------
----------------ooo---------------------------ooooSo------ooooo-----------------------------------------------------ooo--------------------ooooo-----oo-------------------------ooooo-------------------
------------------------oSS--------------------------------------------oooooooo---------------------------ooooo--------------ooooo-------------------------oo----------------------------ooo------------
XXXXXXXXXXXX----oo--------------------------ooooo----XXXXXXXXXXXXXX----------------g------------------------------oooooo------------------XXXXXXXXXXXXXXX-----------XXXXXXXXXXXXXXXXXX------------------
XXXXXXXXXXXX----g--------ooooo-----------------------XXXXXXXXXXXXXX--XXXXXXXXXXXXXXXXXX-ooooo--XXXXX-----XXXXXXX-----------XXXXXXXXXXX----XXXXXXXXXXXXXXXXXXXXX-----XXXXXXXXXXXXXXXXXX----ooo---XX------
XXXXXXXXXXXXXXXXXXXXX---------------------XXXXXXXXXXXXXXXXXXXXXXXXX--XXXXXXXXXXXXXXXXXX-----g--XXXXXXXXXXXXXXXXXXXXXXXXXXXXXXXXXXXXXXX----XXXXXXXXXXXXXXXXXXXXXXXXXXXXXXXXXXXXXXXXXXXX----------XX------
XXXXXXXXXXXXXXXXXXXXXXXXXXXXXXXXXXXXXXXXXXXXXXXXXXXXXXXXXXXXXXXXXXXXXXXXXXXXXXXXXXXXXXXXXXXXXXXXXXXXXXXXXXXXXXXXXXXXXXXXXXXXXXXXXXXXXXXXXXXXXXXXXXXXXXXXXXXXXXXXXXXXXXXXXXXXXXXXXXXXXXXXXXXXXXXXXXXXXXXX

