--------------------------------------------------------------------------------------------------------------------------------------------------------------------------------------------------------
--------------------------------------------------------------------------------------------------------------------------------------------------------------------------------------------------------
--------------------------------------------------------------------------------------------------------------------------------------------------------------------------------------------------------
--------------------------------------------------------------------------------------------------------------------------------------------------------------------------------------------------------
--------------------------------------------------------------------------------------------------------------------------------------------------------------------------------------------------------
--------------------------------------------------------------------------------------------------------------------------------------------------------------------------------------------------------
--------------------------------------------------------------------------------------------------------------------------------------------------------------------------------------------------------
--------------------------------------------------------------------------------------------------------------------------------------------------------------------------------------------------------
--------------------------------------------------------------------------------------------------------------------------------------------------------------------------------------------------------
--------------------------------------------------------------------------------------------------------------------------------------------------------------------------------------------------------
--------------------------------------------------------------------------------------------------------------------------------------------------------------------------------------------------------
--------------------------------------------------------------------------------------------------------------------------------------------------------------------------------------------------------
----------------------------------------------------------------------------ooSSSooo-------------------------SSo----------oooo--------------------------------------------------------------------------
-------------------------ooSoo--------ooSSo-------ooooo------------ooooo--------------------------------------------------------------------------------------------------------------------------------
---------------ooS------------------------------------------------------------oooo--------------------------oooo--------oooo-------------oooo-----------------------------------------------------------
-------------------------oo-------------oooooo----oooooo----------ooooo----------------------------ooooo--------g------------g-------------------------------------ooS----------------------------------
------------ooooooooo------------------------------------XXX--------------XXXXXXXXXXX----XXXXX-----------XXXXXXXXXXX--XXXXXXXXX--------XXXXXXXXXX------------XXXXX------------------XXX--------oooo-XXXX
XXXXXXXXXXX-----------XXXXXXXXX-oo---XXXXXXXXXXXXXXXXXXXXXXX-----XXXXXXXXXXXXXXXXXXXX----XXXXXXXXXXXXXXXXXXXXXXXXXXXXXXXXXXXXXX--------XXXXXXXXXX---oooo-----XXXXX--oooo-----XXXXXXXXXXXXXXXX---g---XXXX
XXXXXXXXXXXXXXXXXXXXXXXXXXXXXXX---g--XXXXXXXXXXXXXXXXXXXXXXXXXXXXXXXXXXXXXXXXXXXXXXXXXXXXXXXXXXXXXXXXXXXXXXXXXXXXXXXXXXXXXXXXXXXXXXX---XXXXXXXXXX--------XXXXXXXXX--g--------XXXXXXXXXXXXXXXXXXXXXXXXXXX
XXXXXXXXXXXXXXXXXXXXXXXXXXXXXXXXXXXXXXXXXXXXXXXXXXXXXXXXXXXXXXXXXXXXXXXXXXXXXXXXXXXXXXXXXXXXXXXXXXXXXXXXXXXXXXXXXXXXXXXXXXXXXXXXXXXXXXXXXXXXXXXXXXXXXXXXXXXXXXXXXXXXXXXXXXXXXXXXXXXXXXXXXXXXXXXXXXXXXXXX

