--------------------------------------------------------------------------------------------------------------------------------------------------------------------------------------------------------
--------------------------------------------------------------------------------------------------------------------------------------------------------------------------------------------------------
--------------------------------------------------------------------------------------------------------------------------------------------------------------------------------------------------------
--------------------------------------------------------------------------------------------------------------------------------------------------------------------------------------------------------
--------------------------------------------------------------------------------------------------------------------------------------------------------------------------------------------------------
--------------------------------------------------------------------------------------------------------------------------------------------------------------------------------------------------------
--------------------------------------------------------------------------------------------------------------------------------------------------------------------------------------------------------
--------------------------------------------------------------------------------------------------------------------------------------------------------------------------------------------------------
--------------------------------------------------------------------------------------------------------------------------------------------------------------------------------------------------------
--------------------------------------------------------------------------------------------------------------------------------------------------------------------------------------------------------
--------------------------------------------------------------------------------------------------------------------------------------------------------------------------------------------------------
--------------------------------------------------------------------------------------------------------------------------------------------------------------------------------------------------------
--------------SoS--------------------------------------------------------------------------------------oooSSoo-------------------------------------------------------------------------ooooS------------
----------------------------------------------ooSo---------------oSS-----------------------------------------------------ooS-------------------oooo-----------------------------------------------------
-------------oooo-------------------------------------------Soo---------ooooo-------------------------ooooo-------------------------------------------------------------oSSSoo---------oooo-------------
--------------------------------------------ooo--------------------------g------------------------------------------------oo------------------ooooooo---------------------------------------------------
----------XXXXXXXXX----------------------------------------------------XXXXXXXXX--------oooo--------XXXXXXXXXXX------------g--------------------------XXXXXX-------------oooo-------XXXXXXXXXX----ooo---
XXXXXXXXXXXXXXXXXXX-------------------XXXXXXXXXXXXX-------------XXXXXXXXXXXXXXXX--------------------XXXXXXXXXXX-------XXXXXXXXX------------XXXXXXXXXXXXXXXXX----------------g--XXXXXXXXXXXXXXX----------
XXXXXXXXXXXXXXXXXXX------XXXXX----XXXXXXXXXXXXXXXXXXXXXXXXXXXXXXXXXXXXXXXXXXXXXX-----XXXXXXXXXX-----XXXXXXXXXXXXXXX---XXXXXXXXX------------XXXXXXXXXXXXXXXXX----------XXXXXXXXXXXXXXXXXXXXXXXX--XXXXXX--
XXXXXXXXXXXXXXXXXXXXXXXXXXXXXXXXXXXXXXXXXXXXXXXXXXXXXXXXXXXXXXXXXXXXXXXXXXXXXXXXXXXXXXXXXXXXXXXXXXXXXXXXXXXXXXXXXXXXXXXXXXXXXXXXXXXXXXXXXXXXXXXXXXXXXXXXXXXXXXXXXXXXXXXXXXXXXXXXXXXXXXXXXXXXXXXXXXXXXXXX

