--------------------------------------------------------------------------------------------------------------------------------------------------------------------------------------------------------
--------------------------------------------------------------------------------------------------------------------------------------------------------------------------------------------------------
--------------------------------------------------------------------------------------------------------------------------------------------------------------------------------------------------------
--------------------------------------------------------------------------------------------------------------------------------------------------------------------------------------------------------
--------------------------------------------------------------------------------------------------------------------------------------------------------------------------------------------------------
--------------------------------------------------------------------------------------------------------------------------------------------------------------------------------------------------------
--------------------------------------------------------------------------------------------------------------------------------------------------------------------------------------------------------
--------------------------------------------------------------------------------------------------------------------------------------------------------------------------------------------------------
--------------------------------------------------------------------------------------------------------------------------------------------------------------------------------------------------------
--------------------------------------------------------------------------------------------------------------------------------------------------------------------------------------------------------
--------------------------------------------------------------------------------------------------------------------------------------------------------------------------------------------------------
--------------------------------------------------------------------------------------------------------------------------------------------------------------------------------------------------------
-------------------------------------------oooSS-------------------------------------SoSoooo------------------------------------------ooo----------------------------------oooo--------SoSooo-----------
-----------------------------------------------------------------oooSo--------------------------oSooo---------------ooo-------------------------ooSooS--------------------------------------------------
--------------------------oSSo-------------oooo---------------------------------------ooo----------------------ooo---------ooSoo-------ooooo-------------------------------ooooooo----ooooo-------------
----------------oooooo-----------------------------------ooo----oooooo----oSSoooo-----g----------ooooo--------------oooo-------------g----------oooooooo----------oooSo---------------------------------
----------------------------------------XXXXXXXXXX--XXX---------------------------XXXXXXXXXXX---------------XXXXXXX---g----oooo----XXXXXXXXXXXX-g-------------XXX---------XXXXXXXXXXXXXXXXXXXX----------
XXXXXXXXXXXXXX--oooooo-----g---------XXXXXXXXXXXXXXXXXXXXXXXXXXXXXXXXXXXX-oooooo--XXXXXXXXXXXXXXXXXXXXX-----XXXXXXXXXXXXXX-----g---XXXXXXXXXXXXXXXXXXXXXXXXXXXXXX----ooo--XXXXXXXXXXXXXXXXXXXXXXXXXXXXXX
XXXXXXXXXXXXXX---------XXXXXXXXXXXXXXXXXXXXXXXXXXXXXXXXXXXXXXXXXXXXXXXXXX---------XXXXXXXXXXXXXXXXXXXXXXXXXXXXXXXXXXXXXXXXXXXXXXXXXXXXXXXXXXXXXXXXXXXXXXXXXXXXXXX---------XXXXXXXXXXXXXXXXXXXXXXXXXXXXXX
XXXXXXXXXXXXXXXXXXXXXXXXXXXXXXXXXXXXXXXXXXXXXXXXXXXXXXXXXXXXXXXXXXXXXXXXXXXXXXXXXXXXXXXXXXXXXXXXXXXXXXXXXXXXXXXXXXXXXXXXXXXXXXXXXXXXXXXXXXXXXXXXXXXXXXXXXXXXXXXXXXXXXXXXXXXXXXXXXXXXXXXXXXXXXXXXXXXXXXXX

