--------------------------------------------------------------------------------------------------------------------------------------------------------------------------------------------------------
--------------------------------------------------------------------------------------------------------------------------------------------------------------------------------------------------------
--------------------------------------------------------------------------------------------------------------------------------------------------------------------------------------------------------
--------------------------------------------------------------------------------------------------------------------------------------------------------------------------------------------------------
--------------------------------------------------------------------------------------------------------------------------------------------------------------------------------------------------------
--------------------------------------------------------------------------------------------------------------------------------------------------------------------------------------------------------
--------------------------------------------------------------------------------------------------------------------------------------------------------------------------------------------------------
--------------------------------------------------------------------------------------------------------------------------------------------------------------------------------------------------------
--------------------------------------------------------------------------------------------------------------------------------------------------------------------------------------------------------
--------------------------------------------------------------------------------------------------------------------------------------------------------------------------------------------------------
--------------------------------------------------------------------------------------------------------------------------------------------------------------------------------------------------------
--------------------------------------------------------------------------------------------------------------------------------------------------------------------------------------------------------
-------------------------------------------------------ooSo---------------------------------------------------------------------------------------------------------------------------------------------
--------------------------------------------------ooo---------------------------------------------------------------------------------------------------------------------------oooo--------------------
----------------oooo-----------------------------------ooo-----oSooooo-------ooo-------------------------------------------------------------------------SooSooo--------Sooo----------------------------
----------------------------------------SooSo----ooo---------------------------------------------------SoSo--------------------ooooSoo---------oooSo----------------------------------------------------
---------------XXXXXXX--------------------------------XXXXXXX-oooooooo-------ooooo---------------oo--------------------oo---------------------------------oooooo---------oooo----------g---g------------
---------------XXXXXXXXXXX-----XX-------oooo--XXXXXXXXXXXXXXX-------------------------------------------------oooo------------oooooooo-----------ooo---------------------------XXXXXXXXXXXXXXX----------
----------XXXXXXXXXXXXXXXX-----XX-------------XXXXXXXXXXXXXXXXXXXXXXXXX---XXXXXXXXX-------XXXXXXXXXXX----------------XXXXXXX--------------------------XXXXXXXXXXXXXXXXXXXXXXXXXXXXXXXXXXXXXXXX-----XXXXX
XXXXXXXXXXXXXXXXXXXXXXXXXXXXXXXXXXXXXXXXXXXXXXXXXXXXXXXXXXXXXXXXXXXXXXXXXXXXXXXXXXXXXXXXXXXXXXXXXXXXXXXXXXXXXXXXXXXXXXXXXXXXXXXXXXXXXXXXXXXXXXXXXXXXXXXXXXXXXXXXXXXXXXXXXXXXXXXXXXXXXXXXXXXXXXXXXXXXXXXX

