--------------------------------------------------------------------------------------------------------------------------------------------------------------------------------------------------------
--------------------------------------------------------------------------------------------------------------------------------------------------------------------------------------------------------
--------------------------------------------------------------------------------------------------------------------------------------------------------------------------------------------------------
--------------------------------------------------------------------------------------------------------------------------------------------------------------------------------------------------------
--------------------------------------------------------------------------------------------------------------------------------------------------------------------------------------------------------
--------------------------------------------------------------------------------------------------------------------------------------------------------------------------------------------------------
--------------------------------------------------------------------------------------------------------------------------------------------------------------------------------------------------------
--------------------------------------------------------------------------------------------------------------------------------------------------------------------------------------------------------
--------------------------------------------------------------------------------------------------------------------------------------------------------------------------------------------------------
--------------------------------------------------------------------------------------------------------------------------------------------------------------------------------------------------------
--------------------------------------------------------------------------------------------------------------------------------------------------------------------------------------------------------
--------------------------------------------------------------------------------------------------------------------------------------------------------------------------------------------------------
--------------------------------oooooooo--------------------------------------------ooSo----------------------------------------------------------------------------------------------------------------
-----------------------------------------------------------------------------------------------------------------------------ooSSooo---------------------------------------ooooo------------------------
----------------ooooSoo------------ooooo------ooSoo----------------------------------oooo-------------ooooo----------------------------------------------------ooSoooo------------------oSoo------------
--------------------------------------------------------------------oSooSSoo-------------------------------------------------ooooo----ooo-----------oSo--------------------ooo--------------------------
----------------ooooo------ooo-XXXXXXXXXXX---------------------------------------XXXXXXXXXXXXXXX--------------------XXXXX----------------------------------oo---ooooooo-----------------oooo------------
-------------------------------XXXXXXXXXXX----------------XX--XXXXX---oooooo-----XXXXXXXXXXXXXXXXXX----------ooooo--XXXXX--XXXXXXXXXXXXXXXX--------oo--------------------XXXXXXXX----XX---------XX------
-------------XXXXXXXXXXXXXXXXXXXXXXXXXXXXX---XXXXXXXXXXXXXXX--XXXXX--------------XXXXXXXXXXXXXXXXXXXXXXXXXXX--g-----XXXXX--XXXXXXXXXXXXXXXX--XXXX-------XXXXXXXXXXXXXXXXXXXXXXXXXXXXXXXXXXXXXXXXXXXXXXXX
XXXXXXXXXXXXXXXXXXXXXXXXXXXXXXXXXXXXXXXXXXXXXXXXXXXXXXXXXXXXXXXXXXXXXXXXXXXXXXXXXXXXXXXXXXXXXXXXXXXXXXXXXXXXXXXXXXXXXXXXXXXXXXXXXXXXXXXXXXXXXXXXXXXXXXXXXXXXXXXXXXXXXXXXXXXXXXXXXXXXXXXXXXXXXXXXXXXXXXXX

