--------------------------------------------------------------------------------------------------------------------------------------------------------------------------------------------------------
--------------------------------------------------------------------------------------------------------------------------------------------------------------------------------------------------------
--------------------------------------------------------------------------------------------------------------------------------------------------------------------------------------------------------
--------------------------------------------------------------------------------------------------------------------------------------------------------------------------------------------------------
--------------------------------------------------------------------------------------------------------------------------------------------------------------------------------------------------------
--------------------------------------------------------------------------------------------------------------------------------------------------------------------------------------------------------
--------------------------------------------------------------------------------------------------------------------------------------------------------------------------------------------------------
--------------------------------------------------------------------------------------------------------------------------------------------------------------------------------------------------------
--------------------------------------------------------------------------------------------------------------------------------------------------------------------------------------------------------
--------------------------------------------------------------------------------------------------------------------------------------------------------------------------------------------------------
--------------------------------------------------------------------------------------------------------------------------------------------------------------------------------------------------------
--------------------------------------------------------------------------------------------------------------------------------------------------------------------------------------------------------
---------------------------oSo--------------------------------------------------------------------------------------------------------------------------------------------------------------------------
-------------------------------------------Sooo------------------oSo-------------------------------------------------------------------------------oooo-----SoS-----------------------------------------
-------------oooooo-------------oooSoo-------------------------------------------------------oSo--------------SoSo--------------------------------------------------------------------------------------
-----------------------------------------oooooo-----oSSo----------oooo--------------------------------oo-------------------------Sooo-----Sooo----oo------ooooo------------ooSSSSooo------oooo----------
XXXXXXXXXXXX----ooo---XXXXXXXXX----ooo----g-----------------XXXX--------XXXXX---XX------------oo------------ooooooo---XX--------------------------------------------------------------------------XXX---
XXXXXXXXXXXX----------XXXXXXXXX--------XXXXXXXXXX--oooooo---XXXXXXXXXXXXXXXXXXXXXX------------------XXXXXX-g----------XX-oo--------------ooo----XXXXXXXXXXXXXXXXXXXXXX--------oooo----------ooooo-XXX---
XXXXXXXXXXXXXXXXXXXXXXXXXXXXXXXXXXXXXXXXXXXXXXXXX-----------XXXXXXXXXXXXXXXXXXXXXX--------XXXXXXXXXXXXXXXXXXXXXXXXXXXXXX------------------------XXXXXXXXXXXXXXXXXXXXXX----------------------------XXXXXX
XXXXXXXXXXXXXXXXXXXXXXXXXXXXXXXXXXXXXXXXXXXXXXXXXXXXXXXXXXXXXXXXXXXXXXXXXXXXXXXXXXXXXXXXXXXXXXXXXXXXXXXXXXXXXXXXXXXXXXXXXXXXXXXXXXXXXXXXXXXXXXXXXXXXXXXXXXXXXXXXXXXXXXXXXXXXXXXXXXXXXXXXXXXXXXXXXXXXXXXX

