--------------------------------------------------------------------------------------------------------------------------------------------------------------------------------------------------------
--------------------------------------------------------------------------------------------------------------------------------------------------------------------------------------------------------
--------------------------------------------------------------------------------------------------------------------------------------------------------------------------------------------------------
--------------------------------------------------------------------------------------------------------------------------------------------------------------------------------------------------------
--------------------------------------------------------------------------------------------------------------------------------------------------------------------------------------------------------
--------------------------------------------------------------------------------------------------------------------------------------------------------------------------------------------------------
--------------------------------------------------------------------------------------------------------------------------------------------------------------------------------------------------------
--------------------------------------------------------------------------------------------------------------------------------------------------------------------------------------------------------
--------------------------------------------------------------------------------------------------------------------------------------------------------------------------------------------------------
--------------------------------------------------------------------------------------------------------------------------------------------------------------------------------------------------------
--------------------------------------------------------------------------------------------------------------------------------------------------------------------------------------------------------
--------------------------------------------------------------------------------------------------------------------------------------------------------------------------------------------------------
-----------------------------------------oooo-------------------------------------------------------------------------------oSoo----------oSoSoSS-----oooooS--------------------------------------------
----------------------------------------------------oSo-----------------------------------------------------------------------------------------------------------------------------------oSoSoo--------
----------------------------------------oo---------------------------------------------------------------------------------------------------oooooo----ooooo------ooooo---------------------------------
------------------------------------------g-------oooo------------------------------------------------SooooSo----------------------------------g---------------------g-----------------ooooooo----------
XXXXXXXXXXXX-----------XXXX----XXXXX--XXXXXXXX-------------------------------XXX-------------XXXXXXX----------XXX---XXXXXXXXXXXXX--------XXXXXXXXXXXXXXXXXXXXX--XXXXXXXX-----------------g--------------
XXXXXXXXXXXX-----------XXXXXXXXXXXXX--XXXXXXXX--XXXXXXXXXX---------oo--------XXXXXXXXXXXXXXXXXXXXXXX---ooooo--XXX---XXXXXXXXXXXXX----oo--XXXXXXXXXXXXXXXXXXXXX--XXXXXXXX-----XXXXX----XXXXXXXXXXX--oo---
XXXXXXXXXXXXXXXXXXXX---XXXXXXXXXXXXXXXXXXXXXXX--XXXXXXXXXX-------------------XXXXXXXXXXXXXXXXXXXXXXX----------XXXXXXXXXXXXXXXXXXX--------XXXXXXXXXXXXXXXXXXXXX--XXXXXXXXXXXXXXXXXX----XXXXXXXXXXX--g----
XXXXXXXXXXXXXXXXXXXXXXXXXXXXXXXXXXXXXXXXXXXXXXXXXXXXXXXXXXXXXXXXXXXXXXXXXXXXXXXXXXXXXXXXXXXXXXXXXXXXXXXXXXXXXXXXXXXXXXXXXXXXXXXXXXXXXXXXXXXXXXXXXXXXXXXXXXXXXXXXXXXXXXXXXXXXXXXXXXXXXXXXXXXXXXXXXXXXXXXX

