--------------------------------------------------------------------------------------------------------------------------------------------------------------------------------------------------------
--------------------------------------------------------------------------------------------------------------------------------------------------------------------------------------------------------
--------------------------------------------------------------------------------------------------------------------------------------------------------------------------------------------------------
--------------------------------------------------------------------------------------------------------------------------------------------------------------------------------------------------------
--------------------------------------------------------------------------------------------------------------------------------------------------------------------------------------------------------
--------------------------------------------------------------------------------------------------------------------------------------------------------------------------------------------------------
--------------------------------------------------------------------------------------------------------------------------------------------------------------------------------------------------------
--------------------------------------------------------------------------------------------------------------------------------------------------------------------------------------------------------
--------------------------------------------------------------------------------------------------------------------------------------------------------------------------------------------------------
--------------------------------------------------------------------------------------------------------------------------------------------------------------------------------------------------------
--------------------------------------------------------------------------------------------------------------------------------------------------------------------------------------------------------
--------------------------------------------------------------------------------------------------------------------------------------------------------------------------------------------------------
-------------------------------------------------------------------------------------------------------------------------oSooooooo----------------------------------------------------------------------
------------------------------------oSoo--------------------------------------------------------ooooS---------------------------------------------------------ooo--------------oooSo--------------------
-----------ooooo---------oSoSo---------------------SoooSSoo--------ooo------------------------------------------oSooo-----oooooooo-----ooSo-------------------------------------------------------------
-----------g---g-g----------------ooooo------------------------------------SSo------------------ooooo---------------------g-------------------------------------------oSoSo------ooooo------------------
----------XXXXXXXXX-----oooooo--------------XXXXX----oooo---------------------------------------------------------ooo---XXXXXXXXXXX-----ooooo-----------------------------------g--------oooooo-XX------
----------XXXXXXXXX---g----g----XXXXXXXXXXXXXXXXX----------------------------oo-------oo----XXXXXXXXXXX----oo-----------XXXXXXXXXXXXXX----g------------------XXXXXX--oooooo---XXXXXXXXX---------XX------
----------XXXXXXXXXXXXXXXXXXXXXXXXXXXXXXXXXXXXXXXXXXXXXXXXXXXXXXXXXXXXXXX--------XXX--------XXXXXXXXXXX-------XXXXXXXXXXXXXXXXXXXXXXXXXXXXXXXXXXXXXXXXXXXXXXXXXXXXX-----------XXXXXXXXXXXXXXXXXXXXXXX---
XXXXXXXXXXXXXXXXXXXXXXXXXXXXXXXXXXXXXXXXXXXXXXXXXXXXXXXXXXXXXXXXXXXXXXXXXXXXXXXXXXXXXXXXXXXXXXXXXXXXXXXXXXXXXXXXXXXXXXXXXXXXXXXXXXXXXXXXXXXXXXXXXXXXXXXXXXXXXXXXXXXXXXXXXXXXXXXXXXXXXXXXXXXXXXXXXXXXXXXX

