--------------------------------------------------------------------------------------------------------------------------------------------------------------------------------------------------------
--------------------------------------------------------------------------------------------------------------------------------------------------------------------------------------------------------
--------------------------------------------------------------------------------------------------------------------------------------------------------------------------------------------------------
--------------------------------------------------------------------------------------------------------------------------------------------------------------------------------------------------------
--------------------------------------------------------------------------------------------------------------------------------------------------------------------------------------------------------
--------------------------------------------------------------------------------------------------------------------------------------------------------------------------------------------------------
--------------------------------------------------------------------------------------------------------------------------------------------------------------------------------------------------------
--------------------------------------------------------------------------------------------------------------------------------------------------------------------------------------------------------
--------------------------------------------------------------------------------------------------------------------------------------------------------------------------------------------------------
--------------------------------------------------------------------------------------------------------------------------------------------------------------------------------------------------------
--------------------------------------------------------------------------------------------------------------------------------------------------------------------------------------------------------
--------------------------------------------------------------------------------------------------------------------------------------------------------------------------------------------------------
-----------------------ooo-----ooSoSo------------------------------------------------ooSoS-----------------------------------oSooS----------------------------------------------------------------------
-------------------------------------------SoSo---------------------------------------------------------------------Soo---------------------------------ooo-------------------ooSoooo-------------------
--------------ooo---oooooooo----ooooo-----------------ooSo-------------------------oooooooo---oooSSSoo------------------------ooo---------------------------------SoSoo----------------------------ooo--
------------------------------------g-----ooooo--------------------------SoooS------------------------------------ooooo------------------SoS-------------ooo-------------------oooooo----------------g--
XXXXXXXXXXXXX-oooo-XXXXXXXXXXXXXXXXXXX----------------oooo------------------------XXXXXXXXXX----oooo-----------------------XXXXXXXXXXXX---------------------------ooooo-XXXXX----------XXXXXX---XXXXXXX-
XXXXXXXXXXXXX------XXXXXXXXXXXXXXXXXXX---XXXXXXXXX-----------------------ooooo----XXXXXXXXXX------g---------XXXXXXXXXXXXXXXXXXXXXXXXXXX---oo-----------XXXXXXX----------XXXXXXXXXXXXXXXXXXXXX---XXXXXXXX
XXXXXXXXXXXXXXXXXXXXXXXXXXXXXXXXXXXXXX---XXXXXXXXXXXXXXXXXXXXXXXXXXXXX----g-------XXXXXXXXXXXXXXXXXXXXXXXXXXXXXXXXXXXXXXXXXXXXXXXXXXXXX--------------XXXXXXXXXXXXXXXXXXXXXXXXXXXXXXXXXXXXXXXXXXXXXXXXXXX
XXXXXXXXXXXXXXXXXXXXXXXXXXXXXXXXXXXXXXXXXXXXXXXXXXXXXXXXXXXXXXXXXXXXXXXXXXXXXXXXXXXXXXXXXXXXXXXXXXXXXXXXXXXXXXXXXXXXXXXXXXXXXXXXXXXXXXXXXXXXXXXXXXXXXXXXXXXXXXXXXXXXXXXXXXXXXXXXXXXXXXXXXXXXXXXXXXXXXXXX

