--------------------------------------------------------------------------------------------------------------------------------------------------------------------------------------------------------
--------------------------------------------------------------------------------------------------------------------------------------------------------------------------------------------------------
--------------------------------------------------------------------------------------------------------------------------------------------------------------------------------------------------------
--------------------------------------------------------------------------------------------------------------------------------------------------------------------------------------------------------
--------------------------------------------------------------------------------------------------------------------------------------------------------------------------------------------------------
--------------------------------------------------------------------------------------------------------------------------------------------------------------------------------------------------------
--------------------------------------------------------------------------------------------------------------------------------------------------------------------------------------------------------
--------------------------------------------------------------------------------------------------------------------------------------------------------------------------------------------------------
--------------------------------------------------------------------------------------------------------------------------------------------------------------------------------------------------------
--------------------------------------------------------------------------------------------------------------------------------------------------------------------------------------------------------
--------------------------------------------------------------------------------------------------------------------------------------------------------------------------------------------------------
--------------------------------------------------------------------------------------------------------------------------------------------------------------------------------------------------------
---------------------------------------------------------ooo-----------------------------------------Sooo-----------------------------------------------------------------------------------------------
-------------------------------------------------------------------SSSSSo-------------------------------------------------------------------SoSooo------------------------------------------------------
----------------------oSo------------------------------ooooo-------------------------------Soo------oooooo---------------------------------------------------------------ooooSoo------------ooSo--------
---------------------------------oooo--------------------------------oooo-------------------------------------------ooSSoSSS---------------oooooo-------------------------------------------------------
XXXXXXXXXXXXXX-------oooo-------------XXXX------------XXXXXXXX-----------------------------ooo----XXXXXXXXXX----oo-------------------------------------oo-------------------oooo------------ooo--------X
XXXXXXXXXXXXXX-----------------XXXXXXXXXXXXXXXX-------XXXXXXXXXXXXXXXXXXXXX-----XXXXXXX-----------XXXXXXXXXX-----------oooooo-------------XXXXXXXXXXX--------XX--ooo-----------------oo----------------X
XXXXXXXXXXXXXXXXXXXXXXXXXXX----XXXXXXXXXXXXXXXXXXX----XXXXXXXXXXXXXXXXXXXXXXXX--XXXXXXXXXXXXXXXXXXXXXXXXXXXXXXXXXXX-----------------------XXXXXXXXXXXXXXXXX--XX---------XXXXXXXXXXX------XXXXXXXXXXXXXXX
XXXXXXXXXXXXXXXXXXXXXXXXXXXXXXXXXXXXXXXXXXXXXXXXXXXXXXXXXXXXXXXXXXXXXXXXXXXXXXXXXXXXXXXXXXXXXXXXXXXXXXXXXXXXXXXXXXXXXXXXXXXXXXXXXXXXXXXXXXXXXXXXXXXXXXXXXXXXXXXXXXXXXXXXXXXXXXXXXXXXXXXXXXXXXXXXXXXXXXXX

