--------------------------------------------------------------------------------------------------------------------------------------------------------------------------------------------------------
--------------------------------------------------------------------------------------------------------------------------------------------------------------------------------------------------------
--------------------------------------------------------------------------------------------------------------------------------------------------------------------------------------------------------
--------------------------------------------------------------------------------------------------------------------------------------------------------------------------------------------------------
--------------------------------------------------------------------------------------------------------------------------------------------------------------------------------------------------------
--------------------------------------------------------------------------------------------------------------------------------------------------------------------------------------------------------
--------------------------------------------------------------------------------------------------------------------------------------------------------------------------------------------------------
--------------------------------------------------------------------------------------------------------------------------------------------------------------------------------------------------------
--------------------------------------------------------------------------------------------------------------------------------------------------------------------------------------------------------
--------------------------------------------------------------------------------------------------------------------------------------------------------------------------------------------------------
--------------------------------------------------------------------------------------------------------------------------------------------------------------------------------------------------------
--------------------------------------------------------------------------------------------------------------------------------------------------------------------------------------------------------
-------------------------------------------------------------ooooSo-------------------------------------------------------ooSSoooo--oooooo--------------------------------------------------------------
-----------------ooSoSooo--------------------------------------------------------------------------------oSooS------------------------------------------------------------------------------------------
---------------------------------------------------------------oooooo------------------oSoSo-------------------------Soo-----ooo-----oo------------------------------------------------------------oo---
------------------oooo-----------SSSSooo---ooSoooo------------------------------------------------------ooooo--------------------------------SSoooS-------------oo--------------------------------------
--------------------------XXXXX-----------------------------XXXXXXXXXXX---------------ooooo------XXXXX--------------oo---XXXXXXXXXXXXXXXXXX------------XXXX-----------------XXXXXXXXXXXXXX---XXXXXXXXXXX
----------------XXXXXXXXXXXXXXX--oooooo-----oooooooo---ooo--XXXXXXXXXXX-ooooooo--------g---g-----XXXXXXXXXXXXXXXX--------XXXXXXXXXXXXXXXXXX----oo------XXXX----XXXXXXXXXXXXXXXXXXXXXXXXXXX---XXXXXXXXXXX
XXXXXXXXXXXXXX--XXXXXXXXXXXXXXX-----------------------------XXXXXXXXXXX-------g-XXXXXXXXXXXXXXXXXXXXXXXXXXXXXXXXXXXXXXXXXXXXXXXXXXXXXXXXXXX------------XXXXXXXXXXXXXXXXXXXXXXXXXXXXXXXXXXXXXXXXXXXXXXXXX
XXXXXXXXXXXXXXXXXXXXXXXXXXXXXXXXXXXXXXXXXXXXXXXXXXXXXXXXXXXXXXXXXXXXXXXXXXXXXXXXXXXXXXXXXXXXXXXXXXXXXXXXXXXXXXXXXXXXXXXXXXXXXXXXXXXXXXXXXXXXXXXXXXXXXXXXXXXXXXXXXXXXXXXXXXXXXXXXXXXXXXXXXXXXXXXXXXXXXXXX

