--------------------------------------------------------------------------------------------------------------------------------------------------------------------------------------------------------
--------------------------------------------------------------------------------------------------------------------------------------------------------------------------------------------------------
--------------------------------------------------------------------------------------------------------------------------------------------------------------------------------------------------------
--------------------------------------------------------------------------------------------------------------------------------------------------------------------------------------------------------
--------------------------------------------------------------------------------------------------------------------------------------------------------------------------------------------------------
--------------------------------------------------------------------------------------------------------------------------------------------------------------------------------------------------------
--------------------------------------------------------------------------------------------------------------------------------------------------------------------------------------------------------
--------------------------------------------------------------------------------------------------------------------------------------------------------------------------------------------------------
--------------------------------------------------------------------------------------------------------------------------------------------------------------------------------------------------------
--------------------------------------------------------------------------------------------------------------------------------------------------------------------------------------------------------
--------------------------------------------------------------------------------------------------------------------------------------------------------------------------------------------------------
--------------------------------------------------------------------------------------------------------------------------------------------------------------------------------------------------------
--------------------------------------------------------------------------------------------------------------------------oSo---------------------------------------------------------------------------
--------------------------------------------------------------------------oSoo----------------------------------oooSSSo-----------------ooo---ooo------------------------------ooSSS--------------------
-----------------ooo------------------------oooooo--oooSoo------oooo---------------------------ooo-----------------------oo----------------------------------------------oo-----------------------------
------------ooo--------------ooSo--oSoooo------------------------g--------oooo-----oo------------------oSoo-----ooooooo------------------------ooo---------------ooo------------oooo--------------------
----------------XXXXXXXX------------------XXXXXXXXX-oooooo----XXXXXXXXXXX-g-------------XXXXXXXXXXX---------------------XXXXXX---XXX-------------------XXXX------------XXXXXXX--------XXXXX-------oo----
-----------oooo-XXXXXXXX------ooo-----oo--XXXXXXXXX-----------XXXXXXXXXXXXXXXXXXXXXXXXXXXXXXXXXXXXX--ooooo---XXXXXXXXXXXXXXXXX---XXXXXXXXXXXXXXXXXXXXXXXXXX-------oo---XXXXXXXXXXXXXXXXXXXXXXX-g-----XXX
XXXXXXXXXX------XXXXXXXXXXX---------------XXXXXXXXXXXXXXXXXXXXXXXXXXXXXXXXXXXXXXXXXXXXXXXXXXXXXXXXX------g---XXXXXXXXXXXXXXXXX---XXXXXXXXXXXXXXXXXXXXXXXXXX------------XXXXXXXXXXXXXXXXXXXXXXXXXXXXXXXXX
XXXXXXXXXXXXXXXXXXXXXXXXXXXXXXXXXXXXXXXXXXXXXXXXXXXXXXXXXXXXXXXXXXXXXXXXXXXXXXXXXXXXXXXXXXXXXXXXXXXXXXXXXXXXXXXXXXXXXXXXXXXXXXXXXXXXXXXXXXXXXXXXXXXXXXXXXXXXXXXXXXXXXXXXXXXXXXXXXXXXXXXXXXXXXXXXXXXXXXXX

