--------------------------------------------------------------------------------------------------------------------------------------------------------------------------------------------------------
--------------------------------------------------------------------------------------------------------------------------------------------------------------------------------------------------------
--------------------------------------------------------------------------------------------------------------------------------------------------------------------------------------------------------
--------------------------------------------------------------------------------------------------------------------------------------------------------------------------------------------------------
--------------------------------------------------------------------------------------------------------------------------------------------------------------------------------------------------------
--------------------------------------------------------------------------------------------------------------------------------------------------------------------------------------------------------
--------------------------------------------------------------------------------------------------------------------------------------------------------------------------------------------------------
--------------------------------------------------------------------------------------------------------------------------------------------------------------------------------------------------------
--------------------------------------------------------------------------------------------------------------------------------------------------------------------------------------------------------
--------------------------------------------------------------------------------------------------------------------------------------------------------------------------------------------------------
--------------------------------------------------------------------------------------------------------------------------------------------------------------------------------------------------------
--------------------------------------------------------------------------------------------------------------------------------------------------------------------------------------------------------
-------------------------oooo-----------------------------------------------SSo----------oSSooo----ooooo------------------------------------------------------------SSoooo------------------------------
--------------ooooo-----------------------oSoo----------------------------------------------------------------------oooooSoo---ooo----------------------------------------------------------------------
------------------------ooo----------------------Soo--------------ooo------ooooooo-------oooooooo-------------oSoo------------------------------oSooS---------------oooooo----------ooSoo--------oooo---
---------------oo-------------------------oo------------------------------------------------------------------------ooooooo-----oo-------------------------oSSo---------g-------------------------------
-----------------------XXXXXXX----------g---g-----oo------------XXXXXXXXXXXXXXXXXXX-----XXXXXXXXXXXXXXXXX----oooo------------------XX-ooooo---oooooo--------------XXXXXXXXXXX-------ooooo---------------
------------XXXXXXXXXXXXXXXXXX----oo---XXXXXXXX-----------XX----XXXXXXXXXXXXXXXXXXX-----XXXXXXXXXXXXXXXXX----------XXXXXXXXXXXXXXXXXX---------------------oooo----XXXXXXXXXXXXXXXXX-------------------XX
XXXXXXXXXXXXXXXXXXXXXXXXXXXXXXXXX------XXXXXXXXXXXXXXXXXXXXXXXXXXXXXXXXXXXXXXXXXXXXXXXXXXXXXXXXXXXXXXXXXX---XXXXXXXXXXXXXXXXXXXXXXXXXXXXXXXXXXXXXXXXXXXX----------XXXXXXXXXXXXXXXXXXXXXXXXXXXXXXXXXXXXXX
XXXXXXXXXXXXXXXXXXXXXXXXXXXXXXXXXXXXXXXXXXXXXXXXXXXXXXXXXXXXXXXXXXXXXXXXXXXXXXXXXXXXXXXXXXXXXXXXXXXXXXXXXXXXXXXXXXXXXXXXXXXXXXXXXXXXXXXXXXXXXXXXXXXXXXXXXXXXXXXXXXXXXXXXXXXXXXXXXXXXXXXXXXXXXXXXXXXXXXXX

