--------------------------------------------------------------------------------------------------------------------------------------------------------------------------------------------------------
--------------------------------------------------------------------------------------------------------------------------------------------------------------------------------------------------------
--------------------------------------------------------------------------------------------------------------------------------------------------------------------------------------------------------
--------------------------------------------------------------------------------------------------------------------------------------------------------------------------------------------------------
--------------------------------------------------------------------------------------------------------------------------------------------------------------------------------------------------------
--------------------------------------------------------------------------------------------------------------------------------------------------------------------------------------------------------
--------------------------------------------------------------------------------------------------------------------------------------------------------------------------------------------------------
--------------------------------------------------------------------------------------------------------------------------------------------------------------------------------------------------------
--------------------------------------------------------------------------------------------------------------------------------------------------------------------------------------------------------
--------------------------------------------------------------------------------------------------------------------------------------------------------------------------------------------------------
--------------------------------------------------------------------------------------------------------------------------------------------------------------------------------------------------------
--------------------------------------------------------------------------------------------------------------------------------------------------------------------------------------------------------
---------------------------------------------ooo----------------oooooo-------------------------------------------------------------------------------------------------------------oSo------------------
----------------------------------------------------------oooo----------------------ooSSooSoo-----------------------------------------------------------------------------------------------------------
----------------------------------Soo-------ooooo------------------------------------------------oSoo--------------------SSSoo-------------------------------------oooSoo---------ooo-------------------
--------------------------------------------------------oooo---------g--------------ooooooooo----------------------------------------------oooo---------------------------------------------------------
-----------XX------XXXXX---------oooo----XXXXXXXXXXXXX-----g---XXXXXXXXXX------------------------ooooo-----XXXXX-----XX-oooooooo-XXXXX-----------------XXXXX-------ooo---------XXXXXXXXXXXXXXXXXX-----XX
XXXXXXXXXXXXXXXXXXXXXXXX---oo------------XXXXXXXXXXXXXXXXXXXXXXXXXXXXXXXX---ooo----XXXXXXXXXXX-------------XXXXX-----XX--------g-XXXXX----XXXXXXX------XXXXXXXX----------------XXXXXXXXXXXXXXXXXXXXXXXXX
XXXXXXXXXXXXXXXXXXXXXXXX------XXXXXXXXXXXXXXXXXXXXXXXXXXXXXXXXXXXXXXXXXXX----------XXXXXXXXXXXXXXXXXXXX----XXXXX-----XXXXXXXXXXXXXXXXXXXXXXXXXXXXXXXXXXXXXXXXXXXXXXXXXXXXXXXXXXXXXXXXXXXXXXXXXXXXXXXXXXX
XXXXXXXXXXXXXXXXXXXXXXXXXXXXXXXXXXXXXXXXXXXXXXXXXXXXXXXXXXXXXXXXXXXXXXXXXXXXXXXXXXXXXXXXXXXXXXXXXXXXXXXXXXXXXXXXXXXXXXXXXXXXXXXXXXXXXXXXXXXXXXXXXXXXXXXXXXXXXXXXXXXXXXXXXXXXXXXXXXXXXXXXXXXXXXXXXXXXXXXX

