--------------------------------------------------------------------------------------------------------------------------------------------------------------------------------------------------------
--------------------------------------------------------------------------------------------------------------------------------------------------------------------------------------------------------
--------------------------------------------------------------------------------------------------------------------------------------------------------------------------------------------------------
--------------------------------------------------------------------------------------------------------------------------------------------------------------------------------------------------------
--------------------------------------------------------------------------------------------------------------------------------------------------------------------------------------------------------
--------------------------------------------------------------------------------------------------------------------------------------------------------------------------------------------------------
--------------------------------------------------------------------------------------------------------------------------------------------------------------------------------------------------------
--------------------------------------------------------------------------------------------------------------------------------------------------------------------------------------------------------
--------------------------------------------------------------------------------------------------------------------------------------------------------------------------------------------------------
--------------------------------------------------------------------------------------------------------------------------------------------------------------------------------------------------------
--------------------------------------------------------------------------------------------------------------------------------------------------------------------------------------------------------
--------------------------------------------------------------------------------------------------------------------------------------------------------------------------------------------------------
----------------------------------------SSoo------------------------------------------------------------------------------------------------------------------------------------------------------------
------------------------------------------------------------------------------------------------------SSSoo-----SSS-------------------------oooo-----------------------ooo-----------------oSSooSo------
---------------------------------oo-----oooooo-------------------oSSS-------------------------------------------------------------------------------------ooooSo----------------------------------------
------------ooSo----------------------------g------oSSo--oSoSo------------ooooo-----------oSoSoooSo--ooooooo-------------------------------oooo------------------------ooooo---------------oooooo-------
XXXXXXXXXXX---------XX------XXXXXXXXXXXXXXXXXXXXXX-----------------ooo------------XXXXXXX----------------------------XXXXX-----------XXXX------------------ooooooo--------------------------------------
XXXXXXXXXXX----oo-XXXX------XXXXXXXXXXXXXXXXXXXXXX-------oooooo-----g---XXXXXXXXXXXXXXXXX-oooooooo--XXXXXXXXXXXXXXXXXXXXXX-------XXXXXXXXXXXXXXXXXXXXXXXX----------XXXXXXXXXXX----------XXXXXXXXXXX-----
XXXXXXXXXXX-------XXXX------XXXXXXXXXXXXXXXXXXXXXX--------------XXXXXXXXXXXXXXXXXXXXXXXXX-----------XXXXXXXXXXXXXXXXXXXXXX----XXXXXXXXXXXXXXXXXXXXXXXXXXXXXXXXXXXXXXXXXXXXXXXX----XXXXXXXXXXXXXXXXXXXXXX
XXXXXXXXXXXXXXXXXXXXXXXXXXXXXXXXXXXXXXXXXXXXXXXXXXXXXXXXXXXXXXXXXXXXXXXXXXXXXXXXXXXXXXXXXXXXXXXXXXXXXXXXXXXXXXXXXXXXXXXXXXXXXXXXXXXXXXXXXXXXXXXXXXXXXXXXXXXXXXXXXXXXXXXXXXXXXXXXXXXXXXXXXXXXXXXXXXXXXXXX

