--------------------------------------------------------------------------------------------------------------------------------------------------------------------------------------------------------
--------------------------------------------------------------------------------------------------------------------------------------------------------------------------------------------------------
--------------------------------------------------------------------------------------------------------------------------------------------------------------------------------------------------------
--------------------------------------------------------------------------------------------------------------------------------------------------------------------------------------------------------
--------------------------------------------------------------------------------------------------------------------------------------------------------------------------------------------------------
--------------------------------------------------------------------------------------------------------------------------------------------------------------------------------------------------------
--------------------------------------------------------------------------------------------------------------------------------------------------------------------------------------------------------
--------------------------------------------------------------------------------------------------------------------------------------------------------------------------------------------------------
--------------------------------------------------------------------------------------------------------------------------------------------------------------------------------------------------------
--------------------------------------------------------------------------------------------------------------------------------------------------------------------------------------------------------
--------------------------------------------------------------------------------------------------------------------------------------------------------------------------------------------------------
--------------------------------------------------------------------------------------------------------------------------------------------------------------------------------------------------------
--------------------------------------------------------------------------------------------------SSoo--------------------------------------------------------------------------------------------------
-------------oooo--------------------------------------------------------------------oSooooo-------------------ooo-------------------------------------------------ooooSo-------------------------------
--------------------------------------------oooo-------oooo--------------------------------------oooooo-----------------------ooo--------------------oooo---------------------ooooo---------------------
------------ooooo--ooo--------ooooS--------------------------------------------------oooooo------------------------------ooo-----------ooooo-----------------------oooo-----------------------SoSoSo----
---------------------------------------------ooo------XXXXXX-ooooo----XXXXXXX-----------------XXXXXXXXXXX-----g--------------XXXXXXX----------------XXXXXX-----------------XX---ooo-XXXXXXX-------------
----------XXXXXXXXXXXXXXX----ooooooo-------g----------XXXXXX--------XXXXXXXXX----XXXXXXXXXXXXXXXXXXXXXXXXXXXXXXXXXXXXXXXXXXXXXXXXXXX----oooo---XXXXXXXXXXX---g--XXXXXXXXXXXXX-------XXXXXXX---ooooooo---
XXXXXXXXXXXXXXXXXXXXXXXXXXX--------g-XXXXXXXXXXXXXXXXXXXXXXXXXXXXXXXXXXXXXXXX----XXXXXXXXXXXXXXXXXXXXXXXXXXXXXXXXXXXXXXXXXXXXXXXXXXXXX---------XXXXXXXXXXXXXXXXXXXXXXXXXXXXXXXXXXXXXXXXXXXX-------------
XXXXXXXXXXXXXXXXXXXXXXXXXXXXXXXXXXXXXXXXXXXXXXXXXXXXXXXXXXXXXXXXXXXXXXXXXXXXXXXXXXXXXXXXXXXXXXXXXXXXXXXXXXXXXXXXXXXXXXXXXXXXXXXXXXXXXXXXXXXXXXXXXXXXXXXXXXXXXXXXXXXXXXXXXXXXXXXXXXXXXXXXXXXXXXXXXXXXXXXX

