--------------------------------------------------------------------------------------------------------------------------------------------------------------------------------------------------------
--------------------------------------------------------------------------------------------------------------------------------------------------------------------------------------------------------
--------------------------------------------------------------------------------------------------------------------------------------------------------------------------------------------------------
--------------------------------------------------------------------------------------------------------------------------------------------------------------------------------------------------------
--------------------------------------------------------------------------------------------------------------------------------------------------------------------------------------------------------
--------------------------------------------------------------------------------------------------------------------------------------------------------------------------------------------------------
--------------------------------------------------------------------------------------------------------------------------------------------------------------------------------------------------------
--------------------------------------------------------------------------------------------------------------------------------------------------------------------------------------------------------
--------------------------------------------------------------------------------------------------------------------------------------------------------------------------------------------------------
--------------------------------------------------------------------------------------------------------------------------------------------------------------------------------------------------------
--------------------------------------------------------------------------------------------------------------------------------------------------------------------------------------------------------
--------------------------------------------------------------------------------------------------------------------------------------------------------------------------------------------------------
--------------------------------------------ooo---------------------------------------------------------------------------------------------------------------------------------------------------------
-------------SooS------------------------------------------------------ooS---------------------------------------------------------------------------------------------ooooSS--------------ooooooo------
---------------------------oSooSo---------ooo------SSoSo---oooo---------------------------------------------------------------------------------------------------ooo-----------------------------------
-----------oooooo------------------------------------------------------oooo---------------------------ooooo-----ooSo------------ooSSoSS---------------------------------oooooo----------------ooo-------
---------------------XXX-oooooo---------XXXXXXXXX--------XXXXXXXXXXXX---------------XXXXXXXXXXXXXXXX-------------------XXXXX-----------------------------------XXXXXXX-----------------------g----------
----------XXXXXXXXX--XXX------------oo--XXXXXXXXX--------XXXXXXXXXXXXXXXXXXX----ooo-XXXXXXXXXXXXXXXXXXXXXXXXX--ooooooo-XXXXXXXX----ooooo----XXXX--ooooo--XXXXXXXXXXXXXXXXXXXXXXXX-ooo-----XXXXXXXXXXX---
----------XXXXXXXXX--XXXXXXXXXXXXX------XXXXXXXXXXXXXXXXXXXXXXXXXXXXXXXXXXXX--------XXXXXXXXXXXXXXXXXXXXXXXXX----------XXXXXXXX-------------XXXX-------g-XXXXXXXXXXXXXXXXXXXXXXXX---------XXXXXXXXXXX---
XXXXXXXXXXXXXXXXXXXXXXXXXXXXXXXXXXXXXXXXXXXXXXXXXXXXXXXXXXXXXXXXXXXXXXXXXXXXXXXXXXXXXXXXXXXXXXXXXXXXXXXXXXXXXXXXXXXXXXXXXXXXXXXXXXXXXXXXXXXXXXXXXXXXXXXXXXXXXXXXXXXXXXXXXXXXXXXXXXXXXXXXXXXXXXXXXXXXXXXX

