--------------------------------------------------------------------------------------------------------------------------------------------------------------------------------------------------------
--------------------------------------------------------------------------------------------------------------------------------------------------------------------------------------------------------
--------------------------------------------------------------------------------------------------------------------------------------------------------------------------------------------------------
--------------------------------------------------------------------------------------------------------------------------------------------------------------------------------------------------------
--------------------------------------------------------------------------------------------------------------------------------------------------------------------------------------------------------
--------------------------------------------------------------------------------------------------------------------------------------------------------------------------------------------------------
--------------------------------------------------------------------------------------------------------------------------------------------------------------------------------------------------------
--------------------------------------------------------------------------------------------------------------------------------------------------------------------------------------------------------
--------------------------------------------------------------------------------------------------------------------------------------------------------------------------------------------------------
--------------------------------------------------------------------------------------------------------------------------------------------------------------------------------------------------------
--------------------------------------------------------------------------------------------------------------------------------------------------------------------------------------------------------
--------------------------------------------------------------------------------------------------------------------------------------------------------------------------------------------------------
------------------------------------------------------------------------------------------oooo----------------------------------------------------------------------------------------------------------
------------------------------------------oSS-----------------------------------------------------------------oSoSS----ooSS----------ooo----------------------------------------------------------------
---------------ooSo------------------------------------oooo----------------------oSSS---oooooo------------------------------------------------------Soo--------------------------SSo--------------------
-------------------------ooo--------------oooo--------------------------------------------------------------ooooooo---------------ooo------------------------------oo--oSoo----------------Sooo---------
----------------ooo--------------ooooo-----------XXXXX--oooo---XXXXXXXXXXX-oooo--ooo---XXXXXXXX--------------------------------------------------ooooooo-----------------------ooooo--------------------
-----------------------------XXX---g---XXXXXXXXXXXXXXX-----g---XXXXXXXXXXX-------------XXXXXXXX------------XXXXXXXXXXXXXXXXXXXX--XXXXXXXXXXXXXXX----------XXXXXXXXXXXX-ooo---------------ooooo-----XXXXX
XXXXXXXXXXXXXXXXXXXXXXX------XXXXXXXXXXXXXXXXXXXXXXXXXXXXXXXXXXXXXXXXXXXXXXXXXXXXXXXXXXXXXXXXXX------------XXXXXXXXXXXXXXXXXXXXXXXXXXXXXXXXXXXXXXXXXXXXXXXXXXXXXXXXXXX--------XXXXXXXXX------------XXXXX
XXXXXXXXXXXXXXXXXXXXXXXXXXXXXXXXXXXXXXXXXXXXXXXXXXXXXXXXXXXXXXXXXXXXXXXXXXXXXXXXXXXXXXXXXXXXXXXXXXXXXXXXXXXXXXXXXXXXXXXXXXXXXXXXXXXXXXXXXXXXXXXXXXXXXXXXXXXXXXXXXXXXXXXXXXXXXXXXXXXXXXXXXXXXXXXXXXXXXXXX

