--------------------------------------------------------------------------------------------------------------------------------------------------------------------------------------------------------
--------------------------------------------------------------------------------------------------------------------------------------------------------------------------------------------------------
--------------------------------------------------------------------------------------------------------------------------------------------------------------------------------------------------------
--------------------------------------------------------------------------------------------------------------------------------------------------------------------------------------------------------
--------------------------------------------------------------------------------------------------------------------------------------------------------------------------------------------------------
--------------------------------------------------------------------------------------------------------------------------------------------------------------------------------------------------------
--------------------------------------------------------------------------------------------------------------------------------------------------------------------------------------------------------
--------------------------------------------------------------------------------------------------------------------------------------------------------------------------------------------------------
--------------------------------------------------------------------------------------------------------------------------------------------------------------------------------------------------------
--------------------------------------------------------------------------------------------------------------------------------------------------------------------------------------------------------
--------------------------------------------------------------------------------------------------------------------------------------------------------------------------------------------------------
--------------------------------------------------------------------------------------------------------------------------------------------------------------------------------------------------------
-----------------------------------------------------------oSSoS------ooSo----------------------------------------------------------ooSS---------------------------------ooSo---------------------------
-------------------------------------------------------------------------------------------------------------------------------------------------------------------------------------------oooooo-------
---------------------------ooo--------Soo--------------------oooooo-----oo--------------------------------------------------------oooooo-----oooooo------------------------------oooooo-----------------
-----------------------------------------------------------------------------ooo------oSoooo--------------------oSSSo------oooo-------------------------------Sooo--------------------------oooooo------
--------------------------XXXXXXX---ooo-------XXX--------XXXXXXXXXXXXXXXXXXX----------------------------------------------------XXXXXXXXXX----ooooo-------------------XXXXXXXXXXXXXXXXXXX---------------
--------------------------XXXXXXX---------XXXXXXX----XXXXXXXXXXXXXXXXXXXXXXXXXXXXXXXX--oooooo-----------oooo--ooooooo--XXXXXXXXXXXXXXXXXXX---------------XX----oo---XXXXXXXXXXXXXXXXXXXXXXXXXXXXXXXX----
XXXXXXXXXXXXXXX-----------XXXXXXXXXXXXXXXXXXXXXXX----XXXXXXXXXXXXXXXXXXXXXXXXXXXXXXXX----------------------------------XXXXXXXXXXXXXXXXXXXXXXXXXXXXX-----XX---------XXXXXXXXXXXXXXXXXXXXXXXXXXXXXXXXXXXX
XXXXXXXXXXXXXXXXXXXXXXXXXXXXXXXXXXXXXXXXXXXXXXXXXXXXXXXXXXXXXXXXXXXXXXXXXXXXXXXXXXXXXXXXXXXXXXXXXXXXXXXXXXXXXXXXXXXXXXXXXXXXXXXXXXXXXXXXXXXXXXXXXXXXXXXXXXXXXXXXXXXXXXXXXXXXXXXXXXXXXXXXXXXXXXXXXXXXXXXX

