--------------------------------------------------------------------------------------------------------------------------------------------------------------------------------------------------------
--------------------------------------------------------------------------------------------------------------------------------------------------------------------------------------------------------
--------------------------------------------------------------------------------------------------------------------------------------------------------------------------------------------------------
--------------------------------------------------------------------------------------------------------------------------------------------------------------------------------------------------------
--------------------------------------------------------------------------------------------------------------------------------------------------------------------------------------------------------
--------------------------------------------------------------------------------------------------------------------------------------------------------------------------------------------------------
--------------------------------------------------------------------------------------------------------------------------------------------------------------------------------------------------------
--------------------------------------------------------------------------------------------------------------------------------------------------------------------------------------------------------
--------------------------------------------------------------------------------------------------------------------------------------------------------------------------------------------------------
--------------------------------------------------------------------------------------------------------------------------------------------------------------------------------------------------------
--------------------------------------------------------------------------------------------------------------------------------------------------------------------------------------------------------
--------------------------------------------------------------------------------------------------------------------------------------------------------------------------------------------------------
---------------------------------------------------------------------------------------------------------ooo----ooo-------------------------oSooooo--------------------------------------oSooSS---------
--------------------------------------------oSSS-------------------------------------------ooo----------------------------------------------------------------------------------------------------------
---------------------------------------------------------------------------------oSoo-------------------------oooooooo-----------------------ooo------------------------------------------oooooo--------
------------------ooSoo----oSooSoo-----------ooo------SSSo--------------------------------oooooo------------------------ooooo---------------------------oooo------------------------------------------g-
-------------XX-----------------------------------------------------------XXXX--ooooooo-----------XXXXXXXXXXXXXXXXXXXXX------------------XXXXXXXXXXX-----------------------------XXXX---XXXXXXXXXXXXXXXX
-------------XX----oooooo--ooooooo---------XXXXXXXX-oooooo----------------XXXX-----g----XXXXXXXXXXXXXXXXXXXXXXXXXXXXXXX----oo--------XXXXXXXXXXXXXXXXXXXXXXXX-ooo----XXXXXX------XXXXXXXXXXXXXXXXXXXXXXX
XXXXXXXXXXXXXXX---------------------XX-----XXXXXXXX-----------------XXXXXXXXXXXXXXXXXXXXXXXXXXXXXXXXXXXXXXXXXXXXXXXXXXX----------XXXXXXXXXXXXXXXXXXXXXXXXXXXX--------XXXXXXXXXXXXXXXXXXXXXXXXXXXXXXXXXXX
XXXXXXXXXXXXXXXXXXXXXXXXXXXXXXXXXXXXXXXXXXXXXXXXXXXXXXXXXXXXXXXXXXXXXXXXXXXXXXXXXXXXXXXXXXXXXXXXXXXXXXXXXXXXXXXXXXXXXXXXXXXXXXXXXXXXXXXXXXXXXXXXXXXXXXXXXXXXXXXXXXXXXXXXXXXXXXXXXXXXXXXXXXXXXXXXXXXXXXXX

