--------------------------------------------------------------------------------------------------------------------------------------------------------------------------------------------------------
--------------------------------------------------------------------------------------------------------------------------------------------------------------------------------------------------------
--------------------------------------------------------------------------------------------------------------------------------------------------------------------------------------------------------
--------------------------------------------------------------------------------------------------------------------------------------------------------------------------------------------------------
--------------------------------------------------------------------------------------------------------------------------------------------------------------------------------------------------------
--------------------------------------------------------------------------------------------------------------------------------------------------------------------------------------------------------
--------------------------------------------------------------------------------------------------------------------------------------------------------------------------------------------------------
--------------------------------------------------------------------------------------------------------------------------------------------------------------------------------------------------------
--------------------------------------------------------------------------------------------------------------------------------------------------------------------------------------------------------
--------------------------------------------------------------------------------------------------------------------------------------------------------------------------------------------------------
--------------------------------------------------------------------------------------------------------------------------------------------------------------------------------------------------------
--------------------------------------------------------------------------------------------------------------------------------------------------------------------------------------------------------
---------------------------------------------------------------------------------------ooSo-------------------------------------------------------------------------------------------------------------
-----------------------------------------------------------oooooo------------------------------oooo--------------------------------------------------SoooSSo--------------------------------------------
-----------------------------------------------ooo-------------------oooo----ooS-------ooo-------------------oSoo----SSo------------------------------------------------ooooo---------------ooo---------
---------------------------------------ooo-----------------oooooo----------------------------oooooo--------------------------------------------------ooooo--------------------------g-------------------
XXXXXXXXXXXXXX------oooo-----------------------oo---------------g--ooooo-----oo------XXXXXXX---gg------------oooo----------------------XXX---XXXXX-------------------------oo-XXXXXXXX------oooooo-XXXXX
XXXXXXXXXXXXXX---------------oooo-------ooo--------------XXXXXXXXX-------------------XXXXXXXXXXXXXXX-----------------------------------XXX---XXXXXXXXXXXXXXXXXXXXXX---------g-XXXXXXXX-------------XXXXX
XXXXXXXXXXXXXX-----XXXXXXXXX----g-----------XXXXXXXXX----XXXXXXXXXXXXXXXXXXXXXXXXXXXXXXXXXXXXXXXXXXXXXX-----XXXXXXXXXXXXX----XXXX------XXXXXXXXXXXXXXXXXXXXXXXXXXXXXXXXXXXXXXXXXXXXXXXXXXXXXXXXXXXXXXXXX
XXXXXXXXXXXXXXXXXXXXXXXXXXXXXXXXXXXXXXXXXXXXXXXXXXXXXXXXXXXXXXXXXXXXXXXXXXXXXXXXXXXXXXXXXXXXXXXXXXXXXXXXXXXXXXXXXXXXXXXXXXXXXXXXXXXXXXXXXXXXXXXXXXXXXXXXXXXXXXXXXXXXXXXXXXXXXXXXXXXXXXXXXXXXXXXXXXXXXXXX

