--------------------------------------------------------------------------------------------------------------------------------------------------------------------------------------------------------
--------------------------------------------------------------------------------------------------------------------------------------------------------------------------------------------------------
--------------------------------------------------------------------------------------------------------------------------------------------------------------------------------------------------------
--------------------------------------------------------------------------------------------------------------------------------------------------------------------------------------------------------
--------------------------------------------------------------------------------------------------------------------------------------------------------------------------------------------------------
--------------------------------------------------------------------------------------------------------------------------------------------------------------------------------------------------------
--------------------------------------------------------------------------------------------------------------------------------------------------------------------------------------------------------
--------------------------------------------------------------------------------------------------------------------------------------------------------------------------------------------------------
--------------------------------------------------------------------------------------------------------------------------------------------------------------------------------------------------------
--------------------------------------------------------------------------------------------------------------------------------------------------------------------------------------------------------
--------------------------------------------------------------------------------------------------------------------------------------------------------------------------------------------------------
--------------------------------------------------------------------------------------------------------------------------------------------------------------------------------------------------------
------------------------------ooSSooooo--------------ooooo-------------------------------------------------------------------------------ooSo-------------ooSo------------------------------------------
-------------------------------------------------------------------------------------ooooSo----------------SoooS----------------------------------------------------------------------------SSooS-------
--------------------------------oooo---------------ooooo---------------oSooo-----------------------------------------------oSS--------oooo------ooooo-----oooooo----------------------------------------
--------------oo-----------------------------oooo------------------------------------oooo----ooooo----------ooooo----------------------------------g-------------------oSooooo---ooSSoSS------oooo------
-----------------------------XXXXXXXXXXX----------XXXXXXXXXXXXXX----------oooo-XX-------------------------g----------XXXX--ooooo-----XXXXXXXXXXXXXXXXXXXXXXXXXXXXXXXX-------------------------------XXXX
----------XXXXXXXXXX-ooooooo-XXXXXXXXXXX----------XXXXXXXXXXXXXX-oooo--g-------XXXXXXXXXXXXXXXXXXXXXXXXXXXXXXXXXXXXXXXXXX---------XXXXXXXXXXXXXXXXXXXXXXXXXXXXXXXXXXX---ooooo-----ooooo---XXXXXXXXXXXXXX
XXXXXXXXXXXXXXXXXXXX----g----XXXXXXXXXXXXXXX------XXXXXXXXXXXXXX------XXXXXXXXXXXXXXXXXXXXXXXXXXXXXXXXXXXXXXXXXXXXXXXXXXXXXXXXXXXXXXXXXXXXXXXXXXXXXXXXXXXXXXXXXXXXXXX----g----------------XXXXXXXXXXXXXX
XXXXXXXXXXXXXXXXXXXXXXXXXXXXXXXXXXXXXXXXXXXXXXXXXXXXXXXXXXXXXXXXXXXXXXXXXXXXXXXXXXXXXXXXXXXXXXXXXXXXXXXXXXXXXXXXXXXXXXXXXXXXXXXXXXXXXXXXXXXXXXXXXXXXXXXXXXXXXXXXXXXXXXXXXXXXXXXXXXXXXXXXXXXXXXXXXXXXXXXX

