--------------------------------------------------------------------------------------------------------------------------------------------------------------------------------------------------------
--------------------------------------------------------------------------------------------------------------------------------------------------------------------------------------------------------
--------------------------------------------------------------------------------------------------------------------------------------------------------------------------------------------------------
--------------------------------------------------------------------------------------------------------------------------------------------------------------------------------------------------------
--------------------------------------------------------------------------------------------------------------------------------------------------------------------------------------------------------
--------------------------------------------------------------------------------------------------------------------------------------------------------------------------------------------------------
--------------------------------------------------------------------------------------------------------------------------------------------------------------------------------------------------------
--------------------------------------------------------------------------------------------------------------------------------------------------------------------------------------------------------
--------------------------------------------------------------------------------------------------------------------------------------------------------------------------------------------------------
--------------------------------------------------------------------------------------------------------------------------------------------------------------------------------------------------------
--------------------------------------------------------------------------------------------------------------------------------------------------------------------------------------------------------
--------------------------------------------------------------------------------------------------------------------------------------------------------------------------------------------------------
-------------------------------oSooooo------------------------------------------------------------------------------------------------------------------------------------------------------------------
-------------------------------------------------oooSSooo-----------------------------------------------------------------------------------------------------------------------------------------------
----------------------------------ooooo-------------------------------------oSoo---------------------------------------------SSo-----------------------------------------ooooo--------------------------
-------------------------------------------oSo-----ooooooo------------oo---------------------------ooSoooS---------------------------------SoSoo--------ooSooo-----SSoo-------------ooSoSo----oooo------
XXXXXXXXXXXXX-----------------XXXXXXXXXX-------------g---------------------ooooo---------ooo----------------------------------oo--------------------------------------------ooooo------------------XXXXX
XXXXXXXXXXXXXXXX--------------XXXXXXXXXX--oooo--XXXXXXXXXXX--------XXXXXX---gg----g----------XXXX--oooooo---XXXXXXXX-----------------------oooo---------oooo-------------------g-----ooo-----oooo--XXXXX
XXXXXXXXXXXXXXXX------XXXXXXXXXXXXXXXXXX-g------XXXXXXXXXXXXXXXXXXXXXXXXXXXXXXXXXXXX--XXXXXXXXXXX---------g-XXXXXXXXXXXXXXXXXXXXXXXXXXXX--------------------------------XXXXXXXXXX-----------------XXXXX
XXXXXXXXXXXXXXXXXXXXXXXXXXXXXXXXXXXXXXXXXXXXXXXXXXXXXXXXXXXXXXXXXXXXXXXXXXXXXXXXXXXXXXXXXXXXXXXXXXXXXXXXXXXXXXXXXXXXXXXXXXXXXXXXXXXXXXXXXXXXXXXXXXXXXXXXXXXXXXXXXXXXXXXXXXXXXXXXXXXXXXXXXXXXXXXXXXXXXXXX

