--------------------------------------------------------------------------------------------------------------------------------------------------------------------------------------------------------
--------------------------------------------------------------------------------------------------------------------------------------------------------------------------------------------------------
--------------------------------------------------------------------------------------------------------------------------------------------------------------------------------------------------------
--------------------------------------------------------------------------------------------------------------------------------------------------------------------------------------------------------
--------------------------------------------------------------------------------------------------------------------------------------------------------------------------------------------------------
--------------------------------------------------------------------------------------------------------------------------------------------------------------------------------------------------------
--------------------------------------------------------------------------------------------------------------------------------------------------------------------------------------------------------
--------------------------------------------------------------------------------------------------------------------------------------------------------------------------------------------------------
--------------------------------------------------------------------------------------------------------------------------------------------------------------------------------------------------------
--------------------------------------------------------------------------------------------------------------------------------------------------------------------------------------------------------
--------------------------------------------------------------------------------------------------------------------------------------------------------------------------------------------------------
--------------------------------------------------------------------------------------------------------------------------------------------------------------------------------------------------------
-------------------------------------------------------------------oSoooSo----------------SoSo----------------------------------------------------------------------------------------------------------
------------------------------------------------oSooSooSo----------------------------------------------------------oSS--------ooo-------Soo--ooooo---------SSooo----------------------------------------
--------------------------------------------------------------------ooooo--------SoSo-----oooo-------------------------------------------------------------------------------ooooo----------------------
---------------------------------------------------ooooo-------------------------------------------ooooo---Soo------ooooo--ooooooo------oo-----------SSo--ooo-----oooSo---------------------------------
--------------------------XXXXX-ooooo------------------g----------XXXXXXXXXXX---ooooooo-XXXXXXX---------------------g----------------------------------------------------------oooo---------------------
-------------XXXXX--------XXXXX-----------XXXXXXXXXXXXXXXX--XXXXXXXXXXXXXXXXX-----------XXXXXXX--oooo------oooo---XXXXXXXXXXXXXXXXXXXXXXXXXXXXXXXXX------XXXXXXXX--oooooo-------------------XXXXXX---oo-
-------------XXXXXXXXXXXXXXXXXXXXXXXXXX---XXXXXXXXXXXXXXXX--XXXXXXXXXXXXXXXXXXXXXXXXXXXXXXXXXXX-------------------XXXXXXXXXXXXXXXXXXXXXXXXXXXXXXXXX------XXXXXXXX----------XXXXXXXXXXXXXXXXXXXXXXX------
XXXXXXXXXXXXXXXXXXXXXXXXXXXXXXXXXXXXXXXXXXXXXXXXXXXXXXXXXXXXXXXXXXXXXXXXXXXXXXXXXXXXXXXXXXXXXXXXXXXXXXXXXXXXXXXXXXXXXXXXXXXXXXXXXXXXXXXXXXXXXXXXXXXXXXXXXXXXXXXXXXXXXXXXXXXXXXXXXXXXXXXXXXXXXXXXXXXXXXXX

