--------------------------------------------------------------------------------------------------------------------------------------------------------------------------------------------------------
--------------------------------------------------------------------------------------------------------------------------------------------------------------------------------------------------------
--------------------------------------------------------------------------------------------------------------------------------------------------------------------------------------------------------
--------------------------------------------------------------------------------------------------------------------------------------------------------------------------------------------------------
--------------------------------------------------------------------------------------------------------------------------------------------------------------------------------------------------------
--------------------------------------------------------------------------------------------------------------------------------------------------------------------------------------------------------
--------------------------------------------------------------------------------------------------------------------------------------------------------------------------------------------------------
--------------------------------------------------------------------------------------------------------------------------------------------------------------------------------------------------------
--------------------------------------------------------------------------------------------------------------------------------------------------------------------------------------------------------
--------------------------------------------------------------------------------------------------------------------------------------------------------------------------------------------------------
--------------------------------------------------------------------------------------------------------------------------------------------------------------------------------------------------------
--------------------------------------------------------------------------------------------------------------------------------------------------------------------------------------------------------
-------------ooSoo----------------------------------oSS------------------------------------------------------------------------------Soo----------------------------------------------------------------
------------------------------------------------------------------------------------------------ooSS------oSSo--------ooS------------------------------oSS------------------------------oSSSo-----------
----------------------SSS---------oooSooSo---------oo--------------------------------------------------------------------------------oooo----------------------------------ooSoSSo----------------------
---------------------------------------------------------------------------------------------------oo--oooooo--------ooo---------------------ooooSSoo--------------------------------------oo-----------
----------XXXXXXXXX----ooo----------oooo--------XXXXXXXXX------------------------g--------XXXXX----------g------------------------XXXXXXXXXX----------------------XX------ooooooo-----------------------
XXXXXXXXXXXXXXXXXXX-----------------------------XXXXXXXXX---------------g--XXXXXXXXXX-----XXXXXXXXXXXXXXXXXXXXX----XXXXXXXX-------XXXXXXXXXX--oooo----XXXXXX------XX-------------------XXXXXXXX---------
XXXXXXXXXXXXXXXXXXXXXXXXXXXXX----XXXXXXXXXXXXXXXXXXXXXXXXXXX---------XXXXXXXXXXXXXXXX-----XXXXXXXXXXXXXXXXXXXXX----XXXXXXXX-------XXXXXXXXXX----------XXXXXXXXXXXXXXXXXXXXXXXXXXXXXX---XXXXXXXX-----XXXX
XXXXXXXXXXXXXXXXXXXXXXXXXXXXXXXXXXXXXXXXXXXXXXXXXXXXXXXXXXXXXXXXXXXXXXXXXXXXXXXXXXXXXXXXXXXXXXXXXXXXXXXXXXXXXXXXXXXXXXXXXXXXXXXXXXXXXXXXXXXXXXXXXXXXXXXXXXXXXXXXXXXXXXXXXXXXXXXXXXXXXXXXXXXXXXXXXXXXXXXX

