--------------------------------------------------------------------------------------------------------------------------------------------------------------------------------------------------------
--------------------------------------------------------------------------------------------------------------------------------------------------------------------------------------------------------
--------------------------------------------------------------------------------------------------------------------------------------------------------------------------------------------------------
--------------------------------------------------------------------------------------------------------------------------------------------------------------------------------------------------------
--------------------------------------------------------------------------------------------------------------------------------------------------------------------------------------------------------
--------------------------------------------------------------------------------------------------------------------------------------------------------------------------------------------------------
--------------------------------------------------------------------------------------------------------------------------------------------------------------------------------------------------------
--------------------------------------------------------------------------------------------------------------------------------------------------------------------------------------------------------
--------------------------------------------------------------------------------------------------------------------------------------------------------------------------------------------------------
--------------------------------------------------------------------------------------------------------------------------------------------------------------------------------------------------------
--------------------------------------------------------------------------------------------------------------------------------------------------------------------------------------------------------
--------------------------------------------------------------------------------------------------------------------------------------------------------------------------------------------------------
-----------------------------------------------oooSoo-----------------------------------------------------------------------------------------------------------------------Sooooo----------------------
-----------------------------------------------------------------------SoS-----------------------oSo-------------------------SoSooo-------------------------ooooo---------------------------------------
-------------------ooooSS-------------------------------ooo--oSSo-------------ooS-----oSooo------------------------------------------ooooo-----------------------------------ooooooo--------------------
--------------------------------------------------------------------ooooo-----------------------oooo----------oSoooo---------ooooo------------Soo-------------oo----------------------------------------
-------------XXX----ooooo--XXXXXXXXXXXXX-----XXXXXXXXXXXXXXX--ooo-------------ooo-----oooooo-------------------------XXXXXX---------XXXXXXX-----------------------------XXXXXXXXXXXXX-------------------
-----------XXXXX--g--------XXXXXXXXXXXXXXXXXXXXXXXXXXXXXXXXX--g----XXXXXXXXX------------------XXXXXXXX-------oooooo--XXXXXXXXXXXXXXXXXXXXXX---------------XXXXXXXX---XXXXXXXXXXXXXXXXXXXXXXX------------
XXXXXXXXXXXXXXXXXXXXXXXXXXXXXXXXXXXXXXXXXXXXXXXXXXXXXXXXXXXXXXXXXXXXXXXXXXXXXXXXXXXXXXXXXXXXXXXXXXXXXX----------g----XXXXXXXXXXXXXXXXXXXXXX-------XXXXXXXXXXXXXXXXXXXXXXXXXXXXXXXXXXXXXXXXXX------------
XXXXXXXXXXXXXXXXXXXXXXXXXXXXXXXXXXXXXXXXXXXXXXXXXXXXXXXXXXXXXXXXXXXXXXXXXXXXXXXXXXXXXXXXXXXXXXXXXXXXXXXXXXXXXXXXXXXXXXXXXXXXXXXXXXXXXXXXXXXXXXXXXXXXXXXXXXXXXXXXXXXXXXXXXXXXXXXXXXXXXXXXXXXXXXXXXXXXXXXX

