--------------------------------------------------------------------------------------------------------------------------------------------------------------------------------------------------------
--------------------------------------------------------------------------------------------------------------------------------------------------------------------------------------------------------
--------------------------------------------------------------------------------------------------------------------------------------------------------------------------------------------------------
--------------------------------------------------------------------------------------------------------------------------------------------------------------------------------------------------------
--------------------------------------------------------------------------------------------------------------------------------------------------------------------------------------------------------
--------------------------------------------------------------------------------------------------------------------------------------------------------------------------------------------------------
--------------------------------------------------------------------------------------------------------------------------------------------------------------------------------------------------------
--------------------------------------------------------------------------------------------------------------------------------------------------------------------------------------------------------
--------------------------------------------------------------------------------------------------------------------------------------------------------------------------------------------------------
--------------------------------------------------------------------------------------------------------------------------------------------------------------------------------------------------------
--------------------------------------------------------------------------------------------------------------------------------------------------------------------------------------------------------
--------------------------------------------------------------------------------------------------------------------------------------------------------------------------------------------------------
----------------------------------------------SoSS-------ooooSo----------------------------------------------------------ooSSoo-------------------------------------------------------------------------
-------------------------------------------------------------------------------------------------------------------------------------------------------------------------------------oooSooo------------
--------------------------------ooooo---------ooooo------ooooooo----------------------------------------------------------oooo----------------SSoSo------------------------oooo-------------------------
---------------------------------------------------------------------------------------ooo-----------------------ooSoSo-----------Soooo---------------ooo------------------------------ooooo----oSoSSoo-
--------------------XXXXXX----XXXXXXXXX-----XXXXXXXX---XXXXXXXXXXX---------------------------------XXXXXXXXXXX----------XXXXXXXX-------------oooooo----------XXX--XXXXX---XXXXXXXXXX--------------------
XXXXXXXXXXX---ooo---XXXXXXXXXXXXXXXXXXXXXX--XXXXXXXXXXXXXXXXXXXXXXXXXXX---------ooooo--------------XXXXXXXXXXX-ooooo----XXXXXXXX-oooooo--------------XXXXXXXXXXX--XXXXX---XXXXXXXXXXXXXXXXXXXXX---------
XXXXXXXXXXX---------XXXXXXXXXXXXXXXXXXXXXX--XXXXXXXXXXXXXXXXXXXXXXXXXXXXXXXXXX------g-------g------XXXXXXXXXXX-------g--XXXXXXXX-----------XXXXXXXXXXXXXXXXXXXXXXXXXXXX---XXXXXXXXXXXXXXXXXXXXX---------
XXXXXXXXXXXXXXXXXXXXXXXXXXXXXXXXXXXXXXXXXXXXXXXXXXXXXXXXXXXXXXXXXXXXXXXXXXXXXXXXXXXXXXXXXXXXXXXXXXXXXXXXXXXXXXXXXXXXXXXXXXXXXXXXXXXXXXXXXXXXXXXXXXXXXXXXXXXXXXXXXXXXXXXXXXXXXXXXXXXXXXXXXXXXXXXXXXXXXXXX

