--------------------------------------------------------------------------------------------------------------------------------------------------------------------------------------------------------
--------------------------------------------------------------------------------------------------------------------------------------------------------------------------------------------------------
--------------------------------------------------------------------------------------------------------------------------------------------------------------------------------------------------------
--------------------------------------------------------------------------------------------------------------------------------------------------------------------------------------------------------
--------------------------------------------------------------------------------------------------------------------------------------------------------------------------------------------------------
--------------------------------------------------------------------------------------------------------------------------------------------------------------------------------------------------------
--------------------------------------------------------------------------------------------------------------------------------------------------------------------------------------------------------
--------------------------------------------------------------------------------------------------------------------------------------------------------------------------------------------------------
--------------------------------------------------------------------------------------------------------------------------------------------------------------------------------------------------------
--------------------------------------------------------------------------------------------------------------------------------------------------------------------------------------------------------
--------------------------------------------------------------------------------------------------------------------------------------------------------------------------------------------------------
--------------------------------------------------------------------------------------------------------------------------------------------------------------------------------------------------------
-----------------------------------------------------------------------------------------------------ooooo-------------------Soo------------------------------------------------oSoooo------------------
---------------------------oSo-----------------------------------------------------------------------------------------------------oooo----------------------------SoooooS---------------oooSo----------
-----------------------------------------------------------------------------------------------------------------------------oo-------------------------------------------------oooooo------------ooSo--
---------------------------ooo---------------------------------------------------ooooooo-----------------g----------ooSo----------------------------------ooSSo-----oooo------g-g--------oooo-----------
-----------------------XXX-------XXX------------------------------------------------------XXXX-----XXXXXXXXXX------------XXXXXXXXX------XXXXX------XXXXX--------------------XXXXXXXXXXX-----------oooo--
-----------------------XXXXXXXXXXXXXXXXXXXXXXX---------------XXXXXXXXX------------ooooooo-XXXX-----XXXXXXXXXX------------XXXXXXXXXXXXXXXXXXXX------XXXXX----oooo-XXXXXXXXXXXXXXXXXXXXXXXXXXXXXX---------
XXXXXXXXXXXXX-----XXXXXXXXXXXXXXXXXXXXXXXXXXXX----------XXXXXXXXXXXXXXXXXX----------------XXXXXXXXXXXXXXXXXXXXXXXXX------XXXXXXXXXXXXXXXXXXXX------XXXXX---------XXXXXXXXXXXXXXXXXXXXXXXXXXXXXXXXXXXXXXX
XXXXXXXXXXXXXXXXXXXXXXXXXXXXXXXXXXXXXXXXXXXXXXXXXXXXXXXXXXXXXXXXXXXXXXXXXXXXXXXXXXXXXXXXXXXXXXXXXXXXXXXXXXXXXXXXXXXXXXXXXXXXXXXXXXXXXXXXXXXXXXXXXXXXXXXXXXXXXXXXXXXXXXXXXXXXXXXXXXXXXXXXXXXXXXXXXXXXXXXX

