--------------------------------------------------------------------------------------------------------------------------------------------------------------------------------------------------------
--------------------------------------------------------------------------------------------------------------------------------------------------------------------------------------------------------
--------------------------------------------------------------------------------------------------------------------------------------------------------------------------------------------------------
--------------------------------------------------------------------------------------------------------------------------------------------------------------------------------------------------------
--------------------------------------------------------------------------------------------------------------------------------------------------------------------------------------------------------
--------------------------------------------------------------------------------------------------------------------------------------------------------------------------------------------------------
--------------------------------------------------------------------------------------------------------------------------------------------------------------------------------------------------------
--------------------------------------------------------------------------------------------------------------------------------------------------------------------------------------------------------
--------------------------------------------------------------------------------------------------------------------------------------------------------------------------------------------------------
--------------------------------------------------------------------------------------------------------------------------------------------------------------------------------------------------------
--------------------------------------------------------------------------------------------------------------------------------------------------------------------------------------------------------
--------------------------------------------------------------------------------------------------------------------------------------------------------------------------------------------------------
-------------------------------------------------------------------------------------------------------------------------------------------------------oooo---------------------------------------------
----------------------------ooo-------------------ooooSoo---------------------------------------------------oSoSoo---ooooo-----oooS-------------------------------------------oooooo--------------------
--------------------------------------------------------------------------------SSo---------oSooSo-------------------------------------------------------oooo-------------------------------------------
--------------------------oooooo----oooooSo------oooooo-----oSoooSS----------------------------------------oooooooo--ooo-----oooooooo------------------------------------ooo---ooo----------------------
------------------------------------------------------------------------XXXX--oooooo--------oooooooo--------------g-----------------------------------XXXXXXXXX-----------------------XXXXX------------X
XXXXXXXXXXX----XXXXXXX--XXXXXXXXXXX---oooo----XXXXXXXXXXXXX--ooooooo----XXXX--------------------------XXXXXXXXXXXXXXXXXXXXXXXXXXXXXXXXXXXX------------XXXXXXXXX--------------XXXXXXXXXXXXXX----g-XXX---X
XXXXXXXXXXXXXXXXXXXXXX--XXXXXXXXXXX-----------XXXXXXXXXXXXX-----------XXXXXXXXXXXXXXXXXXXXXXXXXXXXXXXXXXXXXXXXXXXXXXXXXXXXXXXXXXXXXXXXXXXX-----XXXXXXXXXXXXXXXX------XX------XXXXXXXXXXXXXXXXXXXXXXXXXXX
XXXXXXXXXXXXXXXXXXXXXXXXXXXXXXXXXXXXXXXXXXXXXXXXXXXXXXXXXXXXXXXXXXXXXXXXXXXXXXXXXXXXXXXXXXXXXXXXXXXXXXXXXXXXXXXXXXXXXXXXXXXXXXXXXXXXXXXXXXXXXXXXXXXXXXXXXXXXXXXXXXXXXXXXXXXXXXXXXXXXXXXXXXXXXXXXXXXXXXXX

