--------------------------------------------------------------------------------------------------------------------------------------------------------------------------------------------------------
--------------------------------------------------------------------------------------------------------------------------------------------------------------------------------------------------------
--------------------------------------------------------------------------------------------------------------------------------------------------------------------------------------------------------
--------------------------------------------------------------------------------------------------------------------------------------------------------------------------------------------------------
--------------------------------------------------------------------------------------------------------------------------------------------------------------------------------------------------------
--------------------------------------------------------------------------------------------------------------------------------------------------------------------------------------------------------
--------------------------------------------------------------------------------------------------------------------------------------------------------------------------------------------------------
--------------------------------------------------------------------------------------------------------------------------------------------------------------------------------------------------------
--------------------------------------------------------------------------------------------------------------------------------------------------------------------------------------------------------
--------------------------------------------------------------------------------------------------------------------------------------------------------------------------------------------------------
--------------------------------------------------------------------------------------------------------------------------------------------------------------------------------------------------------
--------------------------------------------------------------------------------------------------------------------------------------------------------------------------------------------------------
----------------------------------Soooo---------------------------------------------------ooSo-------------------------------------------------------------------------------------oooSSo---------------
-----------------------oooooo---------------------------------------------------------------------------oSoSo-------------------------------------------------------------------------------------------
------------ooSSoSo---------------ooo-------------ooo----------------------------------------oooo--------------oSoSo-----------------------------------------SSo-------------------ooooo----------------
------------------------oo-------------------------------------------oSo-----------------------------oooooo--------------------------SoooSo---------------------------------oSo--------------------ooo--
---------------oo----------g--XXXXXXXXXX---------oooo--------------------XXXXXXXX----XXXXXXXXXXXXXXX-------------ooooo-----XX-------------------------------------------oo--------XXXXXXXXX-------------
XXXXXXXXXXX----------XXXXXXXXXXXXXXXXXXXXXXXXXX-g--------------------oo--XXXXXXXXXXXXXXXXXXXXXXXXXXXXXXXXXXXXX-------------XX-----ooooooo------------------------XXXX-------ooo---XXXXXXXXX--g-----oooo-
XXXXXXXXXXXXXXXXXXXXXXXXXXXXXXXXXXXXXXXXXXXXXXXXXXXXXX---XXXXXXXX--------XXXXXXXXXXXXXXXXXXXXXXXXXXXXXXXXXXXXXXXXXXXXXXXXXXXX------------------------XXXXXXXXXXXXXXXXXXXXXX-------XXXXXXXXXXXXXXXX------
XXXXXXXXXXXXXXXXXXXXXXXXXXXXXXXXXXXXXXXXXXXXXXXXXXXXXXXXXXXXXXXXXXXXXXXXXXXXXXXXXXXXXXXXXXXXXXXXXXXXXXXXXXXXXXXXXXXXXXXXXXXXXXXXXXXXXXXXXXXXXXXXXXXXXXXXXXXXXXXXXXXXXXXXXXXXXXXXXXXXXXXXXXXXXXXXXXXXXXXX

