--------------------------------------------------------------------------------------------------------------------------------------------------------------------------------------------------------
--------------------------------------------------------------------------------------------------------------------------------------------------------------------------------------------------------
--------------------------------------------------------------------------------------------------------------------------------------------------------------------------------------------------------
--------------------------------------------------------------------------------------------------------------------------------------------------------------------------------------------------------
--------------------------------------------------------------------------------------------------------------------------------------------------------------------------------------------------------
--------------------------------------------------------------------------------------------------------------------------------------------------------------------------------------------------------
--------------------------------------------------------------------------------------------------------------------------------------------------------------------------------------------------------
--------------------------------------------------------------------------------------------------------------------------------------------------------------------------------------------------------
--------------------------------------------------------------------------------------------------------------------------------------------------------------------------------------------------------
--------------------------------------------------------------------------------------------------------------------------------------------------------------------------------------------------------
--------------------------------------------------------------------------------------------------------------------------------------------------------------------------------------------------------
--------------------------------------------------------------------------------------------------------------------------------------------------------------------------------------------------------
------------------------------------------------------SSSoSo---------------------------ooo-----------------------------------ooooS----------------------------------------------------------------------
-----------------------------oooo----------------------------------------------------------------------------------ooooSoo------------------------------------------------------------------------------
-----------------------------------------------------ooooo-----------------------------oo------oSSSoS--------------------------oo------oo------------------ooooo---------ooo----------------------------
-------------------SSSo-------oo--------oooo--------------------------------SSSo---------------------------oSoSo------ooo--------g-----------ooooooo-------------------------------------Soooo----------
---------------XX---------------------------------g-XXXXXXXXXX----------------------XXXXXXX-------oooo---------------------XXXXXXXXXXXXXXXX----------XXXXXXXXXXXXXXXX-oooo------------------------------
XXXXXXXXXXXXXXXXX---oooooo-XXXXXXXXXXXXXXXXXXXXXXXXXXXXXXXXXXX--------------ooooo---XXXXXXXXXX------------oooo----XXXXXXXXXXXXXXXXXXXXXXXXXXXXXXXXXXXXXXXXXXXXXXXXXXX------------oo------oooooo-----oo--
XXXXXXXXXXXXXXXXX----------XXXXXXXXXXXXXXXXXXXXXXXXXXXXXXXXXXX-----XXXXXX-----------XXXXXXXXXXXXXXXXXXX------g----XXXXXXXXXXXXXXXXXXXXXXXXXXXXXXXXXXXXXXXXXXXXXXXXXXXXXXXXXXX---------------------------
XXXXXXXXXXXXXXXXXXXXXXXXXXXXXXXXXXXXXXXXXXXXXXXXXXXXXXXXXXXXXXXXXXXXXXXXXXXXXXXXXXXXXXXXXXXXXXXXXXXXXXXXXXXXXXXXXXXXXXXXXXXXXXXXXXXXXXXXXXXXXXXXXXXXXXXXXXXXXXXXXXXXXXXXXXXXXXXXXXXXXXXXXXXXXXXXXXXXXXXX

