--------------------------------------------------------------------------------------------------------------------------------------------------------------------------------------------------------
--------------------------------------------------------------------------------------------------------------------------------------------------------------------------------------------------------
--------------------------------------------------------------------------------------------------------------------------------------------------------------------------------------------------------
--------------------------------------------------------------------------------------------------------------------------------------------------------------------------------------------------------
--------------------------------------------------------------------------------------------------------------------------------------------------------------------------------------------------------
--------------------------------------------------------------------------------------------------------------------------------------------------------------------------------------------------------
--------------------------------------------------------------------------------------------------------------------------------------------------------------------------------------------------------
--------------------------------------------------------------------------------------------------------------------------------------------------------------------------------------------------------
--------------------------------------------------------------------------------------------------------------------------------------------------------------------------------------------------------
--------------------------------------------------------------------------------------------------------------------------------------------------------------------------------------------------------
--------------------------------------------------------------------------------------------------------------------------------------------------------------------------------------------------------
--------------------------------------------------------------------------------------------------------------------------------------------------------------------------------------------------------
----------------------------oooo---------------------------------------------------ooSoo----ooooS-------------------------------------------------------------------------------------------------------
------------------------------------------------------------------------Soooooo-------------------------------------------------------------------------------------------------------------------------
--------------oooooo------oooooo------------------------oSoo----------------------ooooo-----oooo------------ooooSo------------------ooo----------------------oooo-----oooSSoSo--------------------------
---------------------------g-------SSo---SoSS---------------------oSo---oooooo---------------------------------------SoSo----------------oSooSooo---ooooS-------------------------------------------ooo-
------------oooooooo--XXXXXXXXXXX--------------XXXXX----oooo--------------------XXXXXXXXXXXXXXXXXXX---------ooooo----------XXXXXXXXXXXXX-------------------XXXXXXXXX----ooooo---------------------------
XXXXXXXXXXX--g--------XXXXXXXXXXX-oo-----ooooo-XXXXX-----------oooo---XXXXXXXXXXXXXXXXXXXXXXXXXXXXX-------------------ooo--XXXXXXXXXXXXX-ooooo------oooo---XXXXXXXXX-------------------------oo---------
XXXXXXXXXXXXXXXXXXXXXXXXXXXXXXXXX--------------XXXXXXXXXXXXXXX--------XXXXXXXXXXXXXXXXXXXXXXXXXXXXXXXX-----XXXXXXXX--------XXXXXXXXXXXXX-------------------XXXXXXXXXXXXXXXXXXXXXXXXXXXXXXX--------------
XXXXXXXXXXXXXXXXXXXXXXXXXXXXXXXXXXXXXXXXXXXXXXXXXXXXXXXXXXXXXXXXXXXXXXXXXXXXXXXXXXXXXXXXXXXXXXXXXXXXXXXXXXXXXXXXXXXXXXXXXXXXXXXXXXXXXXXXXXXXXXXXXXXXXXXXXXXXXXXXXXXXXXXXXXXXXXXXXXXXXXXXXXXXXXXXXXXXXXXX

