--------------------------------------------------------------------------------------------------------------------------------------------------------------------------------------------------------
--------------------------------------------------------------------------------------------------------------------------------------------------------------------------------------------------------
--------------------------------------------------------------------------------------------------------------------------------------------------------------------------------------------------------
--------------------------------------------------------------------------------------------------------------------------------------------------------------------------------------------------------
--------------------------------------------------------------------------------------------------------------------------------------------------------------------------------------------------------
--------------------------------------------------------------------------------------------------------------------------------------------------------------------------------------------------------
--------------------------------------------------------------------------------------------------------------------------------------------------------------------------------------------------------
--------------------------------------------------------------------------------------------------------------------------------------------------------------------------------------------------------
--------------------------------------------------------------------------------------------------------------------------------------------------------------------------------------------------------
--------------------------------------------------------------------------------------------------------------------------------------------------------------------------------------------------------
--------------------------------------------------------------------------------------------------------------------------------------------------------------------------------------------------------
--------------------------------------------------------------------------------------------------------------------------------------------------------------------------------------------------------
----------------------------------------oooS------------------------------SoSS------------ooooSS------------------------------------------------------------oSoS----------------------------------------
-------------------------------------------------------ooo----------------------------------------------------------------------------------------------------------------------------------------------
------------------------------ooooo-------oooo---------------------------oooooooo----------ooooo------------------------------------------------------Sooo--ooooo---------------------------------------
-------------------------------------------g----------oooo---------ooS-----------------------------------------------------------------oooS-----------------------------------------------SSo-----------
---------------------------------oooo--XXXXXXXXX-------------XXXX-------XXXXXXXXXX-------XXXXXXXXXX-------------ooo----------------------------------------XXXXXXX--------------------------------------
------------oo---------oo--------------XXXXXXXXX----XXXXXXXXXXXXX--oo---XXXXXXXXXXXXXX---XXXXXXXXXX-----------------------XXX----oooo----oo----------------XXXXXXX--------XXXXXXXXXXXX--oooo-------oo---
XXXXXXXXXX-------------------XXXXXXXXXXXXXXXXXXX----XXXXXXXXXXXXX-------XXXXXXXXXXXXXX---XXXXXXXXXXXXX----XXXXXXXXXXXXXXXXXXXXXX-------------------XXXXXXXXXXXXXXX--------XXXXXXXXXXXX----------------XX
XXXXXXXXXXXXXXXXXXXXXXXXXXXXXXXXXXXXXXXXXXXXXXXXXXXXXXXXXXXXXXXXXXXXXXXXXXXXXXXXXXXXXXXXXXXXXXXXXXXXXXXXXXXXXXXXXXXXXXXXXXXXXXXXXXXXXXXXXXXXXXXXXXXXXXXXXXXXXXXXXXXXXXXXXXXXXXXXXXXXXXXXXXXXXXXXXXXXXXXX

