--------------------------------------------------------------------------------------------------------------------------------------------------------------------------------------------------------
--------------------------------------------------------------------------------------------------------------------------------------------------------------------------------------------------------
--------------------------------------------------------------------------------------------------------------------------------------------------------------------------------------------------------
--------------------------------------------------------------------------------------------------------------------------------------------------------------------------------------------------------
--------------------------------------------------------------------------------------------------------------------------------------------------------------------------------------------------------
--------------------------------------------------------------------------------------------------------------------------------------------------------------------------------------------------------
--------------------------------------------------------------------------------------------------------------------------------------------------------------------------------------------------------
--------------------------------------------------------------------------------------------------------------------------------------------------------------------------------------------------------
--------------------------------------------------------------------------------------------------------------------------------------------------------------------------------------------------------
--------------------------------------------------------------------------------------------------------------------------------------------------------------------------------------------------------
--------------------------------------------------------------------------------------------------------------------------------------------------------------------------------------------------------
--------------------------------------------------------------------------------------------------------------------------------------------------------------------------------------------------------
-------------oooo----------------------------------------------------------------------------------oooo------------------------------------------------------------------oSoSo--------------------------
----------------------------------------------oSSooo-------------------------------oooS--------------------------------------------------------------------------------------------------------oooSS----
--------------ooooo---oo---oooo---------------------------Soo----oSoSS------------------------------------------------------------------------ooo---------ooSo---------ooooo--------------SSo-----------
-----------------g-----------------ooooSoo-----oooooo----------------------------ooooooo--------------------------------------Sooo-------------------------------------------------------------ooooo----
------------XXXXXXXXXXXXXXXXXXXXXX------------------------ooo-XX--oooooo---ooo--------------------XXXXXX-----------------------------------XXXXXXXXX----oooooooo-XX---XXXXXXXXX----------oo-------------
------------XXXXXXXXXXXXXXXXXXXXXX---------XXXXXXXXXXX--------XX----------------XXXXXXXXXXX-------XXXXXXXXX--XXXXXXXXXXXXX-ooooo---XXXXXXXXXXXXXXXXX---g---------XX---XXXXXXXXX-oo------------XXXXXXXX--
------------XXXXXXXXXXXXXXXXXXXXXX---------XXXXXXXXXXXXXXXXXXXXXXXXXXXXXXXXXXXXXXXXXXXXXXXXXXXXXXXXXXXXXXXXXXXXXXXXXXXXXXX-g-------XXXXXXXXXXXXXXXXX--XXXXXXXXXXXXX---XXXXXXXXX-------XXXXXXXXXXXXXXXX--
XXXXXXXXXXXXXXXXXXXXXXXXXXXXXXXXXXXXXXXXXXXXXXXXXXXXXXXXXXXXXXXXXXXXXXXXXXXXXXXXXXXXXXXXXXXXXXXXXXXXXXXXXXXXXXXXXXXXXXXXXXXXXXXXXXXXXXXXXXXXXXXXXXXXXXXXXXXXXXXXXXXXXXXXXXXXXXXXXXXXXXXXXXXXXXXXXXXXXXXX

