--------------------------------------------------------------------------------------------------------------------------------------------------------------------------------------------------------
--------------------------------------------------------------------------------------------------------------------------------------------------------------------------------------------------------
--------------------------------------------------------------------------------------------------------------------------------------------------------------------------------------------------------
--------------------------------------------------------------------------------------------------------------------------------------------------------------------------------------------------------
--------------------------------------------------------------------------------------------------------------------------------------------------------------------------------------------------------
--------------------------------------------------------------------------------------------------------------------------------------------------------------------------------------------------------
--------------------------------------------------------------------------------------------------------------------------------------------------------------------------------------------------------
--------------------------------------------------------------------------------------------------------------------------------------------------------------------------------------------------------
--------------------------------------------------------------------------------------------------------------------------------------------------------------------------------------------------------
--------------------------------------------------------------------------------------------------------------------------------------------------------------------------------------------------------
--------------------------------------------------------------------------------------------------------------------------------------------------------------------------------------------------------
--------------------------------------------------------------------------------------------------------------------------------------------------------------------------------------------------------
--------------------------------------------------------------------------------------------------------------------------------------------------------------------------------------------------------
------------------ooooo------------------------------------------------------------------------------------------------------------------------------------------------------SoSo--ooSoSoo--------------
-------------------------------------------ooo-----oSo-----------------------------------Soo--------------------------ooSo-------------------------ooo-----SSo------------------------------------------
---------------ooooo---------------------------------------------------------ooo-----------------oooSooo--oSoSSoS---------------ooSoSo---------------------------------ooo----------ooooo------SSo------
-------------------------------------------oo----oooooo-----ooo------------------------------------------------------------------------XXXXX--------ooo---oooo---XX-------------------------------------
--------------XXXXXXXXXX------------XXXX------------------------------XX------ooo-----------------ooo------oooo--------g-----oooooo----XXXXXXXX------------------XXXXXXXXXXXXXXXXXXXXXXXXXXXX----------X
--------------XXXXXXXXXX----XXXXX---XXXXXXXXXXXXXXXXXXXXXXXXXXXX------XX-----------XXXXXXXXXXXX--------------------XXXXXXXXX-----------XXXXXXXXXXXXXXXXXXXXXXXXXXXXXXXXXXXXXXXXXXXXXXXXXXXXXX------XXXXX
XXXXXXXXXXXXXXXXXXXXXXXXXXXXXXXXXXXXXXXXXXXXXXXXXXXXXXXXXXXXXXXXXXXXXXXXXXXXXXXXXXXXXXXXXXXXXXXXXXXXXXXXXXXXXXXXXXXXXXXXXXXXXXXXXXXXXXXXXXXXXXXXXXXXXXXXXXXXXXXXXXXXXXXXXXXXXXXXXXXXXXXXXXXXXXXXXXXXXXXX

