--------------------------------------------------------------------------------------------------------------------------------------------------------------------------------------------------------
--------------------------------------------------------------------------------------------------------------------------------------------------------------------------------------------------------
--------------------------------------------------------------------------------------------------------------------------------------------------------------------------------------------------------
--------------------------------------------------------------------------------------------------------------------------------------------------------------------------------------------------------
--------------------------------------------------------------------------------------------------------------------------------------------------------------------------------------------------------
--------------------------------------------------------------------------------------------------------------------------------------------------------------------------------------------------------
--------------------------------------------------------------------------------------------------------------------------------------------------------------------------------------------------------
--------------------------------------------------------------------------------------------------------------------------------------------------------------------------------------------------------
--------------------------------------------------------------------------------------------------------------------------------------------------------------------------------------------------------
--------------------------------------------------------------------------------------------------------------------------------------------------------------------------------------------------------
--------------------------------------------------------------------------------------------------------------------------------------------------------------------------------------------------------
--------------------------------------------------------------------------------------------------------------------------------------------------------------------------------------------------------
-------------------------------------------------ooSoo--------------------------------------------------------------------------------------------------------------------------------------------------
-------------------ooS-----oSoS-------------------------------------------------------------------------------------------------ooooSo-------------------------------SSSSSoo----------------------------
------------------------------------------------oooooo-------------------oSoSS-----------------------------------Soo------------------------------------------oo----------------------------------------
--------------------------oooooooo----------------------------------------------------------------------ooooo--------------------ooo--------------oSSo----------g----oooooo-----------------------------
-------------------------------------oo-------XXXXXXXXXXXX--------------ooooooo------------------------------------oooo----oo----------------------------XXXXXXXXX-------------------------ooo-XXXXXXXXX
-----------XXXX---XXXXXXXXXXXXXXXXX--------XXXXXXXXXXXXXXX--ooo----ooo------------XXXXXXXXXXXXXXXXXXX-oooooo------------------XXXXXXXXXXX------XX----ooo-XXXXXXXXXXXXXXXXXXXX-------oo---------XXXXXXXXX
XXXXXXXXXXXXXXXXXXXXXXXXXXXXXXXXXXXXXXXXXXXXXXXXXXXXXXXXXX-------------XXXXXXXXXXXXXXXXXXXXXXXXXXXXXX----------XXXXXXXXXXXXXXXXXXXXXXXXXX------XX--------XXXXXXXXXXXXXXXXXXXX----------XXXXXXXXXXXXXXXXX
XXXXXXXXXXXXXXXXXXXXXXXXXXXXXXXXXXXXXXXXXXXXXXXXXXXXXXXXXXXXXXXXXXXXXXXXXXXXXXXXXXXXXXXXXXXXXXXXXXXXXXXXXXXXXXXXXXXXXXXXXXXXXXXXXXXXXXXXXXXXXXXXXXXXXXXXXXXXXXXXXXXXXXXXXXXXXXXXXXXXXXXXXXXXXXXXXXXXXXXX

