--------------------------------------------------------------------------------------------------------------------------------------------------------------------------------------------------------
--------------------------------------------------------------------------------------------------------------------------------------------------------------------------------------------------------
--------------------------------------------------------------------------------------------------------------------------------------------------------------------------------------------------------
--------------------------------------------------------------------------------------------------------------------------------------------------------------------------------------------------------
--------------------------------------------------------------------------------------------------------------------------------------------------------------------------------------------------------
--------------------------------------------------------------------------------------------------------------------------------------------------------------------------------------------------------
--------------------------------------------------------------------------------------------------------------------------------------------------------------------------------------------------------
--------------------------------------------------------------------------------------------------------------------------------------------------------------------------------------------------------
--------------------------------------------------------------------------------------------------------------------------------------------------------------------------------------------------------
--------------------------------------------------------------------------------------------------------------------------------------------------------------------------------------------------------
--------------------------------------------------------------------------------------------------------------------------------------------------------------------------------------------------------
--------------------------------------------------------------------------------------------------------------------------------------------------------------------------------------------------------
---------------------------------------------SSSoS--------------SSS-------------------------------------------oSooo-------------------------------------------------------------------------------------
-------------------------------------------------------------------------------------------------------------------------oooS-------------------------------Sooo-------------oSoooSSS----------ooo------
------------------oooooooo-------------------oooooo-------------oooo-----------------------------------oooo-----ooo-----------------ooo-----------------------------------------------------------------
----------------------------------------------------------------------------------------ooo-----oo------------------------oooo--------------oSoSoooo----------------------------oooooo--oSoo------------
XXXXXXXXXXXXXX-----oooooo---oooo--XXXXX---XXXXXXXXXXX-------XXXXXXXXX----ooo--------------------------XXXXXXXXXXXXXXXXXX----------oooooo-------------XXXX--------------------------g------------g-------
XXXXXXXXXXXXXXXXX-----g-----------XXXXX---XXXXXXXXXXX-oo----XXXXXXXXX---------oooo-XXXXXXXXXXXXXXXXXXXXXXXXXXXXXXXXXXXXXXXXXXXXXX--------------ooooo-XXXXXXXXXXXX-----------XXXXXXXXXXX-oooo-XXXXXXXXXXX
XXXXXXXXXXXXXXXXXXXXXXXXXXXXXXXXXXXXXXX---XXXXXXXXXXX-------XXXXXXXXXXXXXXXXX------XXXXXXXXXXXXXXXXXXXXXXXXXXXXXXXXXXXXXXXXXXXXXXXXXXXXXXXX----------XXXXXXXXXXXX-------XXXXXXXXXXXXXXX------XXXXXXXXXXX
XXXXXXXXXXXXXXXXXXXXXXXXXXXXXXXXXXXXXXXXXXXXXXXXXXXXXXXXXXXXXXXXXXXXXXXXXXXXXXXXXXXXXXXXXXXXXXXXXXXXXXXXXXXXXXXXXXXXXXXXXXXXXXXXXXXXXXXXXXXXXXXXXXXXXXXXXXXXXXXXXXXXXXXXXXXXXXXXXXXXXXXXXXXXXXXXXXXXXXXX

