--------------------------------------------------------------------------------------------------------------------------------------------------------------------------------------------------------
--------------------------------------------------------------------------------------------------------------------------------------------------------------------------------------------------------
--------------------------------------------------------------------------------------------------------------------------------------------------------------------------------------------------------
--------------------------------------------------------------------------------------------------------------------------------------------------------------------------------------------------------
--------------------------------------------------------------------------------------------------------------------------------------------------------------------------------------------------------
--------------------------------------------------------------------------------------------------------------------------------------------------------------------------------------------------------
--------------------------------------------------------------------------------------------------------------------------------------------------------------------------------------------------------
--------------------------------------------------------------------------------------------------------------------------------------------------------------------------------------------------------
--------------------------------------------------------------------------------------------------------------------------------------------------------------------------------------------------------
--------------------------------------------------------------------------------------------------------------------------------------------------------------------------------------------------------
--------------------------------------------------------------------------------------------------------------------------------------------------------------------------------------------------------
--------------------------------------------------------------------------------------------------------------------------------------------------------------------------------------------------------
-------------------------------ooS--------------------------oooo------------------------------------------------------------------------------------------------------------------Sooooo---ooo----------
---------------------------------------------------------------------------------------ooo----------------oSSoS-----------------------------------------ooooSo------------------------------------------
------------------------------ooooooo-----------------------oooooo--------------------------------------------------------------oooooo-------------------------------------------oooooo----oo-----------
-----------------------------------------------------------------------oo---------------------ooooSS---------oo--------oSSS----------------------------oooo-------------------------------------oooS----
-----------------------------XXXXXXXXXXXXXX---ooo--XXXXXXXXXXXXXXXXX------------ooo--------------------XX-----------------------oooo--------ooo------------g---XX--oooooo--XXXXXXXXXXXXXXXXXXXX--------X
----------------ooo---XXXXXXXXXXXXXXXXXXXXX--------XXXXXXXXXXXXXXXXXXXXXXX------------XXXXXXX---oooo---XXXXXXXXXXXX---ooo---------------------------XXXXXXXXXXXXX----------XXXXXXXXXXXXXXXXXXXX-oooooo-X
----------------g-----XXXXXXXXXXXXXXXXXXXXXXXXXXXXXXXXXXXXXXXXXXXXXXXXXXXX----XXXXXXXXXXXXXXX----------XXXXXXXXXXXX----------XXXXXXXXXXXXXXXXXXX----XXXXXXXXXXXXXXXXXXXXXXXXXXXXXXXXXXXXXXXXXXX--------X
XXXXXXXXXXXXXXXXXXXXXXXXXXXXXXXXXXXXXXXXXXXXXXXXXXXXXXXXXXXXXXXXXXXXXXXXXXXXXXXXXXXXXXXXXXXXXXXXXXXXXXXXXXXXXXXXXXXXXXXXXXXXXXXXXXXXXXXXXXXXXXXXXXXXXXXXXXXXXXXXXXXXXXXXXXXXXXXXXXXXXXXXXXXXXXXXXXXXXXXX

