--------------------------------------------------------------------------------------------------------------------------------------------------------------------------------------------------------
--------------------------------------------------------------------------------------------------------------------------------------------------------------------------------------------------------
--------------------------------------------------------------------------------------------------------------------------------------------------------------------------------------------------------
--------------------------------------------------------------------------------------------------------------------------------------------------------------------------------------------------------
--------------------------------------------------------------------------------------------------------------------------------------------------------------------------------------------------------
--------------------------------------------------------------------------------------------------------------------------------------------------------------------------------------------------------
--------------------------------------------------------------------------------------------------------------------------------------------------------------------------------------------------------
--------------------------------------------------------------------------------------------------------------------------------------------------------------------------------------------------------
--------------------------------------------------------------------------------------------------------------------------------------------------------------------------------------------------------
--------------------------------------------------------------------------------------------------------------------------------------------------------------------------------------------------------
--------------------------------------------------------------------------------------------------------------------------------------------------------------------------------------------------------
--------------------------------------------------------------------------------------------------------------------------------------------------------------------------------------------------------
--------------------------------------------------------------------------------------------------------------------------------------------------------------------------------------------------------
------------------------------------ooooSooo-------------------------------------------------------------ooSSo------ooSo--------------------------------------------------------------------------------
---------------------------oooo-----------------ooSooo----------------------------ooo--------------------------------------------------------------------------------ooo--------------------------------
-------------------------------------oooooo------------------------Soo-------------------------Sooooooo------------oooo--------ooo----------------------------------------------------------------------
XXXXXXXXXXXX--------oo----XXXXXXXX----------------ooooo----------------XXXXX-----ooooo-XXXXXX--------------------------------------XXX----ooooo--------------------XXXXXXXXXX---------------------------
XXXXXXXXXXXX--oo----------XXXXXXXXXXXXXXXXXXX---------------------oooo-XXXXX-----------XXXXXX----ooo----XXXXXXXXXXXXXXXXXX--XXXXXXXXXX---------------ooooo---------XXXXXXXXXXXX-----------------XXXXXXXX
XXXXXXXXXXXX-------XXXXXXXXXXXXXXXXXXXXXXXXXXXXXXXXXXXXX---XXXX--------XXXXXXXXXXXXXXXXXXXXXX-----g-----XXXXXXXXXXXXXXXXXX--XXXXXXXXXXXXXXXXXXXXXX-----g---XXXXXXXXXXXXXXXXXXXX------------XXXXXXXXXXXXX
XXXXXXXXXXXXXXXXXXXXXXXXXXXXXXXXXXXXXXXXXXXXXXXXXXXXXXXXXXXXXXXXXXXXXXXXXXXXXXXXXXXXXXXXXXXXXXXXXXXXXXXXXXXXXXXXXXXXXXXXXXXXXXXXXXXXXXXXXXXXXXXXXXXXXXXXXXXXXXXXXXXXXXXXXXXXXXXXXXXXXXXXXXXXXXXXXXXXXXXX

