--------------------------------------------------------------------------------------------------------------------------------------------------------------------------------------------------------
--------------------------------------------------------------------------------------------------------------------------------------------------------------------------------------------------------
--------------------------------------------------------------------------------------------------------------------------------------------------------------------------------------------------------
--------------------------------------------------------------------------------------------------------------------------------------------------------------------------------------------------------
--------------------------------------------------------------------------------------------------------------------------------------------------------------------------------------------------------
--------------------------------------------------------------------------------------------------------------------------------------------------------------------------------------------------------
--------------------------------------------------------------------------------------------------------------------------------------------------------------------------------------------------------
--------------------------------------------------------------------------------------------------------------------------------------------------------------------------------------------------------
--------------------------------------------------------------------------------------------------------------------------------------------------------------------------------------------------------
--------------------------------------------------------------------------------------------------------------------------------------------------------------------------------------------------------
--------------------------------------------------------------------------------------------------------------------------------------------------------------------------------------------------------
--------------------------------------------------------------------------------------------------------------------------------------------------------------------------------------------------------
-----------------------------ooSo-----------------------------------------------------------------------------------------------------------------------------------------------------------------------
------------------------------------ooSooo--------ooo-------------------------------ooooo----------------------------------------oooo-------oooSS--------ooS--------------------------------------------
---------------------------oooooo---------------------------oooSS----ooo--------------------------------------------------------------------------------------------------------------------ooo---------
-------------------------------g----ooooooooo-------------------------------------------------ooo---------------------------------oo------oooooo---------oooo--------SSo---------------------g----------
XXXXXXXXXXXXXXXX---------XXXXXXXXXX----------------------ooooooo-----oo--------------------------------XX-------XXXX-----------------------------------------------------------------------XXXXXXX----XX
XXXXXXXXXXXXXXXX---------XXXXXXXXXXXXXXXXXXXXX--XXXXXXXX---------------g-----------XXXXXXX--ooooooo----XX---XXXXXXXX----------XXXXXXXXXXXXXXXXXXXXX--XXXXXXXXXXXXXX-ooooooo-----ooooo------XXXXXXXXXXXXX
XXXXXXXXXXXXXXXX---------XXXXXXXXXXXXXXXXXXXXX--XXXXXXXXXXXXXXXXXXXXXXXXXXXXXXXXXXXXXXXXXX----------XXXXXXXXXXXXXXXXXXX-----XXXXXXXXXXXXXXXXXXXXXXXXXXXXXXXXXXXXXXX------g------------XXXXXXXXXXXXXXXXXX
XXXXXXXXXXXXXXXXXXXXXXXXXXXXXXXXXXXXXXXXXXXXXXXXXXXXXXXXXXXXXXXXXXXXXXXXXXXXXXXXXXXXXXXXXXXXXXXXXXXXXXXXXXXXXXXXXXXXXXXXXXXXXXXXXXXXXXXXXXXXXXXXXXXXXXXXXXXXXXXXXXXXXXXXXXXXXXXXXXXXXXXXXXXXXXXXXXXXXXXX

