--------------------------------------------------------------------------------------------------------------------------------------------------------------------------------------------------------
--------------------------------------------------------------------------------------------------------------------------------------------------------------------------------------------------------
--------------------------------------------------------------------------------------------------------------------------------------------------------------------------------------------------------
--------------------------------------------------------------------------------------------------------------------------------------------------------------------------------------------------------
--------------------------------------------------------------------------------------------------------------------------------------------------------------------------------------------------------
--------------------------------------------------------------------------------------------------------------------------------------------------------------------------------------------------------
--------------------------------------------------------------------------------------------------------------------------------------------------------------------------------------------------------
--------------------------------------------------------------------------------------------------------------------------------------------------------------------------------------------------------
--------------------------------------------------------------------------------------------------------------------------------------------------------------------------------------------------------
--------------------------------------------------------------------------------------------------------------------------------------------------------------------------------------------------------
--------------------------------------------------------------------------------------------------------------------------------------------------------------------------------------------------------
--------------------------------------------------------------------------------------------------------------------------------------------------------------------------------------------------------
--------------------------------------------------------------------------------------------------------------------------------------------------------------------------------------------------------
-----------------------------------------------------------SSSo-------------------SSSooo-----------------------------------------------------------------------ooo-------oooo---------------------------
--------------------------ooSSooo---------------------------------------------------------------------------------------oSoSooo-----------SSSoooS-------------------------------------------------------
-------------------oooo-------------ooooooS------ooS-------oooo-----------------oooooooo------------------------------------------------------------------------oooo-----oooo----SoS--------------------
-------------------------oooooooo------------------------------g----------------g----------XXXXXX-----------XXXX-----------oooo-------------oooo-----XX---------------------------------XXXXX---------XX
XXXXXXXXXX--------XXXXXX--------------oooooo-----oo----XXXXXXXXXXXXXXXXX----XXXXXXXXXXXXX--XXXXXX--XXXX-----XXXXXXXX----------------XXXX-----------XXXX-----XXXXXXXXXXXXXXXXXX----ooooo-XXXXXXXXX-----XX
XXXXXXXXXX--------XXXXXXXXXXXXXXXXX---------g--------g-XXXXXXXXXXXXXXXXX----XXXXXXXXXXXXXXXXXXXXX--XXXXXXXXXXXXXXXXX---XXXXXXXXXXXXXXXXXXXXXXXXXXXXXXXXXXXXXXXXXXXXXXXXXXXXXXX-----g----XXXXXXXXXXXXXXXX
XXXXXXXXXXXXXXXXXXXXXXXXXXXXXXXXXXXXXXXXXXXXXXXXXXXXXXXXXXXXXXXXXXXXXXXXXXXXXXXXXXXXXXXXXXXXXXXXXXXXXXXXXXXXXXXXXXXXXXXXXXXXXXXXXXXXXXXXXXXXXXXXXXXXXXXXXXXXXXXXXXXXXXXXXXXXXXXXXXXXXXXXXXXXXXXXXXXXXXXX

