--------------------------------------------------------------------------------------------------------------------------------------------------------------------------------------------------------
--------------------------------------------------------------------------------------------------------------------------------------------------------------------------------------------------------
--------------------------------------------------------------------------------------------------------------------------------------------------------------------------------------------------------
--------------------------------------------------------------------------------------------------------------------------------------------------------------------------------------------------------
--------------------------------------------------------------------------------------------------------------------------------------------------------------------------------------------------------
--------------------------------------------------------------------------------------------------------------------------------------------------------------------------------------------------------
--------------------------------------------------------------------------------------------------------------------------------------------------------------------------------------------------------
--------------------------------------------------------------------------------------------------------------------------------------------------------------------------------------------------------
--------------------------------------------------------------------------------------------------------------------------------------------------------------------------------------------------------
--------------------------------------------------------------------------------------------------------------------------------------------------------------------------------------------------------
--------------------------------------------------------------------------------------------------------------------------------------------------------------------------------------------------------
--------------------------------------------------------------------------------------------------------------------------------------------------------------------------------------------------------
-------------------ooSoSo-----------------------------------------------------ooo------------------------------------oSooooo-----------------------ooooS--------------------------ooooo------------ooSo-
------------ooo----------------------------Soo-----------------------------------------oooSoo-----------------------------------------------------------------------------------------------------------
-----------------ooooooo---------------------------------------------------oooooo-------------------------------------ooooo-------------------------ooooo----------------oSoooo--ooo--------------------
-----------ooo----------------------------ooo----------------oSo------------------------ooo-----oSSooSo-----ooSSoo-------------------------------------------------------------------------ooo----------
----------------XXXXXXXXXXXXX----------------------XX---------------------XXXXXXXXXX-----g-------------------------XXXXXXXXXXXX---------XXXXXXXXXXXXXXXXXXXXXX---oo--------ooo--XXXXXXXX----------XXXXXX
XXXXXXXXXXXXXXXXXXXXXXXXXXXXX-ooooooo--XXXXXXXXX---XXXXXX--oooooooo---XXXXXXXXXXXXXXXXXXXXXXXX---oooooo----oooo----XXXXXXXXXXXX---------XXXXXXXXXXXXXXXXXXXXXX------------------XXXXXXXX--XXXXXXXXXXXXXX
XXXXXXXXXXXXXXXXXXXXXXXXXXXXX----------XXXXXXXXX---XXXXXX-----------XXXXXXXXXXXXXXXXXXXXXXXXXX---g--------------g--XXXXXXXXXXXXXXXXXXXXXXXXXXXXXXXXXXXXXXXXXXXXXXXXXXX--XXXXXXXXXXXXXXXXXXXXXXXXXXXXXXXX
XXXXXXXXXXXXXXXXXXXXXXXXXXXXXXXXXXXXXXXXXXXXXXXXXXXXXXXXXXXXXXXXXXXXXXXXXXXXXXXXXXXXXXXXXXXXXXXXXXXXXXXXXXXXXXXXXXXXXXXXXXXXXXXXXXXXXXXXXXXXXXXXXXXXXXXXXXXXXXXXXXXXXXXXXXXXXXXXXXXXXXXXXXXXXXXXXXXXXXXX

