--------------------------------------------------------------------------------------------------------------------------------------------------------------------------------------------------------
--------------------------------------------------------------------------------------------------------------------------------------------------------------------------------------------------------
--------------------------------------------------------------------------------------------------------------------------------------------------------------------------------------------------------
--------------------------------------------------------------------------------------------------------------------------------------------------------------------------------------------------------
--------------------------------------------------------------------------------------------------------------------------------------------------------------------------------------------------------
--------------------------------------------------------------------------------------------------------------------------------------------------------------------------------------------------------
--------------------------------------------------------------------------------------------------------------------------------------------------------------------------------------------------------
--------------------------------------------------------------------------------------------------------------------------------------------------------------------------------------------------------
--------------------------------------------------------------------------------------------------------------------------------------------------------------------------------------------------------
--------------------------------------------------------------------------------------------------------------------------------------------------------------------------------------------------------
--------------------------------------------------------------------------------------------------------------------------------------------------------------------------------------------------------
--------------------------------------------------------------------------------------------------------------------------------------------------------------------------------------------------------
----------------------------------------------------------------------------------------oooo------------------------------------------------------------------------------------------------------------
----------------------------------------------------------oooS------ooooo----------------------------------------------------------------------------------------Soooo----------------------------------
-----------------------------ooo----oSoooo----ooS--------------------------oooo---------------------------------------------------------oo--------------------------------------------------------------
--------------------oo-------------------------------------ooo----ooooooo----------------g--------------ooo------------------------------g-------------ooo------ooooo----------SooSooo------------------
XXXXXXXXXXX-ooo--------------ooooo--ooooooo-----------oo------------------XXXXXXXXX----XXXXXXX----------------------------oo-XXXXXX--XXXXXXXXXXXXX----------------------oooo--------------XXX-----------
XXXXXXXXXXX-------XXXXXXX--------------------------------XXXXXXXXXXXXXXXXXXXXXXXXXX----XXXXXXX---------ooooo-----------------XXXXXX--XXXXXXXXXXXXXXX-oooooo---XXXXXXXXX----------oooooo---XXXXXXXXXXX---
XXXXXXXXXXXXXXXXXXXXXXXXXXXXXXXXXXXXXXXXXXXXXXXXXXXXXXXXXXXXXXXXXXXXXXXXXXXXXXXXXXXXXXXXXXXXXXXXXXXX----------XXXXXXXXXXXXXXXXXXXXX--XXXXXXXXXXXXXXX--g-------XXXXXXXXXXXXXXX-----------XXXXXXXXXXXXX---
XXXXXXXXXXXXXXXXXXXXXXXXXXXXXXXXXXXXXXXXXXXXXXXXXXXXXXXXXXXXXXXXXXXXXXXXXXXXXXXXXXXXXXXXXXXXXXXXXXXXXXXXXXXXXXXXXXXXXXXXXXXXXXXXXXXXXXXXXXXXXXXXXXXXXXXXXXXXXXXXXXXXXXXXXXXXXXXXXXXXXXXXXXXXXXXXXXXXXXXX

