--------------------------------------------------------------------------------------------------------------------------------------------------------------------------------------------------------
--------------------------------------------------------------------------------------------------------------------------------------------------------------------------------------------------------
--------------------------------------------------------------------------------------------------------------------------------------------------------------------------------------------------------
--------------------------------------------------------------------------------------------------------------------------------------------------------------------------------------------------------
--------------------------------------------------------------------------------------------------------------------------------------------------------------------------------------------------------
--------------------------------------------------------------------------------------------------------------------------------------------------------------------------------------------------------
--------------------------------------------------------------------------------------------------------------------------------------------------------------------------------------------------------
--------------------------------------------------------------------------------------------------------------------------------------------------------------------------------------------------------
--------------------------------------------------------------------------------------------------------------------------------------------------------------------------------------------------------
--------------------------------------------------------------------------------------------------------------------------------------------------------------------------------------------------------
--------------------------------------------------------------------------------------------------------------------------------------------------------------------------------------------------------
--------------------------------------------------------------------------------------------------------------------------------------------------------------------------------------------------------
--------------------ooSoSoS---------------------------------------------------------------oooSo--------------------------------------oSo----------------------------------------------------------------
--------------------------------------------------------------------------------------------------------oSo---------------------------------------------------------------------------------------------
-----------------------ooooo----------------------oSSooo-------------------------------ooooo---------------------oooooo--ooo-----------------------ooo-----ooSSSo------------------Soo------------------
--------------------------------------------------------------ooooo---oSSSSS-------------------------ooooooo-------------------------------------------------------------------------------oSSSSoo------
-------------------XXXXXXXXXX-ooooo--------------oooooooo-XXX-------------------------XXXXXXXXXX------------------ooo---XXXXXXXX----XXXXXX----XXXXXXXXXX-ooooooo-------------XXXX----oo-----------------
-------------------XXXXXXXXXX-----------------XX----------XXXXXXXXXX--ooooo-----------XXXXXXXXXX----XXXXXXXXXX-------g--XXXXXXXX----XXXXXXXXXXXXXXXXXXXX---------------XXXXXXXXXX------------oooo-------
--------------XXXXXXXXXXXXXXXXXXXXXX-----XXXXXXXXXXXXXXXXXXXXXXXXXXX-----------XXXXX--XXXXXXXXXXXXXXXXXXXXXXXXXXXXXXXXXXXXXXXXXX----XXXXXXXXXXXXXXXXXXXXXXXXXXXXXXXXXXXXXXXXXXXXXXXXXXXXX---------------
XXXXXXXXXXXXXXXXXXXXXXXXXXXXXXXXXXXXXXXXXXXXXXXXXXXXXXXXXXXXXXXXXXXXXXXXXXXXXXXXXXXXXXXXXXXXXXXXXXXXXXXXXXXXXXXXXXXXXXXXXXXXXXXXXXXXXXXXXXXXXXXXXXXXXXXXXXXXXXXXXXXXXXXXXXXXXXXXXXXXXXXXXXXXXXXXXXXXXXXX

