--------------------------------------------------------------------------------------------------------------------------------------------------------------------------------------------------------
--------------------------------------------------------------------------------------------------------------------------------------------------------------------------------------------------------
--------------------------------------------------------------------------------------------------------------------------------------------------------------------------------------------------------
--------------------------------------------------------------------------------------------------------------------------------------------------------------------------------------------------------
--------------------------------------------------------------------------------------------------------------------------------------------------------------------------------------------------------
--------------------------------------------------------------------------------------------------------------------------------------------------------------------------------------------------------
--------------------------------------------------------------------------------------------------------------------------------------------------------------------------------------------------------
--------------------------------------------------------------------------------------------------------------------------------------------------------------------------------------------------------
--------------------------------------------------------------------------------------------------------------------------------------------------------------------------------------------------------
--------------------------------------------------------------------------------------------------------------------------------------------------------------------------------------------------------
--------------------------------------------------------------------------------------------------------------------------------------------------------------------------------------------------------
--------------------------------------------------------------------------------------------------------------------------------------------------------------------------------------------------------
---------------------------------------------------------------oooSo------------------------------------------------oooooo-----------SoooS-------------------------------------oooo---------------------
-------------------------------------------------ooo---------------------ooo--------oSoo------------------ooo----------------------------------------------------oooSoS-----------------ooooo-----------
----------------------oo-----oooo----oSoSoSoo----------oooo---------------------------------oSoSooo--------------oooooooo-----------ooooo-------------------------------------oooooo--------------------
------------------------------------------------oo--------------g-----oooooooo----ooooooo------------------oooo------------------------------ooSooSoo--------------ooooo--------------oooooo------------
------------------XXXXXXXXXXXXXXXX-----ooooo--------------ooo-XXXXXXX---------------g---------oooooo------------XXXXXXXXXXX------XXXXXXXXXXX----------XXX-----XX-----------XXXXXXXXXX-------------------
------------------XXXXXXXXXXXXXXXXXX-----------XXXXXXX--------XXXXXXXXXXXXXXXXXXXXXXXXXXXXX------g-------XXXXXXXXXXXXXXXXXX----g-XXXXXXXXXXX---ooo----XXXXXXXXXXXXXXXXXXXXXXXXXXXXXXXXXXXXXXXXXX--XXXXXX
XXXXXXXXXXXXXXXXXXXXXXXXXXXXXXXXXXXXXXXXXXXXXXXXXXXXXXXXXXXXXXXXXXXXXXXXXXXXXXXXXXXXXXXXXXXXXXXXXXXXXX---XXXXXXXXXXXXXXXXXXXXXXXXXXXXXXXXXXX---g------XXXXXXXXXXXXXXXXXXXXXXXXXXXXXXXXXXXXXXXXXX--XXXXXX
XXXXXXXXXXXXXXXXXXXXXXXXXXXXXXXXXXXXXXXXXXXXXXXXXXXXXXXXXXXXXXXXXXXXXXXXXXXXXXXXXXXXXXXXXXXXXXXXXXXXXXXXXXXXXXXXXXXXXXXXXXXXXXXXXXXXXXXXXXXXXXXXXXXXXXXXXXXXXXXXXXXXXXXXXXXXXXXXXXXXXXXXXXXXXXXXXXXXXXXX

