--------------------------------------------------------------------------------------------------------------------------------------------------------------------------------------------------------
--------------------------------------------------------------------------------------------------------------------------------------------------------------------------------------------------------
--------------------------------------------------------------------------------------------------------------------------------------------------------------------------------------------------------
--------------------------------------------------------------------------------------------------------------------------------------------------------------------------------------------------------
--------------------------------------------------------------------------------------------------------------------------------------------------------------------------------------------------------
--------------------------------------------------------------------------------------------------------------------------------------------------------------------------------------------------------
--------------------------------------------------------------------------------------------------------------------------------------------------------------------------------------------------------
--------------------------------------------------------------------------------------------------------------------------------------------------------------------------------------------------------
--------------------------------------------------------------------------------------------------------------------------------------------------------------------------------------------------------
--------------------------------------------------------------------------------------------------------------------------------------------------------------------------------------------------------
--------------------------------------------------------------------------------------------------------------------------------------------------------------------------------------------------------
--------------------------------------------------------------------------------------------------------------------------------------------------------------------------------------------------------
----------------------------ooSoSo--------------------------oooSo----------------------------------------------------------------------------------------------------oooo-------------------------------
------------------oSoSSooo----------------------------------------------------------------------------------------------------------oooSS-----------Sooo-----------------------------------------oSSS---
------------------------------oo----------------------------oooooo-----------------------ooo------------------------------oooooo-------------------------------------ooooooo-----------ooSS-------------
------------------ooooo-----------------------------------------g-------------oooo---------g---------------------------------------ooooooo----------oooooo---oo--------------------------------ooooo----
---------------------------XXXXXXXXX-----------------------XXXXXXXXXXXX----------------XXXXXXXXXXX----------XXXXX--------XXXXXXXXX---------------------------------XXXXXXXXXXXXXXX----oooooo------------
XXXXXXXXXXXXXXXXXXXXXXXXXXXXXXXXXXXX-ooo-----oo------------XXXXXXXXXXXXXXXXXXXXXXXXXX--XXXXXXXXXXX----------XXXXX--------XXXXXXXXXXXXXXXXXXXXXXXXXXXXXXXXXXXXXXXXXXXXXXXXXXXXXXXXX-------g----XXXXXXXXXX
XXXXXXXXXXXXXXXXXXXXXXXXXXXXXXXXXXXX---------------XXXXXXXXXXXXXXXXXXXXXXXXXXXXXXXXXX--XXXXXXXXXXX----------XXXXX--------XXXXXXXXXXXXXXXXXXXXXXXXXXXXXXXXXXXXXXXXXXXXXXXXXXXXXXXXXXXXXXXXXXXXXXXXXXXXXXX
XXXXXXXXXXXXXXXXXXXXXXXXXXXXXXXXXXXXXXXXXXXXXXXXXXXXXXXXXXXXXXXXXXXXXXXXXXXXXXXXXXXXXXXXXXXXXXXXXXXXXXXXXXXXXXXXXXXXXXXXXXXXXXXXXXXXXXXXXXXXXXXXXXXXXXXXXXXXXXXXXXXXXXXXXXXXXXXXXXXXXXXXXXXXXXXXXXXXXXXX

