--------------------------------------------------------------------------------------------------------------------------------------------------------------------------------------------------------
--------------------------------------------------------------------------------------------------------------------------------------------------------------------------------------------------------
--------------------------------------------------------------------------------------------------------------------------------------------------------------------------------------------------------
--------------------------------------------------------------------------------------------------------------------------------------------------------------------------------------------------------
--------------------------------------------------------------------------------------------------------------------------------------------------------------------------------------------------------
--------------------------------------------------------------------------------------------------------------------------------------------------------------------------------------------------------
--------------------------------------------------------------------------------------------------------------------------------------------------------------------------------------------------------
--------------------------------------------------------------------------------------------------------------------------------------------------------------------------------------------------------
--------------------------------------------------------------------------------------------------------------------------------------------------------------------------------------------------------
--------------------------------------------------------------------------------------------------------------------------------------------------------------------------------------------------------
--------------------------------------------------------------------------------------------------------------------------------------------------------------------------------------------------------
--------------------------------------------------------------------------------------------------------------------------------------------------------------------------------------------------------
-----------------------------------------ooSSo-------------------------------------------------SoooS-------------------------------oSoo-----------------------------------------------------------------
------------------------Sooo----------------------------------------------------------------------------------------------------------------------------------------------------oSooSoo-----------------
------------------------------oooSo------oo------------oSooooo---------------------------oo---ooooooo---------------------------------------------------------------------------------------------------
------------------------oo-----------------g---------------------------ooo---------------------------------------oSooSo----ooooo---------oooo-----------oSSS------ooooo----------ooooo---ooooS----------
--------------XXXXXX----------ooooo---XXXXXXXXX----------ooo----------------XXXXXXX----XXXXXXXXXXXXXXXX--------------------g------XXXXXX-------oo--------------------g---XXX---------------------XXXX---
--------------XXXXXX--XXXXXXX---------XXXXXXXXX----XXX---------XXXXXXXXXXXXXXXXXXXX----XXXXXXXXXXXXXXXXXXX--------oooo----XXXXXXXXXXXXXXXXXXXX--------ooooo---XXXXXXXXXXXXXXXXXXXXXXXXXX----oo---XXXXXXX
XXXXXXXXXXXXXXXXXXXX--XXXXXXXXXXXXXXXXXXXXXXXXXXXXXXXXXXXXXXXXXXXXXXXXXXXXXXXXXXXXXXXXXXXXXXXXXXXXXXXXXXXX----------------XXXXXXXXXXXXXXXXXXXXXXXXXX----------XXXXXXXXXXXXXXXXXXXXXXXXXX---------XXXXXXX
XXXXXXXXXXXXXXXXXXXXXXXXXXXXXXXXXXXXXXXXXXXXXXXXXXXXXXXXXXXXXXXXXXXXXXXXXXXXXXXXXXXXXXXXXXXXXXXXXXXXXXXXXXXXXXXXXXXXXXXXXXXXXXXXXXXXXXXXXXXXXXXXXXXXXXXXXXXXXXXXXXXXXXXXXXXXXXXXXXXXXXXXXXXXXXXXXXXXXXXX

