--------------------------------------------------------------------------------------------------------------------------------------------------------------------------------------------------------
--------------------------------------------------------------------------------------------------------------------------------------------------------------------------------------------------------
--------------------------------------------------------------------------------------------------------------------------------------------------------------------------------------------------------
--------------------------------------------------------------------------------------------------------------------------------------------------------------------------------------------------------
--------------------------------------------------------------------------------------------------------------------------------------------------------------------------------------------------------
--------------------------------------------------------------------------------------------------------------------------------------------------------------------------------------------------------
--------------------------------------------------------------------------------------------------------------------------------------------------------------------------------------------------------
--------------------------------------------------------------------------------------------------------------------------------------------------------------------------------------------------------
--------------------------------------------------------------------------------------------------------------------------------------------------------------------------------------------------------
--------------------------------------------------------------------------------------------------------------------------------------------------------------------------------------------------------
--------------------------------------------------------------------------------------------------------------------------------------------------------------------------------------------------------
--------------------------------------------------------------------------------------------------------------------------------------------------------------------------------------------------------
------------------------------------------------ooooo------------------------------------------------------------------------------------------------------------------------------------------oSSoo----
--------------------------------------------------------------------------------------------------------------------------------------------------------------------------------------------------------
---------------------------oo-------oooSooo-----ooo--------oSo--------------------------------------------------ooooS-------------------------------------------------------------------------ooooo-----
-----------------oooo------------------------------g------------------------------oooooSooo--oSooSooo--ooSSSSo---------------------oSoo---------ooooooo-----oSoooS---------------------------g-----g----
-------------------------XXXXXX--------oooo-XXXXXXXXXXX----ooooo----ooo------XXXX--------------------------------oooooo-------XXXX----------------------------------------------------ooo---XXXXXXXXXX--
---------------oooo------XXXXXX-------------XXXXXXXXXXX----------------------XXXX-oooooo-------oooooo-----oooo----------------XXXX-ooooooo-XXXX---ooooo-----ooooo---------------------------XXXXXXXXXX--
---------------g----g----XXXXXX----XXXXXXXXXXXXXXXXXXXXXXXXXXXXXXXXXXXXXXXXXXXXXX------------------------------XXXXXXXXXXXXXXXXXXX---------XXXX---------------------XXXXXXXX---XXXXXXXXXXXXXXXXXXXXXXX--
XXXXXXXXXXXXXXXXXXXXXXXXXXXXXXXXXXXXXXXXXXXXXXXXXXXXXXXXXXXXXXXXXXXXXXXXXXXXXXXXXXXXXXXXXXXXXXXXXXXXXXXXXXXXXXXXXXXXXXXXXXXXXXXXXXXXXXXXXXXXXXXXXXXXXXXXXXXXXXXXXXXXXXXXXXXXXXXXXXXXXXXXXXXXXXXXXXXXXXXX

