--------------------------------------------------------------------------------------------------------------------------------------------------------------------------------------------------------
--------------------------------------------------------------------------------------------------------------------------------------------------------------------------------------------------------
--------------------------------------------------------------------------------------------------------------------------------------------------------------------------------------------------------
--------------------------------------------------------------------------------------------------------------------------------------------------------------------------------------------------------
--------------------------------------------------------------------------------------------------------------------------------------------------------------------------------------------------------
--------------------------------------------------------------------------------------------------------------------------------------------------------------------------------------------------------
--------------------------------------------------------------------------------------------------------------------------------------------------------------------------------------------------------
--------------------------------------------------------------------------------------------------------------------------------------------------------------------------------------------------------
--------------------------------------------------------------------------------------------------------------------------------------------------------------------------------------------------------
--------------------------------------------------------------------------------------------------------------------------------------------------------------------------------------------------------
--------------------------------------------------------------------------------------------------------------------------------------------------------------------------------------------------------
--------------------------------------------------------------------------------------------------------------------------------------------------------------------------------------------------------
------------------------------------------oooo-----------ooo--------ooooSoo-----------------------oSoSSSo-------------------------------SoSSo------------------oooo-------------------------------------
--------------------------------------------------------------------------------------------------------------------------------------------------------------------------------------------SSoo--------
-------------------------ooSoSoo---------ooooooo--------------------ooooooo-----------------------oooooo------oSSo------oooo-----------ooooo-----------oSo----------------------------------------------
-----------------------------------------------------------------------g-----oooo------ooooSooo--------------------------------------------------------------------------------------------ooo----------
XXXXXXXXXXXXX-----------ooooo-----------XXXXXXXXX------XXXXXXXX---XXXXXXXXXX------XXXX-----------XXXXXXXXXXX--------XXXXXXXXX--oooo--XXXXXXXXX-----------ooo--XXXXXXX-----------XXXXXXXXXX--------------
XXXXXXXXXXXXXXXXXXXXXXX-----------ooo---XXXXXXXXX------XXXXXXXX---XXXXXXXXXX--ooo-XXXX--ooooooo--XXXXXXXXXXX---g----XXXXXXXXX--------XXXXXXXXX----------------XXXXXXX--oo-------XXXXXXXXXXXXXXXXXXXXXXXX
XXXXXXXXXXXXXXXXXXXXXXXXXXXXXXXXX-------XXXXXXXXXXXXXXXXXXXXXXXXXXXXXXXXXXXX------XXXX---g-------XXXXXXXXXXXXXXXXXXXXXXXXXXXXXXXXXXXXXXXXXXXXXXXXX----XXXXXXXXXXXXXXX-----------XXXXXXXXXXXXXXXXXXXXXXXX
XXXXXXXXXXXXXXXXXXXXXXXXXXXXXXXXXXXXXXXXXXXXXXXXXXXXXXXXXXXXXXXXXXXXXXXXXXXXXXXXXXXXXXXXXXXXXXXXXXXXXXXXXXXXXXXXXXXXXXXXXXXXXXXXXXXXXXXXXXXXXXXXXXXXXXXXXXXXXXXXXXXXXXXXXXXXXXXXXXXXXXXXXXXXXXXXXXXXXXXX

