--------------------------------------------------------------------------------------------------------------------------------------------------------------------------------------------------------
--------------------------------------------------------------------------------------------------------------------------------------------------------------------------------------------------------
--------------------------------------------------------------------------------------------------------------------------------------------------------------------------------------------------------
--------------------------------------------------------------------------------------------------------------------------------------------------------------------------------------------------------
--------------------------------------------------------------------------------------------------------------------------------------------------------------------------------------------------------
--------------------------------------------------------------------------------------------------------------------------------------------------------------------------------------------------------
--------------------------------------------------------------------------------------------------------------------------------------------------------------------------------------------------------
--------------------------------------------------------------------------------------------------------------------------------------------------------------------------------------------------------
--------------------------------------------------------------------------------------------------------------------------------------------------------------------------------------------------------
--------------------------------------------------------------------------------------------------------------------------------------------------------------------------------------------------------
--------------------------------------------------------------------------------------------------------------------------------------------------------------------------------------------------------
--------------------------------------------------------------------------------------------------------------------------------------------------------------------------------------------------------
------------oooooooo-----------ooSo---------------------------------------------------------------------------------------------------------------------------------------------------------------------
--------------------------------------------SoSo------------------------------------ooSo-------------------------oooooooo-------------------------------------oooooooo----------------------------------
------------oooooo-------oSoo-----------------------------ooSooo--------------------------------oSS-------ooo-----------------------------------------Sooo--------------------------oo----ooo-----------
-------------------------------g--g---------oo----ooooo-----------------------------oo------------------g---------ooooooo--------------------------------------oooooo----SooSSo-------------------------
-----------XXXXXXXXXXX--------XXXXXXX----g-----------------ooooo------XXX-------------g---------ooooo--XXXXXXXXX--------g--XXXX-oo---XXXXX--------------oooo--------------------XXXXXXXX------------XX--
-----------XXXXXXXXXXX--------XXXXXXX---XXXXXXXXX----oo-------g---XXXXXXX-oo----XXXXXXXXX----g---------XXXXXXXXXXXXXXXXXXXXXXXX------XXXXX----XXXXXX--g------XXXXXXXXXX--oooooo-XXXXXXXX------------XX--
XXXXXXXXXXXXXXXXXXXXXXXXXXXXXXXXXXXXX---XXXXXXXXX--------XXXXXXXXXXXXXXXX-------XXXXXXXXX---XXXXXXXXXXXXXXXXXXXXXXXXXXXXXXXXXXXXXXXXXXXXXX----XXXXXXXXXXXXXXXXXXXXXXXXX---------XXXXXXXXXXXXXXX-----XX--
XXXXXXXXXXXXXXXXXXXXXXXXXXXXXXXXXXXXXXXXXXXXXXXXXXXXXXXXXXXXXXXXXXXXXXXXXXXXXXXXXXXXXXXXXXXXXXXXXXXXXXXXXXXXXXXXXXXXXXXXXXXXXXXXXXXXXXXXXXXXXXXXXXXXXXXXXXXXXXXXXXXXXXXXXXXXXXXXXXXXXXXXXXXXXXXXXXXXXXXX

