--------------------------------------------------------------------------------------------------------------------------------------------------------------------------------------------------------
--------------------------------------------------------------------------------------------------------------------------------------------------------------------------------------------------------
--------------------------------------------------------------------------------------------------------------------------------------------------------------------------------------------------------
--------------------------------------------------------------------------------------------------------------------------------------------------------------------------------------------------------
--------------------------------------------------------------------------------------------------------------------------------------------------------------------------------------------------------
--------------------------------------------------------------------------------------------------------------------------------------------------------------------------------------------------------
--------------------------------------------------------------------------------------------------------------------------------------------------------------------------------------------------------
--------------------------------------------------------------------------------------------------------------------------------------------------------------------------------------------------------
--------------------------------------------------------------------------------------------------------------------------------------------------------------------------------------------------------
--------------------------------------------------------------------------------------------------------------------------------------------------------------------------------------------------------
--------------------------------------------------------------------------------------------------------------------------------------------------------------------------------------------------------
--------------------------------------------------------------------------------------------------------------------------------------------------------------------------------------------------------
------------------------------------------------------------------------------oSooo---------------------------Soooo-------------------------------------------------------------------------------------
--------------------------------------------------oSooSo----------------SSo---------------oooSSoo---------------------oSoo-----------------------------------------------oooS---------------------------
-------------------oooo-------ooSoS--------------------------------------------ooo-----------------------------ooooo------------------------------------------------------------------------ooo---------
--------------------------------------ooS----------ooooo----oooo-------ooooo---------------ooooo------ooo---------------------oooo------------------------------ooo---ooooo-----ooooo-------------------
------------------oooo-----ooooooo---------------------------g---------------XXXXXXXXX----------------------XXXXXXXXX------g--g----------------XXXXX--------------------------------g-g-XXXXXXXX--------
------------------------------g-------ooo--------XXXXXXXXXXXXXXXXXX---XXXXXXXXXXXXXXXX--XXXXXXXXXX-----oo---XXXXXXXXXXXXXXXXXXXXXXXX-------XXXXXXXXX----oooo--ooooo--XXXXXXXXXXXXXXXXXXXXXXXXXXX--------
---------------XXXXXXXXXXXXXXXXXXXXXX------------XXXXXXXXXXXXXXXXXXXXXXXXXXXXXXXXXXXXX--XXXXXXXXXX----------XXXXXXXXXXXXXXXXXXXXXXXX-----XXXXXXXXXXX------------g----XXXXXXXXXXXXXXXXXXXXXXXXXXXXXXXXXXX
XXXXXXXXXXXXXXXXXXXXXXXXXXXXXXXXXXXXXXXXXXXXXXXXXXXXXXXXXXXXXXXXXXXXXXXXXXXXXXXXXXXXXXXXXXXXXXXXXXXXXXXXXXXXXXXXXXXXXXXXXXXXXXXXXXXXXXXXXXXXXXXXXXXXXXXXXXXXXXXXXXXXXXXXXXXXXXXXXXXXXXXXXXXXXXXXXXXXXXXX

