--------------------------------------------------------------------------------------------------------------------------------------------------------------------------------------------------------
--------------------------------------------------------------------------------------------------------------------------------------------------------------------------------------------------------
--------------------------------------------------------------------------------------------------------------------------------------------------------------------------------------------------------
--------------------------------------------------------------------------------------------------------------------------------------------------------------------------------------------------------
--------------------------------------------------------------------------------------------------------------------------------------------------------------------------------------------------------
--------------------------------------------------------------------------------------------------------------------------------------------------------------------------------------------------------
--------------------------------------------------------------------------------------------------------------------------------------------------------------------------------------------------------
--------------------------------------------------------------------------------------------------------------------------------------------------------------------------------------------------------
--------------------------------------------------------------------------------------------------------------------------------------------------------------------------------------------------------
--------------------------------------------------------------------------------------------------------------------------------------------------------------------------------------------------------
--------------------------------------------------------------------------------------------------------------------------------------------------------------------------------------------------------
--------------------------------------------------------------------------------------------------------------------------------------------------------------------------------------------------------
-----------------------oooS---------------------------------------------------------------------------------------------------------------------------oSoo----------------------------------------------
-------------------------------------------------------------oSooo-----------oSo------SSSoSo-----------------------------------------------------------------------------------------SSoSo--------------
------------------------oo--------------------------------------------------------------------oooo--------oooooo-----ooo-------------------oSoo------ooooooo--------------------------------------------
---------------------------------oooS---------oooo-----------oooooo------------------oooo---------------------------------------ooooo-------------------------------oSoSo--------------ooo--------------
XXXXXXXXXXXXXXX-------XXXXXXX----------------------------------------------------------------XXXXXXX----------------ooo--------------------ooooo---XXXXXXXXXX-oooo-----------oo-----------------XXX-----
XXXXXXXXXXXXXXX-------XXXXXXX--ooooo----oo---XXXXXXX--------XXXXXXXXX-oooo-XXXXXXXXXXXXXXXXXXXXXXXXX----------------------------ooooooo------------XXXXXXXXXX----------------------XXXXXXXXXXXXXXXX--XXX
XXXXXXXXXXXXXXX-------XXXXXXX----------------XXXXXXXXXXX----XXXXXXXXX------XXXXXXXXXXXXXXXXXXXXXXXXX----XXXXXXXXXXXXXXXXXX--------------XXXXXXXXXXXXXXXXXXXXXXXXXXX-g-------XXXXXXXXXXXXXXXXXXXXXXX--XXX
XXXXXXXXXXXXXXXXXXXXXXXXXXXXXXXXXXXXXXXXXXXXXXXXXXXXXXXXXXXXXXXXXXXXXXXXXXXXXXXXXXXXXXXXXXXXXXXXXXXXXXXXXXXXXXXXXXXXXXXXXXXXXXXXXXXXXXXXXXXXXXXXXXXXXXXXXXXXXXXXXXXXXXXXXXXXXXXXXXXXXXXXXXXXXXXXXXXXXXXX

