--------------------------------------------------------------------------------------------------------------------------------------------------------------------------------------------------------
--------------------------------------------------------------------------------------------------------------------------------------------------------------------------------------------------------
--------------------------------------------------------------------------------------------------------------------------------------------------------------------------------------------------------
--------------------------------------------------------------------------------------------------------------------------------------------------------------------------------------------------------
--------------------------------------------------------------------------------------------------------------------------------------------------------------------------------------------------------
--------------------------------------------------------------------------------------------------------------------------------------------------------------------------------------------------------
--------------------------------------------------------------------------------------------------------------------------------------------------------------------------------------------------------
--------------------------------------------------------------------------------------------------------------------------------------------------------------------------------------------------------
--------------------------------------------------------------------------------------------------------------------------------------------------------------------------------------------------------
--------------------------------------------------------------------------------------------------------------------------------------------------------------------------------------------------------
--------------------------------------------------------------------------------------------------------------------------------------------------------------------------------------------------------
--------------------------------------------------------------------------------------------------------------------------------------------------------------------------------------------------------
--------------------------------------------------------------------oSoSSoo------------------------------------------------------------------------------------------SSoo-------------------------------
------------------------------------------------------oooo-------------------------------------------------------------------------------------------------ooooo-------------SooS-----------------------
--------------------------------------oooooSoo-----------------------ooooooo-----------------ooo-----oSSoSS------------------------oSoo------------------------------ooo-------------------ooooS--------
-------------------ooo-------SoSoooo-------------------ooooo----------------------------------------------------oSSooSo----------------------------------oooooo--------------oooo-----------------------
-----------------------------------------ooooo---------------------XXXXXXXXXXX---------------oo--XXX--ooo-----------------XXXXXX-ooooooo--------oooo-------g-----XXXXXXXXX-------------------oooo-----XX
----------------XXXXXXXXXX----oooo-------------------XXXXXXXXX-----XXXXXXXXXXXXXXXXXXXXXXX-------XXX--------------oooooo--XXXXXX----------XXX-----------XXXXXXXXXXXXXXXXXXXXXXXXXXXXXXXXXX----------XXXX
-------------XXXXXXXXXXXXX-----------XXXXXXXXXXX-----XXXXXXXXXXXXXXXXXXXXXXXXXXXXXXXXXXXXXXXXXXXXXXXXXXXXXXXX-------------XXXXXXXXXXXXXXXXXXXXXXXXXXXXXXXXXXXXXXXXXXXXXXXXXXXXXXXXXXXXXXXXXXXXXXXXXXXXXX
XXXXXXXXXXXXXXXXXXXXXXXXXXXXXXXXXXXXXXXXXXXXXXXXXXXXXXXXXXXXXXXXXXXXXXXXXXXXXXXXXXXXXXXXXXXXXXXXXXXXXXXXXXXXXXXXXXXXXXXXXXXXXXXXXXXXXXXXXXXXXXXXXXXXXXXXXXXXXXXXXXXXXXXXXXXXXXXXXXXXXXXXXXXXXXXXXXXXXXXX

