--------------------------------------------------------------------------------------------------------------------------------------------------------------------------------------------------------
--------------------------------------------------------------------------------------------------------------------------------------------------------------------------------------------------------
--------------------------------------------------------------------------------------------------------------------------------------------------------------------------------------------------------
--------------------------------------------------------------------------------------------------------------------------------------------------------------------------------------------------------
--------------------------------------------------------------------------------------------------------------------------------------------------------------------------------------------------------
--------------------------------------------------------------------------------------------------------------------------------------------------------------------------------------------------------
--------------------------------------------------------------------------------------------------------------------------------------------------------------------------------------------------------
--------------------------------------------------------------------------------------------------------------------------------------------------------------------------------------------------------
--------------------------------------------------------------------------------------------------------------------------------------------------------------------------------------------------------
--------------------------------------------------------------------------------------------------------------------------------------------------------------------------------------------------------
--------------------------------------------------------------------------------------------------------------------------------------------------------------------------------------------------------
--------------------------------------------------------------------------------------------------------------------------------------------------------------------------------------------------------
----------------------------------------------------------------------------------------------------------------------------------------------Sooo------------------------------------------------------
-----------------ooooSo---------------------------------------------------------------------------------------------ooo---ooSoSSoo----------------------------------------------------------------------
--------------------------------------------ooSooSooo-------ooo--------SSSoo------ooo---oooSo-----------------------------------------SSS-----ooo-------------------------------------------------------
---------------oooooo---------------------------------------------------------------------------------oo------------------ooooooo---------------------------ooooo-----Sooooo---------ooS----oooooS------
XXXXXXXXXX-------g-----------------------------ooo----XXXXXXXXXXXX-----ooo-------oo-------ooo----------------------------------------------XXXXXXXX----XXX----------------------------------------------
XXXXXXXXXX---XXXXXXXXXXX-oooo-XXX-ooo-----------------XXXXXXXXXXXXXX-----------g--------------------XXXXXXX-------XXXXXXXXXXXXXXXXXX-------XXXXXXXXXXXXXXXXXXXXXXXXX-oooooo----XXXXX--------------------
XXXXXXXXXX---XXXXXXXXXXX------XXX---gg-----XXXXXXXXXXXXXXXXXXXXXXXXXXXXXXXXXXXXXXXXXXXXXXXXXXXX-----XXXXXXX----g--XXXXXXXXXXXXXXXXXXXXXXXXXXXXXXXXXXXXXXXXXXXXXXXXXX-----------XXXXX----------------XXXX
XXXXXXXXXXXXXXXXXXXXXXXXXXXXXXXXXXXXXXXXXXXXXXXXXXXXXXXXXXXXXXXXXXXXXXXXXXXXXXXXXXXXXXXXXXXXXXXXXXXXXXXXXXXXXXXXXXXXXXXXXXXXXXXXXXXXXXXXXXXXXXXXXXXXXXXXXXXXXXXXXXXXXXXXXXXXXXXXXXXXXXXXXXXXXXXXXXXXXXXX

