--------------------------------------------------------------------------------------------------------------------------------------------------------------------------------------------------------
--------------------------------------------------------------------------------------------------------------------------------------------------------------------------------------------------------
--------------------------------------------------------------------------------------------------------------------------------------------------------------------------------------------------------
--------------------------------------------------------------------------------------------------------------------------------------------------------------------------------------------------------
--------------------------------------------------------------------------------------------------------------------------------------------------------------------------------------------------------
--------------------------------------------------------------------------------------------------------------------------------------------------------------------------------------------------------
--------------------------------------------------------------------------------------------------------------------------------------------------------------------------------------------------------
--------------------------------------------------------------------------------------------------------------------------------------------------------------------------------------------------------
--------------------------------------------------------------------------------------------------------------------------------------------------------------------------------------------------------
--------------------------------------------------------------------------------------------------------------------------------------------------------------------------------------------------------
--------------------------------------------------------------------------------------------------------------------------------------------------------------------------------------------------------
--------------------------------------------------------------------------------------------------------------------------------------------------------------------------------------------------------
------------------------------ooSo-----------------oooSooSSo-------------SoSoS------------------------------------SoSo----------------------oSSoo-------------------------------ooo---------------SSo---
--------------------------------------------------------------------------------------------------------------------------SSo---------------------------------------------------------------------------
-----------------------------------------------------oooo------------------oooo----------------------oSSSoSS------ooooo--------------------------------------------------------ooooooo-----------oo-----
----------------------ooo----------------------------------------oSSoo--------------ooooS-----------------------------------oo---------------------oooo-----------oooo----------------------------------
-----------------------------XXXXXX-------XXXXX---XXXXXXXXXXXXX--------XXXXXXXXX-----------XXX---------oooooo--XXXXXXXXX----g---XXXX-------XXXXXXX----g----------------------XXXXXXXXXX-------XXXXXXXXXX
------------------------oooo-XXXXXX-oooo--XXXXX---XXXXXXXXXXXXX---ooo--XXXXXXXXX---oooo----XXX---oo-----g------XXXXXXXXXXXXXXXXXXXXX-------XXXXXXXXXXXXXXXXXXX---oooo----XX--XXXXXXXXXXXXXXXXXXXXXXXXXXX
XXXXXXXXXXX------------------XXXXXX---g---XXXXXXXXXXXXXXXXXXXXX--------XXXXXXXXX-----------XXX------XXXXXXXXXXXXXXXXXXXXXXXXXXXXXXXX---XXXXXXXXXXXXXXXXXXXXXXX-----------XX--XXXXXXXXXXXXXXXXXXXXXXXXXXX
XXXXXXXXXXXXXXXXXXXXXXXXXXXXXXXXXXXXXXXXXXXXXXXXXXXXXXXXXXXXXXXXXXXXXXXXXXXXXXXXXXXXXXXXXXXXXXXXXXXXXXXXXXXXXXXXXXXXXXXXXXXXXXXXXXXXXXXXXXXXXXXXXXXXXXXXXXXXXXXXXXXXXXXXXXXXXXXXXXXXXXXXXXXXXXXXXXXXXXXX

