--------------------------------------------------------------------------------------------------------------------------------------------------------------------------------------------------------
--------------------------------------------------------------------------------------------------------------------------------------------------------------------------------------------------------
--------------------------------------------------------------------------------------------------------------------------------------------------------------------------------------------------------
--------------------------------------------------------------------------------------------------------------------------------------------------------------------------------------------------------
--------------------------------------------------------------------------------------------------------------------------------------------------------------------------------------------------------
--------------------------------------------------------------------------------------------------------------------------------------------------------------------------------------------------------
--------------------------------------------------------------------------------------------------------------------------------------------------------------------------------------------------------
--------------------------------------------------------------------------------------------------------------------------------------------------------------------------------------------------------
--------------------------------------------------------------------------------------------------------------------------------------------------------------------------------------------------------
--------------------------------------------------------------------------------------------------------------------------------------------------------------------------------------------------------
--------------------------------------------------------------------------------------------------------------------------------------------------------------------------------------------------------
--------------------------------------------------------------------------------------------------------------------------------------------------------------------------------------------------------
-----------------------------SoS------------------oSSS-----ooSSoSoo-------------------ooo--ooooSSS-----------oooo-----------------------------------------------------Soooooo---------------------------
------------------------------------------------------------------------------------------------------------------------ooSooSS-------------------------------------------------------------------------
--------------SSo---ooo----oooooo--------------------------oooooooo------------------------ooooooo-----------oooo------------------------------------------------------ooo------------------------------
-------------------------------------g----------------------------------------------------------------------------------ooooooo---------------------------g----ooo-------------ooooSoSoo----------------
-----------ooooo-----oooo-XXXXXXXXXXXXXXX--------XXXXXXXXXXXXXXXXXXX---------------XXXXXXXXXXXXXXXXXXXXXXXXXXXXXXXX------------------------------------XXXXXX------XXXXXXXXXXX-----------XXXXXXXXX-ooo--
--------------------------XXXXXXXXXXXXXXX------XXXXXXXXXXXXXXXXXXXXX-------XX------XXXXXXXXXXXXXXXXXXXXXXXXXXXXXXXX----XXXXXXXXXX--XXXXXX-----XXX------XXXXXXXXXXXXXXXXXXXXXXX---ooooooo-XXXXXXXXX------
----------XXXXXXXXXXXXXXXXXXXXXXXXXXXXXXXXXXXXXXXXXXXXXXXXXXXXXXXXXXXXXX---XXXXXXXXXXXXXXXXXXXXXXXXXXXXXXXXXXXXXXXXXXXXXXXXXXXXXX--XXXXXX-----XXXXXXXXXXXXXXXXXXXXXXXXXXXXXXXX------g----XXXXXXXXXXXXXXX
XXXXXXXXXXXXXXXXXXXXXXXXXXXXXXXXXXXXXXXXXXXXXXXXXXXXXXXXXXXXXXXXXXXXXXXXXXXXXXXXXXXXXXXXXXXXXXXXXXXXXXXXXXXXXXXXXXXXXXXXXXXXXXXXXXXXXXXXXXXXXXXXXXXXXXXXXXXXXXXXXXXXXXXXXXXXXXXXXXXXXXXXXXXXXXXXXXXXXXXX

