--------------------------------------------------------------------------------------------------------------------------------------------------------------------------------------------------------
--------------------------------------------------------------------------------------------------------------------------------------------------------------------------------------------------------
--------------------------------------------------------------------------------------------------------------------------------------------------------------------------------------------------------
--------------------------------------------------------------------------------------------------------------------------------------------------------------------------------------------------------
--------------------------------------------------------------------------------------------------------------------------------------------------------------------------------------------------------
--------------------------------------------------------------------------------------------------------------------------------------------------------------------------------------------------------
--------------------------------------------------------------------------------------------------------------------------------------------------------------------------------------------------------
--------------------------------------------------------------------------------------------------------------------------------------------------------------------------------------------------------
--------------------------------------------------------------------------------------------------------------------------------------------------------------------------------------------------------
--------------------------------------------------------------------------------------------------------------------------------------------------------------------------------------------------------
--------------------------------------------------------------------------------------------------------------------------------------------------------------------------------------------------------
--------------------------------------------------------------------------------------------------------------------------------------------------------------------------------------------------------
---------------------------------------------oSSoSo--------------------------------------------------oooSSS------oooSS-----------------------Soo-------ooooSoo------------------------------------------
-----------ooooo-------------------------------------------------------------------------------------------------------------------------------------------------------------------------Soooo----------
----------------------------------------------oo------------------------------------------------------oooo-----ooooo-----------oo-----------ooooo--------oooo-------------------------------------------
----------------------------oooo----ooooo------------oSoooS----------------------------------------------------------------------g--------------------------------oo---------ooSoSooo---ooooo-----------
------------------------------------------XXXXXXXXXX------------------ooo--------oooo--------------XXXXXXXXXXXXXXXXXXXXX---XXXXXXXX-------XXXXXXXXXXXXXXXXXXXXXXX--------------------------------------X
----------XXXXXXXXXXXXXX---ooo-----oooo---XXXXXXXXXX---oooo------------------------g-----------oo--XXXXXXXXXXXXXXXXXXXXXXXXXXXXXXXX-oo----XXXXXXXXXXXXXXXXXXXXXXXXXXXXX---------oo----XXXXXXXXXXXXXX---X
XXXXXXXXXXXXXXXXXXXXXXXX------------------XXXXXXXXXX------------g----XXXXXX---XXXXXXXXXXXXXX-------XXXXXXXXXXXXXXXXXXXXXXXXXXXXXXXX-------XXXXXXXXXXXXXXXXXXXXXXXXXXXXX---------------XXXXXXXXXXXXXXXXXX
XXXXXXXXXXXXXXXXXXXXXXXXXXXXXXXXXXXXXXXXXXXXXXXXXXXXXXXXXXXXXXXXXXXXXXXXXXXXXXXXXXXXXXXXXXXXXXXXXXXXXXXXXXXXXXXXXXXXXXXXXXXXXXXXXXXXXXXXXXXXXXXXXXXXXXXXXXXXXXXXXXXXXXXXXXXXXXXXXXXXXXXXXXXXXXXXXXXXXXXX

