--------------------------------------------------------------------------------------------------------------------------------------------------------------------------------------------------------
--------------------------------------------------------------------------------------------------------------------------------------------------------------------------------------------------------
--------------------------------------------------------------------------------------------------------------------------------------------------------------------------------------------------------
--------------------------------------------------------------------------------------------------------------------------------------------------------------------------------------------------------
--------------------------------------------------------------------------------------------------------------------------------------------------------------------------------------------------------
--------------------------------------------------------------------------------------------------------------------------------------------------------------------------------------------------------
--------------------------------------------------------------------------------------------------------------------------------------------------------------------------------------------------------
--------------------------------------------------------------------------------------------------------------------------------------------------------------------------------------------------------
--------------------------------------------------------------------------------------------------------------------------------------------------------------------------------------------------------
--------------------------------------------------------------------------------------------------------------------------------------------------------------------------------------------------------
--------------------------------------------------------------------------------------------------------------------------------------------------------------------------------------------------------
--------------------------------------------------------------------------------------------------------------------------------------------------------------------------------------------------------
------------------------------ooSoSoSo------------------ooo------------------------------ooSoo---------------------------------------------------------------------oSSoo--------------------------------
--------------------------------------------------------------------------------ooSoSSo-----------------------------------------------------------------------------------------------------------------
--------------------------------ooooo------------------------------------------------------oo------------------------------------------oSooo----------------------oooooooo-------------------------ooo--
-------------------------------------g------------oooo-------g-----------------ooooo---------------------Soooo------------ooSoSo-------------------------------------------------------oooSoSoo---------
----------XX--------XXXXX----XXXXXXXXXX----------------XXXXXXXX-------------------------XXXXXXXX---------------------------------XXXX----ooo-XXXXX---------XXXXXXXXXXXXXXXX----------------------------X
XXXXXXXXXXXX--------XXXXX----XXXXXXXXXX----------XXXXXXXXXXXXXX-----XXXX-----XXXXXXXXXXXXXXXXXXXXX-----oooooo----oooo--oooooooo--XXXX--------XXXXX---------XXXXXXXXXXXXXXXX-------------ooooo------g---X
XXXXXXXXXXXXXXXXXXXXXXXXX----XXXXXXXXXX-----XXXXXXXXXXXXXXXXXXX-----XXXX-----XXXXXXXXXXXXXXXXXXXXX-------------------------------XXXXXXXXXXXXXXXXX-----XXXXXXXXXXXXXXXXXXXX------XXXXX-----------XXXXXXX
XXXXXXXXXXXXXXXXXXXXXXXXXXXXXXXXXXXXXXXXXXXXXXXXXXXXXXXXXXXXXXXXXXXXXXXXXXXXXXXXXXXXXXXXXXXXXXXXXXXXXXXXXXXXXXXXXXXXXXXXXXXXXXXXXXXXXXXXXXXXXXXXXXXXXXXXXXXXXXXXXXXXXXXXXXXXXXXXXXXXXXXXXXXXXXXXXXXXXXXX

