--------------------------------------------------------------------------------------------------------------------------------------------------------------------------------------------------------
--------------------------------------------------------------------------------------------------------------------------------------------------------------------------------------------------------
--------------------------------------------------------------------------------------------------------------------------------------------------------------------------------------------------------
--------------------------------------------------------------------------------------------------------------------------------------------------------------------------------------------------------
--------------------------------------------------------------------------------------------------------------------------------------------------------------------------------------------------------
--------------------------------------------------------------------------------------------------------------------------------------------------------------------------------------------------------
--------------------------------------------------------------------------------------------------------------------------------------------------------------------------------------------------------
--------------------------------------------------------------------------------------------------------------------------------------------------------------------------------------------------------
--------------------------------------------------------------------------------------------------------------------------------------------------------------------------------------------------------
--------------------------------------------------------------------------------------------------------------------------------------------------------------------------------------------------------
--------------------------------------------------------------------------------------------------------------------------------------------------------------------------------------------------------
--------------------------------------------------------------------------------------------------------------------------------------------------------------------------------------------------------
---------------ooo-----------------------Sooo-----------------------------------------------------------------------------------------------------------------------------------------------------------
----------------------------------------------------------------oSooo----------------------------------------------------Soo----------------------------------ooSSoSooo---------------------------------
---------------ooo---------------------ooo-----oSoSSSo---------------------oSoo---------------ooo--------------Soo---------------------------------------------------------Soooo--------oSoo------oooSo-
----------------R-k--------------------y-----------------------oooooo-------------ooSo---------Gr-----ooo--------------oo---------------------------------------ooooo-----------------------------------
--------------XXXXXXX------------k-K-XXXXXXXXX-----------oo----r----R-k---ooooo---------XXXXXXXXXXXXX--r-k---ooooooo---kg-g----oo-------XXXXX----------XXXXXX-g-R---G-----ooooooo-----------------ooooo-
XXXXXXXXXXXXXXXXXXXXXXXXXXXXXXXXXXXXXXXXXXXXXX-g---g-----y-G--XXXXXXXXXX-y--r-----------XXXXXXXXXXXXXXXXXXXX-g-k-----XXXXXXXX-------XXXXXXXXXXXX-------XXXXXXXXXXXXXXXXX-k---------XXXX-k--------k-yYy--
XXXXXXXXXXXXXXXXXXXXXXXXXXXXXXXXXXXXXXXXXXXXXXXXXXXXXXXXXXXXXXXXXXXXXXXXXXXXXXXXX-------XXXXXXXXXXXXXXXXXXXXXXXXXXXXXXXXXXXXXXXXXXXXXXXXXXXXXXXX-------XXXXXXXXXXXXXXXXXXXXXXXXXXXXXXXXXXXXXXXXXXXXXXXXX
XXXXXXXXXXXXXXXXXXXXXXXXXXXXXXXXXXXXXXXXXXXXXXXXXXXXXXXXXXXXXXXXXXXXXXXXXXXXXXXXXXXXXXXXXXXXXXXXXXXXXXXXXXXXXXXXXXXXXXXXXXXXXXXXXXXXXXXXXXXXXXXXXXXXXXXXXXXXXXXXXXXXXXXXXXXXXXXXXXXXXXXXXXXXXXXXXXXXXXXX

