--------------------------------------------------------------------------------------------------------------------------------------------------------------------------------------------------------
--------------------------------------------------------------------------------------------------------------------------------------------------------------------------------------------------------
--------------------------------------------------------------------------------------------------------------------------------------------------------------------------------------------------------
--------------------------------------------------------------------------------------------------------------------------------------------------------------------------------------------------------
--------------------------------------------------------------------------------------------------------------------------------------------------------------------------------------------------------
--------------------------------------------------------------------------------------------------------------------------------------------------------------------------------------------------------
--------------------------------------------------------------------------------------------------------------------------------------------------------------------------------------------------------
--------------------------------------------------------------------------------------------------------------------------------------------------------------------------------------------------------
--------------------------------------------------------------------------------------------------------------------------------------------------------------------------------------------------------
--------------------------------------------------------------------------------------------------------------------------------------------------------------------------------------------------------
--------------------------------------------------------------------------------------------------------------------------------------------------------------------------------------------------------
--------------------------------------------------------------------------------------------------------------------------------------------------------------------------------------------------------
--------------------------------------------------------------------oooSo----------------------------oSoo-------------------------------------ooo-------------------------------------------------------
--------------------------oSooo-----------ooo------------------------------------------------------------------------------------------------------------------------------------------oSoSo------------
-------------------------------------oo--------------------------------oo----------------------------oooo----------------ooSooooo-------oSoo---ooooo---ooSo-----------------SoooSo--------------oSoSooo-
---------------ooo-----------oooo-----kr--ooo---------------oo------g---y-----SSo-------------------k----g------------------------------------R-K--g------------oSSooS---------------oooooooo-----------
XXXXXXXXXX-----------------y-------XXXXXX--Kg--k-----------r-r-G---XXXXXXX----------oo------------XXXXXXXXX---------XXX----oooo-------oooo---XXXXXXXX--oo-------------------ooooo---------------ooooo---
XXXXXXXXXX----oooo-------XXXXXXXXXXXXXXXXXXXXXXXX---------XXXXXXX--XXXXXXX------------y----oooooo-XXXXXXXXX---RK-XXXXXX--R---kk--------k-R---XXXXXXXX-rR---G---oooooo---XX-y-G----k-XXXXXXXXXX----yrRy--
XXXXXXXXXXXX--y-ry-------XXXXXXXXXXXXXXXXXXXXXXXX--XXX----XXXXXXX--XXXXXXX-rRk-g--XXXXXXX------ky-XXXXXXXXXXXXXXXXXXXXXXXXXXXXXXXX---XXXXXXXXXXXXXXXXXXXXXXXX-----k-G-g-XXXXXXXXXXXXXXXXXXXXXXXXXXXXXXXX
XXXXXXXXXXXXXXXXXXXXXXXXXXXXXXXXXXXXXXXXXXXXXXXXXXXXXXXXXXXXXXXXXXXXXXXXXXXXXXXXXXXXXXXXXXXXXXXXXXXXXXXXXXXXXXXXXXXXXXXXXXXXXXXXXXXXXXXXXXXXXXXXXXXXXXXXXXXXXXXXXXXXXXXXXXXXXXXXXXXXXXXXXXXXXXXXXXXXXXXX

