--------------------------------------------------------------------------------------------------------------------------------------------------------------------------------------------------------
--------------------------------------------------------------------------------------------------------------------------------------------------------------------------------------------------------
--------------------------------------------------------------------------------------------------------------------------------------------------------------------------------------------------------
--------------------------------------------------------------------------------------------------------------------------------------------------------------------------------------------------------
--------------------------------------------------------------------------------------------------------------------------------------------------------------------------------------------------------
--------------------------------------------------------------------------------------------------------------------------------------------------------------------------------------------------------
--------------------------------------------------------------------------------------------------------------------------------------------------------------------------------------------------------
--------------------------------------------------------------------------------------------------------------------------------------------------------------------------------------------------------
--------------------------------------------------------------------------------------------------------------------------------------------------------------------------------------------------------
--------------------------------------------------------------------------------------------------------------------------------------------------------------------------------------------------------
--------------------------------------------------------------------------------------------------------------------------------------------------------------------------------------------------------
--------------------------------------------------------------------------------------------------------------------------------------------------------------------------------------------------------
---------------------------------------------------------------------------------------------------Soo-------------------oSo--ooSoo---------------------------------------------------------------------
-----------------------ooSSo-----------------------------------------------------------------------------oSoo------------------------------------------------------oooooo-----------------oooooSSoo-----
-------------------------------ooo-----------------ooooo-------------------------------oo----------ooo-------------------------oooooo--------------------ooSS-------------------------------------------
--------------ooSoSoo----ooo--------g---k------------k---------------------------------Kk-------------k---oooo------oo---y--------y--K------------------------------oooooo-----------------oooooo-------
------------------------------oooo-XXXXXXXX-oo----XXXXXXXXX-------------------------XXXXXX-------XXXXXXX---k-r-------R-XXXXXXXXXXXXXXXX-----------------ooooo------------------------------Yyyy--k------
--------------ooooo---XXXXXXX------XXXXXXXX-------XXXXXXXXX-----oooo-XXXXXXXXX------XXXXXX--ooo--XXXXXXXXXXXXXXXXXXXXXXXXXXXXXXXXXXXXXX----------------------g---XXXXXXXXXXXXXXX-Kk-K----XXXXXXXXXXX----
XXXXXXXXXXX-----g---r-XXXXXXXXXXXXXXXXXXXXXXXXXXXXXXXXXXXXX----yy--r-XXXXXXXXX-r----XXXXXX--KyrY-XXXXXXXXXXXXXXXXXXXXXXXXXXXXXXXXXXXXXX----XXXXXXXXXXXXXXXXXXXXXXXXXXXXXXXXXXXXXXXXXXXXXXXXXXXXXXXXX----
XXXXXXXXXXXXXXXXXXXXXXXXXXXXXXXXXXXXXXXXXXXXXXXXXXXXXXXXXXXXXXXXXXXXXXXXXXXXXXXXXXXXXXXXXXXXXXXXXXXXXXXXXXXXXXXXXXXXXXXXXXXXXXXXXXXXXXXXXXXXXXXXXXXXXXXXXXXXXXXXXXXXXXXXXXXXXXXXXXXXXXXXXXXXXXXXXXXXXXXX

