--------------------------------------------------------------------------------------------------------------------------------------------------------------------------------------------------------
--------------------------------------------------------------------------------------------------------------------------------------------------------------------------------------------------------
--------------------------------------------------------------------------------------------------------------------------------------------------------------------------------------------------------
--------------------------------------------------------------------------------------------------------------------------------------------------------------------------------------------------------
--------------------------------------------------------------------------------------------------------------------------------------------------------------------------------------------------------
--------------------------------------------------------------------------------------------------------------------------------------------------------------------------------------------------------
--------------------------------------------------------------------------------------------------------------------------------------------------------------------------------------------------------
--------------------------------------------------------------------------------------------------------------------------------------------------------------------------------------------------------
--------------------------------------------------------------------------------------------------------------------------------------------------------------------------------------------------------
--------------------------------------------------------------------------------------------------------------------------------------------------------------------------------------------------------
--------------------------------------------------------------------------------------------------------------------------------------------------------------------------------------------------------
--------------------------------------------------------------------------------------------------------------------------------------------------------------------------------------------------------
-----------------------------------------------------------------------------------------------------------------------------------------------------ooSo--------------oooo-----------------------------
----------------------------------oooo--------------------------------------------------------------------------------------------SooSo-----------------------------------------------------------------
------------------------------------------------------------------------------------------------ooooo---------------------------------------oooo----ooo------SSooo---oooooo------------ooS-----oooS-----
-----------------------oo------oooooo----------------------------------oSoSSo-------------oooo------------oSS----oSooo---ooooS------oooooo-----RR------gR-----------r-k-g-------------------------------
----------XX---------r----XXXX--g-----y----oo--------------ooo-XXX---------------ooooo----gg-g----ooooo---------------------------GKgy-r---XXXXXXXXXXXXXXX---------XXXXXXXXXX--------oooooo-------oo-XXX
XXXXXXXXXXXX--------XXXXXXXXXXXXXXXXXXXXX--R------------g--K---XXX---oooooo------r------XXXXXXX--y--g------------ooo------------XXXXXXXXXXXXXXXXXXXXXXXXXX---------XXXXXXXXXX--XXXX-r----y-----k-----XXX
XXXXXXXXXXXX--------XXXXXXXXXXXXXXXXXXXXXXXXXXXX---XXXXXXXXXXXXXXXXX---k--R---XXXXXXXXXXXXXXXXXXXXXXXXXX---r-y------K----R---r--XXXXXXXXXXXXXXXXXXXXXXXXXXXXXXXXXXXXXXXXXXXXXXXXXXXXXXXXXXXXXXXXXXXXXXXX
XXXXXXXXXXXXXXXXXXXXXXXXXXXXXXXXXXXXXXXXXXXXXXXXXXXXXXXXXXXXXXXXXXXXXXXXXXXXXXXXXXXXXXXXXXXXXXXXXXXXXXXXXXXXXXXXXXXXXXXXXXXXXXXXXXXXXXXXXXXXXXXXXXXXXXXXXXXXXXXXXXXXXXXXXXXXXXXXXXXXXXXXXXXXXXXXXXXXXXXX

