--------------------------------------------------------------------------------------------------------------------------------------------------------------------------------------------------------
--------------------------------------------------------------------------------------------------------------------------------------------------------------------------------------------------------
--------------------------------------------------------------------------------------------------------------------------------------------------------------------------------------------------------
--------------------------------------------------------------------------------------------------------------------------------------------------------------------------------------------------------
--------------------------------------------------------------------------------------------------------------------------------------------------------------------------------------------------------
--------------------------------------------------------------------------------------------------------------------------------------------------------------------------------------------------------
--------------------------------------------------------------------------------------------------------------------------------------------------------------------------------------------------------
--------------------------------------------------------------------------------------------------------------------------------------------------------------------------------------------------------
--------------------------------------------------------------------------------------------------------------------------------------------------------------------------------------------------------
--------------------------------------------------------------------------------------------------------------------------------------------------------------------------------------------------------
--------------------------------------------------------------------------------------------------------------------------------------------------------------------------------------------------------
--------------------------------------------------------------------------------------------------------------------------------------------------------------------------------------------------------
------------------------oSooSoo-----SoSoSo------ooo---------------ooSo----------------------------oSoSS-------------------------------------------------------------------------------------------------
---------------------------------------------------------------------------------------------------------------------------------------------------------------------------------------------------ooS--
---------------------------oooooo---oooooo--------oooo----------oooo-----SSoo---------ooSooooo----oooo-----oooo---------ooo-------------------oo----ooSooo----oSSSo-------------------------------------
-------------oSSoSo-----y-r--g-----gg-k-R-R----g-----G------------k-y-------------------------------g--k-----g-y----------------------------r---------------------------ooSSSoooo----------------ooooo--
-----------------------XXXXXXXXXXXXXXXXXXXXXXXXXXXXXXXX--------XXXXXXXX--oooooo---------ooooo----XXXXXXXXXXXXXXXX-------oooooo-XXXXXX----XXXXXXXX----oooooo-----oooooo-----------------------oo----k--g-
--------------oooo-----XXXXXXXXXXXXXXXXXXXXXXXXXXXXXXXX--r---y-XXXXXXXX--k---yY----------yy----XXXXXXXXXXXXXXXXXX-Y-----r-Y-y--XXXXXX----XXXXXXXX---y----------kK----r---oooooooo----------gkk--XXXXXXXX
-------------yk--------XXXXXXXXXXXXXXXXXXXXXXXXXXXXXXXXXXXXXXXXXXXXXXXXXXXXXXXXXX--XXXXXXXXXXXXXXXXXXXXXXXXXXXXXXXXXXXXXXXXXXXXXXXXXX----XXXXXXXX--XXXXXXXXXXXXXXXXXXXX----G---g------r---XXXXXXXXXXXXXX
XXXXXXXXXXXXXXXXXXXXXXXXXXXXXXXXXXXXXXXXXXXXXXXXXXXXXXXXXXXXXXXXXXXXXXXXXXXXXXXXXXXXXXXXXXXXXXXXXXXXXXXXXXXXXXXXXXXXXXXXXXXXXXXXXXXXXXXXXXXXXXXXXXXXXXXXXXXXXXXXXXXXXXXXXXXXXXXXXXXXXXXXXXXXXXXXXXXXXXXX

