--------------------------------------------------------------------------------------------------------------------------------------------------------------------------------------------------------
--------------------------------------------------------------------------------------------------------------------------------------------------------------------------------------------------------
--------------------------------------------------------------------------------------------------------------------------------------------------------------------------------------------------------
--------------------------------------------------------------------------------------------------------------------------------------------------------------------------------------------------------
--------------------------------------------------------------------------------------------------------------------------------------------------------------------------------------------------------
--------------------------------------------------------------------------------------------------------------------------------------------------------------------------------------------------------
--------------------------------------------------------------------------------------------------------------------------------------------------------------------------------------------------------
--------------------------------------------------------------------------------------------------------------------------------------------------------------------------------------------------------
--------------------------------------------------------------------------------------------------------------------------------------------------------------------------------------------------------
--------------------------------------------------------------------------------------------------------------------------------------------------------------------------------------------------------
--------------------------------------------------------------------------------------------------------------------------------------------------------------------------------------------------------
--------------------------------------------------------------------------------------------------------------------------------------------------------------------------------------------------------
------------------oSoSo-----------------------------------------------------------------------oSS------------------------------------------------------------------------------------------oooooo-------
--------------------------------------oooo--------------------------------------------------------------------------------------------------------------------------------------------------------------
--------------------ooo----------------------------------------------oSooSooo---------oSSo-----ooo-----------------------------------------------------------------ooooo---------------------oooo-------
--------------------g--g------------ooooooo-----oo-------------Soo--------------------------g--rk-k-----------------------------ooo-----ooSSooo----oo--------------K--------------ooS-----kk--R---------
------------XXXXXXXXXXXXXX------------------------k-------------------oooooo---oo----------XXXXXXXXX----------------------------------------------y-----XXXXXXXXXXXXXXXXX----------------XXXXXXXXX--ooo-
------------XXXXXXXXXXXXXX--------XXXXXXXXXXXXXXXXXX---------ooooo---r--G-k------R---------XXXXXXXXX------XXXXXXXXXX--y---------ooo--------ooo---XXXXXXXXXXXXXXXXXXXXXXXXXXXXX--oooooo---XXXXXXXXX-gG---
XXXXXXXXXXXXXXXXXXXXXXXXXX--y-----XXXXXXXXXXXXXXXXXX------------k---XXXXXXXXXXXXXXXXXXXXXXXXXXXXXXXX---r--XXXXXXXXXXXXXXXX-------yGR-g-----Gr--k-XXXXXXXXXXXXXXXXXXXXXXXXXXXXX-Y-Ky-kK---XXXXXXXXXXXXXXX
XXXXXXXXXXXXXXXXXXXXXXXXXXXXXXXXXXXXXXXXXXXXXXXXXXXXXXXXXXXXXXXXXXXXXXXXXXXXXXXXXXXXXXXXXXXXXXXXXXXXXXXXXXXXXXXXXXXXXXXXXXXXXXXXXXXXXXXXXXXXXXXXXXXXXXXXXXXXXXXXXXXXXXXXXXXXXXXXXXXXXXXXXXXXXXXXXXXXXXXX

