--------------------------------------------------------------------------------------------------------------------------------------------------------------------------------------------------------
--------------------------------------------------------------------------------------------------------------------------------------------------------------------------------------------------------
--------------------------------------------------------------------------------------------------------------------------------------------------------------------------------------------------------
--------------------------------------------------------------------------------------------------------------------------------------------------------------------------------------------------------
--------------------------------------------------------------------------------------------------------------------------------------------------------------------------------------------------------
--------------------------------------------------------------------------------------------------------------------------------------------------------------------------------------------------------
--------------------------------------------------------------------------------------------------------------------------------------------------------------------------------------------------------
--------------------------------------------------------------------------------------------------------------------------------------------------------------------------------------------------------
--------------------------------------------------------------------------------------------------------------------------------------------------------------------------------------------------------
--------------------------------------------------------------------------------------------------------------------------------------------------------------------------------------------------------
--------------------------------------------------------------------------------------------------------------------------------------------------------------------------------------------------------
--------------------------------------------------------------------------------------------------------------------------------------------------------------------------------------------------------
--------------------------ooooooo------------------------------------oSooo--------oSSS--------SSSooo------------------------oooooooo---oooSS------------------------------------------------------------
------------------------------------SooSoSo------------------------------------------------------------ooSSoo------------------------------------------------oooooo--------------------------------Tt---
--------------------------ooooooo------------------------------oSo----------------------------ooooo----------------oooooo--ooooooo----oooooo------oSoo-----------------------------------oo---Tt---Tt---
--------------Y--G-------y--gY-----ooooo----------------------------gy--K-----------Gr--------G--------ooo---------R-r--------g-g-y---rr---G--k--------------ooooo----------------------gg----Tt---Tt---
-------------XXXXXXX----XXXXXXXXXX-------g----------------r---oooo-XXXXXXXX------XXXXXXX---XXXXXXXXXX--y--R---XX--XXXXXXXXXXXXXXXXXXXXXXXXXXXXXX----------k---------XXXXX--------------XXXXXXXXXXXXXXXXX
-------------XXXXXXXXXXXXXXXXXXXXXXXXXXXXXXX----------XXXXXX----ky-XXXXXXXX-r----XXXXXXX---XXXXXXXXXXXXXXXXXXXXX--XXXXXXXXXXXXXXXXXXXXXXXXXXXXXX---g-G---XXXXXXXXXXXXXXXX---------XXXXXXXXXXXXXXXXXXXXXX
XXXXXXXXXXXXXXXXXXXXXXXXXXXXXXXXXXXXXXXXXXXX---GR-XXXXXXXXXXXXXXXXXXXXXXXXXXXXXXXXXXXXXX---XXXXXXXXXXXXXXXXXXXXXXXXXXXXXXXXXXXXXXXXXXXXXXXXXXXXXXXXXXXXXXXXXXXXXXXXXXXXXX---------XXXXXXXXXXXXXXXXXXXXXX
XXXXXXXXXXXXXXXXXXXXXXXXXXXXXXXXXXXXXXXXXXXXXXXXXXXXXXXXXXXXXXXXXXXXXXXXXXXXXXXXXXXXXXXXXXXXXXXXXXXXXXXXXXXXXXXXXXXXXXXXXXXXXXXXXXXXXXXXXXXXXXXXXXXXXXXXXXXXXXXXXXXXXXXXXXXXXXXXXXXXXXXXXXXXXXXXXXXXXXXX

