--------------------------------------------------------------------------------------------------------------------------------------------------------------------------------------------------------
--------------------------------------------------------------------------------------------------------------------------------------------------------------------------------------------------------
--------------------------------------------------------------------------------------------------------------------------------------------------------------------------------------------------------
--------------------------------------------------------------------------------------------------------------------------------------------------------------------------------------------------------
--------------------------------------------------------------------------------------------------------------------------------------------------------------------------------------------------------
--------------------------------------------------------------------------------------------------------------------------------------------------------------------------------------------------------
--------------------------------------------------------------------------------------------------------------------------------------------------------------------------------------------------------
--------------------------------------------------------------------------------------------------------------------------------------------------------------------------------------------------------
--------------------------------------------------------------------------------------------------------------------------------------------------------------------------------------------------------
--------------------------------------------------------------------------------------------------------------------------------------------------------------------------------------------------------
--------------------------------------------------------------------------------------------------------------------------------------------------------------------------------------------------------
--------------------------------------------------------------------------------------------------------------------------------------------------------------------------------------------------------
----------------------------------oooo--------------------------------------------------------------Soo--------------SoSooo---------------------ooS-----------------------------------oSoo--------------
-------------------------------------------------------------------------Soo--------ooooSSooo-------------oSSo------------------------------------------------------------------------------------------
--------------oooo---------------oooo--------------------------------------------------------------------------------ooooo----------------------oooo------------------------oooooooo----ooo-------------
-----------------------oSo-----------R----oSoo---------------------------ooo--------ooooooooo-------------ooo-----g---y--rr-------------oooo-----R---------------oooo-------Y---g------kYkk-------------
---------------oo-------------XXXXXXXXX--------XXXXXXXXXXXXXXXXXX-----------r-XXXXX--y-----g-----XXXXXXXX--------XXXXXXXXXXX-------------------XXXXXXXX---XXX--------------XXXXXXXXXXXXXXXXX------------
-------------Y--------ooooo---XXXXXXXXX----ooo-XXXXXXXXXXXXXXXXXXXXXXXXXXXXXXXXXXXXXXXXXXXXXXXXXXXXXXXXXXXXXXXXXXXXXXXXXXXXX---ooo---ooooooooo-XXXXXXXX---XXX--ooooooo-----XXXXXXXXXXXXXXXXX-oo---------
-----------XXXXXXXX--------Y--XXXXXXXXX---gry--XXXXXXXXXXXXXXXXXXXXXXXXXXXXXXXXXXXXXXXXXXXXXXXXXXXXXXXXXXXXXXXXXXXXXXXXXXXXX-Kk-g-k--G-yk-k--g-XXXXXXXX---XXX-kKY---R-y----XXXXXXXXXXXXXXXXX-----y------
XXXXXXXXXXXXXXXXXXXXXXXXXXXXXXXXXXXXXXXXXXXXXXXXXXXXXXXXXXXXXXXXXXXXXXXXXXXXXXXXXXXXXXXXXXXXXXXXXXXXXXXXXXXXXXXXXXXXXXXXXXXXXXXXXXXXXXXXXXXXXXXXXXXXXXXXXXXXXXXXXXXXXXXXXXXXXXXXXXXXXXXXXXXXXXXXXXXXXXXX

