--------------------------------------------------------------------------------------------------------------------------------------------------------------------------------------------------------
--------------------------------------------------------------------------------------------------------------------------------------------------------------------------------------------------------
--------------------------------------------------------------------------------------------------------------------------------------------------------------------------------------------------------
--------------------------------------------------------------------------------------------------------------------------------------------------------------------------------------------------------
--------------------------------------------------------------------------------------------------------------------------------------------------------------------------------------------------------
--------------------------------------------------------------------------------------------------------------------------------------------------------------------------------------------------------
--------------------------------------------------------------------------------------------------------------------------------------------------------------------------------------------------------
--------------------------------------------------------------------------------------------------------------------------------------------------------------------------------------------------------
--------------------------------------------------------------------------------------------------------------------------------------------------------------------------------------------------------
--------------------------------------------------------------------------------------------------------------------------------------------------------------------------------------------------------
--------------------------------------------------------------------------------------------------------------------------------------------------------------------------------------------------------
--------------------------------------------------------------------------------------------------------------------------------------------------------------------------------------------------------
--------------------------------------oSoo------------------------------------------------------------------------------------------------------------------------------------oSo-----------------------
--------------------ooSSS------------------------------------------------------------------------------SSS-----------------------------------SoSo-----------ooo------Soooo------------------------------
--------------------------------------ooo-------------ooSooo------------------------------------------------------------------------------------------------------------------ooo------------ooo--------
--------------------oooo----------------yYk---------------------------------Soo----------------Sooo-----ooo--------------ooSoSo--ooooS---------oo-----Sooo---oo-----oooo--------rg----ooo---yR-r--------
----------------------------XXXXX---XXXXXXXX----------ooooooo-------R-XXXX----------oooooo------------rY--y----------------------------------KG--------------Gg------------XXXXXXXXX---g---XXXXXXXXX----
XXXXXXXXXXXXX-----XXXXXXXXXXXXXXX---XXXXXXXX-----XXXX---r---G-y-XXXXXXXXXX-oooooo----k--y-----ooo---XXXXXXXX------------oooooo---ooooo-----XXXXXXX--ooo----XXXXXXXXXXXXXXXXXXXXXXXXXXXXXXXXXXXXXXXXX----
XXXXXXXXXXXXX-----XXXXXXXXXXXXXXX---XXXXXXXX-----XXXXXXXXXXXXXXXXXXXXXXXXX--G---R--XXXXXXXXX-----Ry-XXXXXXXXXXXX----g--------g--------ky---XXXXXXX---g-r---XXXXXXXXXXXXXXXXXXXXXXXXXXXXXXXXXXXXXXXXX----
XXXXXXXXXXXXXXXXXXXXXXXXXXXXXXXXXXXXXXXXXXXXXXXXXXXXXXXXXXXXXXXXXXXXXXXXXXXXXXXXXXXXXXXXXXXXXXXXXXXXXXXXXXXXXXXXXXXXXXXXXXXXXXXXXXXXXXXXXXXXXXXXXXXXXXXXXXXXXXXXXXXXXXXXXXXXXXXXXXXXXXXXXXXXXXXXXXXXXXXX

