--------------------------------------------------------------------------------------------------------------------------------------------------------------------------------------------------------
--------------------------------------------------------------------------------------------------------------------------------------------------------------------------------------------------------
--------------------------------------------------------------------------------------------------------------------------------------------------------------------------------------------------------
--------------------------------------------------------------------------------------------------------------------------------------------------------------------------------------------------------
--------------------------------------------------------------------------------------------------------------------------------------------------------------------------------------------------------
--------------------------------------------------------------------------------------------------------------------------------------------------------------------------------------------------------
--------------------------------------------------------------------------------------------------------------------------------------------------------------------------------------------------------
--------------------------------------------------------------------------------------------------------------------------------------------------------------------------------------------------------
--------------------------------------------------------------------------------------------------------------------------------------------------------------------------------------------------------
--------------------------------------------------------------------------------------------------------------------------------------------------------------------------------------------------------
--------------------------------------------------------------------------------------------------------------------------------------------------------------------------------------------------------
--------------------------------------------------------------------------------------------------------------------------------------------------------------------------------------------------------
------------------------------------------------------------------------------------------------------Sooo------------------ooooooS------------------------------------ooSSSS--------------SoSSoo-------
--------------------------------------ooo------------------------------------------------------------------------------------------------------------oSSo-----oooo--------------------------------------
-----------------------------------------------------------------------------------oooooo------------oooo-------------------oooooo----------------------------------------oo-------------oooooo---------
--------------oooo--------------------------------------------------------------------K------------k---G--k--------ooSoS----Y-------------------------oooo------ooooo---gR---K-------------Gy-----------
XXXXXXXXXXXXX---------------------------y---------XXX--------------------XXX-----XXXXXXXXX--------XXXXXXXXXX---------------XXXXXXXXXX------------------yR-----g-yR--k-XXXXXXXXXX-ooo--XXXXXXXXXXXXX-----
XXXXXXXXXXXXX--oooo-------ooo-XXXXX--XXXXXXXXX----XXX------------------r-XXX-----XXXXXXXXX--------XXXXXXXXXX--------oooooo-XXXXXXXXXXXXX-y-----XXXXXXXXXXXXXXXXXXXXXXXXXXXXXXXXX--k-g-XXXXXXXXXXXXXXXXXX
XXXXXXXXXXXXX---r-y----krY----XXXXX--XXXXXXXXX----XXX----XXXXX----XXXXXXXXXX-----XXXXXXXXXXXXXXXXXXXXXXXXXXX---------gg----XXXXXXXXXXXXXXXXXXXXXXXXXXXXXXXXXXXXXXXXXXXXXXXXXXXXXXXXXXXXXXXXXXXXXXXXXXXXX
XXXXXXXXXXXXXXXXXXXXXXXXXXXXXXXXXXXXXXXXXXXXXXXXXXXXXXXXXXXXXXXXXXXXXXXXXXXXXXXXXXXXXXXXXXXXXXXXXXXXXXXXXXXXXXXXXXXXXXXXXXXXXXXXXXXXXXXXXXXXXXXXXXXXXXXXXXXXXXXXXXXXXXXXXXXXXXXXXXXXXXXXXXXXXXXXXXXXXXXX

