--------------------------------------------------------------------------------------------------------------------------------------------------------------------------------------------------------
--------------------------------------------------------------------------------------------------------------------------------------------------------------------------------------------------------
--------------------------------------------------------------------------------------------------------------------------------------------------------------------------------------------------------
--------------------------------------------------------------------------------------------------------------------------------------------------------------------------------------------------------
--------------------------------------------------------------------------------------------------------------------------------------------------------------------------------------------------------
--------------------------------------------------------------------------------------------------------------------------------------------------------------------------------------------------------
--------------------------------------------------------------------------------------------------------------------------------------------------------------------------------------------------------
--------------------------------------------------------------------------------------------------------------------------------------------------------------------------------------------------------
--------------------------------------------------------------------------------------------------------------------------------------------------------------------------------------------------------
--------------------------------------------------------------------------------------------------------------------------------------------------------------------------------------------------------
--------------------------------------------------------------------------------------------------------------------------------------------------------------------------------------------------------
--------------------------------------------------------------------------------------------------------------------------------------------------------------------------------------------------------
-------------------------------oooSS-----oooo----------------------------------------------------------------------------------------------------oSoS------SoSSoo-----------ooooSS----------------------
--------------------ooSSooo---------------------------------------------------oSoSooSSo-------------------------------------------ooSoS-----------------------------------------------------------------
---------------------------------------oooo--------------------------oSooooo-------------------------------------ooSoooSSo-----------------------ooooo----oooooo---------------ooo----------------------
----------------------ooo------ry-y-------r------------------------------------ooooooo----------oSoo------------------------------oooooo--------Yk---------Yg---------------r-r-------------------------
XXXXXXXXXXXXX---------Y--yk-XXXXXXXXXXXXXXXXXX--XXXXXX----------------oooo------------k------R---------------XXX--ooooooo----r-----------------XXXXXXXXXXXXXXXXXXXX--------XXXXXXXXXX----------ooooo----
XXXXXXXXXXXXX-----XXXXXXXXXXXXXXXXXXXXXXXXXXXXXXXXXXXX---------------y---y-r-XXXXXXXXXXXXXXXXXX----oooo------XXX---rKy--gr-XXXXXXXXXXXXXXXXXXXXXXXXXXXXXXXXXXXXXXXX----oo--XXXXXXXXXX----XXXXX----Ky----
XXXXXXXXXXXXXXXXXXXXXXXXXXXXXXXXXXXXXXXXXXXXXXXXXXXXXX----r----G----XXXXXXXXXXXXXXXXXXXXXXXXXXX-----Y--------XXXXXXXXXXXXXXXXXXXXXXXXXXXXXXXXXXXXXXXXXXXXXXXXXXXXXX----k---XXXXXXXXXX----XXXXXXXXXXXXXXX
XXXXXXXXXXXXXXXXXXXXXXXXXXXXXXXXXXXXXXXXXXXXXXXXXXXXXXXXXXXXXXXXXXXXXXXXXXXXXXXXXXXXXXXXXXXXXXXXXXXXXXXXXXXXXXXXXXXXXXXXXXXXXXXXXXXXXXXXXXXXXXXXXXXXXXXXXXXXXXXXXXXXXXXXXXXXXXXXXXXXXXXXXXXXXXXXXXXXXXXX

