--------------------------------------------------------------------------------------------------------------------------------------------------------------------------------------------------------
--------------------------------------------------------------------------------------------------------------------------------------------------------------------------------------------------------
--------------------------------------------------------------------------------------------------------------------------------------------------------------------------------------------------------
--------------------------------------------------------------------------------------------------------------------------------------------------------------------------------------------------------
--------------------------------------------------------------------------------------------------------------------------------------------------------------------------------------------------------
--------------------------------------------------------------------------------------------------------------------------------------------------------------------------------------------------------
--------------------------------------------------------------------------------------------------------------------------------------------------------------------------------------------------------
--------------------------------------------------------------------------------------------------------------------------------------------------------------------------------------------------------
--------------------------------------------------------------------------------------------------------------------------------------------------------------------------------------------------------
--------------------------------------------------------------------------------------------------------------------------------------------------------------------------------------------------------
--------------------------------------------------------------------------------------------------------------------------------------------------------------------------------------------------------
--------------------------------------------------------------------------------------------------------------------------------------------------------------------------------------------------------
------------------------------------Sooooo-------------------------------ooSoSSoo------------------------------------------ooSoooSo-------------ooSoSSS-------------------------------------------------
-----------------------------------------------------------------------------------oooo-----------------------------------------------------------------------------------------------------------------
------------------------------------oooooo------------------ooooo----------ooooo-----------oSSoo----------------------------ooooo-------SSSo-------oooooo-----------oooS--------oSoSS-------------------
---------------------------------------rk-k-------------------------------y----------------------------------R------------Y--rr-g-r--------------yK--G------------------------------------oSSSo---------
--------------XXX-----------------XXXXXXXXXX----oo----------oo----------XXXXXXXXXX-R-k----ooooooo-------y---XXXXXXX------XXXXXXXXXXX----ooo----XXXXXXXXXXX---XX-----ooooo-------oooo--------------------
XXXXXXXXXXXXXXXXX------ooooo---XXXXXXXXXXXXX----Rr---oooo-----G---------XXXXXXXXXXXXXXXXX-g-----------XXXXXXXXXXXXX------XXXXXXXXXXX-y---------XXXXXXXXXXXXXXXX-------k---------K----k--oooooo----------
XXXXXXXXXXXXXXXXXXXXXX----Kk-XXXXXXXXXXXXXXXXXXXXXXX-r-kYr-XXXXXXX---y--XXXXXXXXXXXXXXXXXXXXXXXXXX----XXXXXXXXXXXXXXXXXXXXXXXXXXXXXXXXXXXXXXXXXXXXXXXXXXXXXXXXXXXXXXXXXXXXXXXXXXXXXXXXX------r-R---Gr-g-
XXXXXXXXXXXXXXXXXXXXXXXXXXXXXXXXXXXXXXXXXXXXXXXXXXXXXXXXXXXXXXXXXXXXXXXXXXXXXXXXXXXXXXXXXXXXXXXXXXXXXXXXXXXXXXXXXXXXXXXXXXXXXXXXXXXXXXXXXXXXXXXXXXXXXXXXXXXXXXXXXXXXXXXXXXXXXXXXXXXXXXXXXXXXXXXXXXXXXXXX

