--------------------------------------------------------------------------------------------------------------------------------------------------------------------------------------------------------
--------------------------------------------------------------------------------------------------------------------------------------------------------------------------------------------------------
--------------------------------------------------------------------------------------------------------------------------------------------------------------------------------------------------------
--------------------------------------------------------------------------------------------------------------------------------------------------------------------------------------------------------
--------------------------------------------------------------------------------------------------------------------------------------------------------------------------------------------------------
--------------------------------------------------------------------------------------------------------------------------------------------------------------------------------------------------------
--------------------------------------------------------------------------------------------------------------------------------------------------------------------------------------------------------
--------------------------------------------------------------------------------------------------------------------------------------------------------------------------------------------------------
--------------------------------------------------------------------------------------------------------------------------------------------------------------------------------------------------------
--------------------------------------------------------------------------------------------------------------------------------------------------------------------------------------------------------
--------------------------------------------------------------------------------------------------------------------------------------------------------------------------------------------------------
--------------------------------------------------------------------------------------------------------------------------------------------------------------------------------------------------------
-------------------------------------------------------*------------------------------------------oSooSoo----------------------ooSooSoo-----------------------------------------------------------------
---------------------------ooSSoS----------------------*-------------------------------------------------------------------------------------------------------------------------------------SSooSo-----
-------------------------------------------------------*--*--------------------------------------oooooo-------------------------ooooo----ooSSoSo---------------------------ooo-------ooo----------------
----------------------------ooooooo--------------G-----*--*----------ooSoo-------K------------------k--------*-----ooo-------------y----------------------------------------------------------ooooooo---
-----------ooooo-XX-----------rr-Y-r-----------XXXXXXXXXXXXXXXXX----------------XXXXXXXXXXXX--XXXXXXXXXXXX---*--y--K--y-XXXXXXXXXXXXXXXX----ooo----XXXX------Rk-y--XXXXX--------------------kr----r---XX
-----------R-----XX-------XXXXXXXXXXX-oooo-XXXXXXXXXXXXXXXXXXXXX-----oooo-------XXXXXXXXXXXX--XXXXXXXXXXXXXX-*-XXXXXXXXXXXXXXXXXXXXXXXXX-------r-XXXXXX-----XXXXXXXXXXXX--r----------K--RG-XXXXXXXXXXXXX
----------XXXXXXXXX-------XXXXXXXXXXX-gy---XXXXXXXXXXXXXXXXXXXXX--*------k------XXXXXXXXXXXX--XXXXXXXXXXXXXX-*-XXXXXXXXXXXXXXXXXXXXXXXXXXXXXXXXXXXXXXXXXXXXXXXXXXXXXXXXXXXXXXXX-----XXXXXXXXXXXXXXXXXXXX
XXXXXXXXXXXXXXXXXXXXXXXXXXXXXXXXXXXXXXXXXXXXXXXXXXXXXXXXXXXXXXXXXXXXXXXXXXXXXXXXXXXXXXXXXXXX--XXXXXXXXXXXXXXXXXXXXXXXXXXXXXXXXXXXXXXXXXXXXXXXXXXXXXXXXXXXXXXXXXXXXXXXXXXXXXXXXXXXXXXXXXXXXXXXXXXXXXXXXXX

