--------------------------------------------------------------------------------------------------------------------------------------------------------------------------------------------------------
--------------------------------------------------------------------------------------------------------------------------------------------------------------------------------------------------------
--------------------------------------------------------------------------------------------------------------------------------------------------------------------------------------------------------
--------------------------------------------------------------------------------------------------------------------------------------------------------------------------------------------------------
--------------------------------------------------------------------------------------------------------------------------------------------------------------------------------------------------------
--------------------------------------------------------------------------------------------------------------------------------------------------------------------------------------------------------
--------------------------------------------------------------------------------------------------------------------------------------------------------------------------------------------------------
--------------------------------------------------------------------------------------------------------------------------------------------------------------------------------------------------------
--------------------------------------------------------------------------------------------------------------------------------------------------------------------------------------------------------
--------------------------------------------------------------------------------------------------------------------------------------------------------------------------------------------------------
--------------------------------------------------------------------------------------------------------------------------------------------------------------------------------------------------------
--------------------------------------------------------------------------------------------------------------------------------------------------------------------------------------------------------
------------------------------------oSSo----------------------------oooo---------------------------------------------------------------------------------oSo----------------------------ooo-------------
-------------oooooooo----------------------------------oooooS---------------------------ooooooS---------------------------------------ooo---------------------------------------------------------------
----------------------------------ooo------ooo----------------------ooo----------------------------SoSSS-------------------------------------------------oo------------------------------ooo------------
-------------oooooo----------------R--kK------------------ooooo------Gkgy------SSSo-------oooooo--------------------ooo-------ooo----ooooo-----------------G------oSSSS-------k-Y------K-K-gg-----------
------------rkkg--G---XXXXXXXX---XXXXXXXX--ooooo----------------XXXXXXXXXX-------------r-----------ooo-------g-k------r------------g--y--k-y-------k-XXXXXXXXXX----------XXXXXXXXX----XXXXXXXXX--ky---k-
-----------XXXXXXXXXXXXXXXXXXX---XXXXXXXX-G-Y---------XXXXXXXXXXXXXXXXXXXX----oooo----XXXXXXXXXXX--K--k---XXXXXXXXXXXXXXXXXXXXXXXXXXXXXXXXXXX--XXXXXXXXXXXXXXXX--oooo----XXXXXXXXX----XXXXXXXXXXXXXXXXXX
XXXXXXXXXXXXXXXXXXXXXXXXXXXXXXXXXXXXXXXXXXXXXXXXXXXXXXXXXXXXXXXXXXXXXXXXXX---y--g--g--XXXXXXXXXXXXXXXXXXXXXXXXXXXXXXXXXXXXXXXXXXXXXXXXXXXXXXX--XXXXXXXXXXXXXXXX-YR-------XXXXXXXXXXXXXXXXXXXXXXXXXXXXXXX
XXXXXXXXXXXXXXXXXXXXXXXXXXXXXXXXXXXXXXXXXXXXXXXXXXXXXXXXXXXXXXXXXXXXXXXXXXXXXXXXXXXXXXXXXXXXXXXXXXXXXXXXXXXXXXXXXXXXXXXXXXXXXXXXXXXXXXXXXXXXXXXXXXXXXXXXXXXXXXXXXXXXXXXXXXXXXXXXXXXXXXXXXXXXXXXXXXXXXXXX

