--------------------------------------------------------------------------------------------------------------------------------------------------------------------------------------------------------
--------------------------------------------------------------------------------------------------------------------------------------------------------------------------------------------------------
--------------------------------------------------------------------------------------------------------------------------------------------------------------------------------------------------------
--------------------------------------------------------------------------------------------------------------------------------------------------------------------------------------------------------
--------------------------------------------------------------------------------------------------------------------------------------------------------------------------------------------------------
--------------------------------------------------------------------------------------------------------------------------------------------------------------------------------------------------------
--------------------------------------------------------------------------------------------------------------------------------------------------------------------------------------------------------
--------------------------------------------------------------------------------------------------------------------------------------------------------------------------------------------------------
--------------------------------------------------------------------------------------------------------------------------------------------------------------------------------------------------------
--------------------------------------------------------------------------------------------------------------------------------------------------------------------------------------------------------
--------------------------------------------------------------------------------------------------------------------------------------------------------------------------------------------------------
--------------------------------------------------------------------------------------------------------------------------------------------------------------------------------------------------------
-------------------------------oooS--------------------------------------------------oooSoS--------------------ooSSo---------------------------------------------------------------------oSoSoo---------
----------------------------------------------------------SSooo--------------------------------------------------------------------------------------------------------------oSoo-----------------------
-----------------ooS------ooo--oooo---------------------------------ooooo------------ooooooo-------------------oooo-------------------Soo------------------------------------------------ooo------------
--------------------------------r-----------------------oooo----------------------------G-r---------ooooo-----y--r-g-------Soooo-----------------ooo--------------------------------------Y-gR----------
-------------------ooo----ooo-XXXXXXXX---------------------K--R--------ooo----XXXXXXXXXXXXXXX---XXX-yy-g-g-XXXXXXXXXX------------------oo--------------XXXXXXXXXX------------r----------XXXXXXXX--------
XXXXXXXXXXX------y-------R----XXXXXXXX--------------oo-XXXXXXXXX-----gggkYg-XXXXXXXXXXXXXXXXX---XXXXXXXXXXXXXXXXXXXXXXXXX----oooooo-------k---oooooo---XXXXXXXXXXXXXXXXXXXXXXXXXXX------XXXXXXXX-ooo----
XXXXXXXXXXX-----XXXXXXXXXXXXXXXXXXXXXX--XXXXXXXXX-rG-y-XXXXXXXXXXXXXXXXXXXXXXXXXXXXXXXXXXXXXX---XXXXXXXXXXXXXXXXXXXXXXXXX--gyg--r---XXXXXXXXX-R--r--k--XXXXXXXXXXXXXXXXXXXXXXXXXXX--Rg--XXXXXXXX------y-
XXXXXXXXXXXXXXXXXXXXXXXXXXXXXXXXXXXXXXXXXXXXXXXXXXXXXXXXXXXXXXXXXXXXXXXXXXXXXXXXXXXXXXXXXXXXXXXXXXXXXXXXXXXXXXXXXXXXXXXXXXXXXXXXXXXXXXXXXXXXXXXXXXXXXXXXXXXXXXXXXXXXXXXXXXXXXXXXXXXXXXXXXXXXXXXXXXXXXXXX

