--------------------------------------------------------------------------------------------------------------------------------------------------------------------------------------------------------
--------------------------------------------------------------------------------------------------------------------------------------------------------------------------------------------------------
--------------------------------------------------------------------------------------------------------------------------------------------------------------------------------------------------------
--------------------------------------------------------------------------------------------------------------------------------------------------------------------------------------------------------
--------------------------------------------------------------------------------------------------------------------------------------------------------------------------------------------------------
--------------------------------------------------------------------------------------------------------------------------------------------------------------------------------------------------------
--------------------------------------------------------------------------------------------------------------------------------------------------------------------------------------------------------
--------------------------------------------------------------------------------------------------------------------------------------------------------------------------------------------------------
--------------------------------------------------------------------------------------------------------------------------------------------------------------------------------------------------------
--------------------------------------------------------------------------------------------------------------------------------------------------------------------------------------------------------
--------------------------------------------------------------------------------------------------------------------------------------------------------------------------------------------------------
--------------------------------------------------------------------------------------------------------------------------------------------------------------------------------------------------------
---------------------------------------------------------------------oSo------------------------------------------------SoSooo----------------------------------oSSoSo----------ooS-----SSoo------------
------------oSoooSoo-----------------------------------------------------------------------------------------------------------------------------------SSSS---------------------------------------------
----------------------ooSoo----oSoSoS-------------------------------oooo-----ooSo----------------------------------------oooo--------------------------------------oooooo-------ooooo----oo-------------
-------------ooooooo--------------------------ooooooo---------------K---k-k------------ooo--oSoo-------------------------r---g-y--oSoooo----------------ooooo-----K---k-R-----k---g-k-------kk----------
----------------r--Y---ooooo----oooo----------------------XXXX-----XXXXXXXXX--oooo---rK----------XXX-------XXXXX------XXXXXXXXXXX-----------XXXX-----R-yy-ykkg-XXXXXXXXXXXXXXXXXXXXXXXXXXXXXXXX---------
XXXXXXXXXXXXXXXXXXXXX--y---y--k-k-r----XXXXX----oooo--XXXXXXXXXXXXXXXXXXXXXX---k-G-XXXXXXXX-oo---XXXXXXXXXXXXXXX------XXXXXXXXXXX--oooooo---XXXXXXXXXXXXXXXXXXXXXXXXXXXXXXXXXXXXXXXXXXXXXXXXXXX--XXXXX--
XXXXXXXXXXXXXXXXXXXXXXXXXXXXXXXXXXXXXXXXXXXX--R-kgk-K-XXXXXXXXXXXXXXXXXXXXXXXXXXXXXXXXXXXXX-y----XXXXXXXXXXXXXXX--GRK-XXXXXXXXXXX----y-r-G--XXXXXXXXXXXXXXXXXXXXXXXXXXXXXXXXXXXXXXXXXXXXXXXXXXX--XXXXXXX
XXXXXXXXXXXXXXXXXXXXXXXXXXXXXXXXXXXXXXXXXXXXXXXXXXXXXXXXXXXXXXXXXXXXXXXXXXXXXXXXXXXXXXXXXXXXXXXXXXXXXXXXXXXXXXXXXXXXXXXXXXXXXXXXXXXXXXXXXXXXXXXXXXXXXXXXXXXXXXXXXXXXXXXXXXXXXXXXXXXXXXXXXXXXXXXXXXXXXXXX

