--------------------------------------------------------------------------------------------------------------------------------------------------------------------------------------------------------
--------------------------------------------------------------------------------------------------------------------------------------------------------------------------------------------------------
--------------------------------------------------------------------------------------------------------------------------------------------------------------------------------------------------------
--------------------------------------------------------------------------------------------------------------------------------------------------------------------------------------------------------
--------------------------------------------------------------------------------------------------------------------------------------------------------------------------------------------------------
--------------------------------------------------------------------------------------------------------------------------------------------------------------------------------------------------------
--------------------------------------------------------------------------------------------------------------------------------------------------------------------------------------------------------
--------------------------------------------------------------------------------------------------------------------------------------------------------------------------------------------------------
--------------------------------------------------------------------------------------------------------------------------------------------------------------------------------------------------------
--------------------------------------------------------------------------------------------------------------------------------------------------------------------------------------------------------
--------------------------------------------------------------------------------------------------------------------------------------------------------------------------------------------------------
--------------------------------------------------------------------------------------------------------------------------------------------------------------------------------------------------------
--------------------------------oSo------------------------------oSSS----------------------------------------------------------------------------ooSo---------------------------------------------------
----------------------------------------ooo------------------------------------------------------------------oSooSoo------------------------------------------------------------------------oooSSo------
-------------ooooSSoSo----------ooo-----------------------------ooo-------------oo--------------------------------------oSSoo--------------oSSo-----ooo---oooooo---------------oooSoooo-----------------
------------------------------------------oo-----ooo----g-----k-ryk-------------G---------------ooS-------------ooo-----------------y-------------gk-Y-----Y-r-----------------------------ooooo--------
XXXXXXXXXXXX--oooooo------XXXXXXXXXXXX----g-g---------XXXXXXXXXXXXXXXXX-----XXXXXXX-----------------------------------oooooooo--XXXXXXX--ooo----XXXXXXXXXXXXXXXXX---------------oooooo-----g----G-------
XXXXXXXXXXXX-R-g-----Y-XXXXXXXXXXXXXXXXXXXXXXXX---oo--XXXXXXXXXXXXXXXXX---XXXXXXXXX--ooooo----ooooooo--XXXXXXXXXXXXXX--k-----R--XXXXXXX------yR-XXXXXXXXXXXXXXXXX---------XXXX----y-y----XXXXXXXXXXXXXXX
XXXXXXXXXXXXXXXXXXXXXXXXXXXXXXXXXXXXXXXXXXXXXXX-k-g-y-XXXXXXXXXXXXXXXXX---XXXXXXXXX-k--------------KKk-XXXXXXXXXXXXXXXXXXXXXXXXXXXXXXXXXXXXXXXXXXXXXXXXXXXXXXXXXXXXXXXXXXXXXXXXXXXXXXXXXXXXXXXXXXXXXXXXX
XXXXXXXXXXXXXXXXXXXXXXXXXXXXXXXXXXXXXXXXXXXXXXXXXXXXXXXXXXXXXXXXXXXXXXXXXXXXXXXXXXXXXXXXXXXXXXXXXXXXXXXXXXXXXXXXXXXXXXXXXXXXXXXXXXXXXXXXXXXXXXXXXXXXXXXXXXXXXXXXXXXXXXXXXXXXXXXXXXXXXXXXXXXXXXXXXXXXXXXX

