--------------------------------------------------------------------------------------------------------------------------------------------------------------------------------------------------------
--------------------------------------------------------------------------------------------------------------------------------------------------------------------------------------------------------
--------------------------------------------------------------------------------------------------------------------------------------------------------------------------------------------------------
--------------------------------------------------------------------------------------------------------------------------------------------------------------------------------------------------------
--------------------------------------------------------------------------------------------------------------------------------------------------------------------------------------------------------
--------------------------------------------------------------------------------------------------------------------------------------------------------------------------------------------------------
--------------------------------------------------------------------------------------------------------------------------------------------------------------------------------------------------------
--------------------------------------------------------------------------------------------------------------------------------------------------------------------------------------------------------
--------------------------------------------------------------------------------------------------------------------------------------------------------------------------------------------------------
--------------------------------------------------------------------------------------------------------------------------------------------------------------------------------------------------------
--------------------------------------------------------------------------------------------------------------------------------------------------------------------------------------------------------
--------------------------------------------------------------------------------------------------------------------------------------------------------------------------------------------------------
------------------------------------------------------------------------------------------------------------------------------------ooooo---------------------------------------------------------------
--------------oSoSSSooo------------------------------------------------------------------------------------------------------------------------------------------------------------------------oooo-----
----------------------------oSooSSo---------------------------------------------------------------------------------ooooo-------------------------------------------------------------------------------
----------------oooo-------------------oo-----oSoooooo----------------------------------------oSSoSoo---ooSSo--------R---------------R-----------oooSooSo----SSo------------------------------oo--------
----------------g--yRk------ooooo-----y--------------------------------------------XXXXX-------------------------XXXXXXXXX--------XXXXXXXXXX--------------------------------XX--------------kY-yyg------
-------------XXXXXXXXXXXXXX----g--k--XXXXXXX----ooo-----------------ooooo-XXXXXXXXXXXXXX-------oooooo---oooooooo-XXXXXXXXX--------XXXXXXXXXX------oooooooo--oooooo-----oooo-XXXXXXXX-------XXXXXXXXXXXXX
-------------XXXXXXXXXXXXXXXXXXXXXXXXXXXXXXX--------Ry--y-y------XX-k-----XXXXXXXXXXXXXX-----------yk------Y--y--XXXXXXXXX--------XXXXXXXXXXXXXX----r-k-----------y--y-k--k-XXXXXXXX--XXXXXXXXXXXXXXXXXX
XXXXXXXXXXXXXXXXXXXXXXXXXXXXXXXXXXXXXXXXXXXXXXXXXXXXXXXXXXXXXXXXXXXXXXXXXXXXXXXXXXXXXXXXXXXXXXXXXXXXXXXXXXXXXXXXXXXXXXXXXXXXXXXXXXXXXXXXXXXXXXXXXXXXXXXXXXXXXXXXXXXXXXXXXXXXXXXXXXXXXXXXXXXXXXXXXXXXXXXX

