--------------------------------------------------------------------------------------------------------------------------------------------------------------------------------------------------------
--------------------------------------------------------------------------------------------------------------------------------------------------------------------------------------------------------
--------------------------------------------------------------------------------------------------------------------------------------------------------------------------------------------------------
--------------------------------------------------------------------------------------------------------------------------------------------------------------------------------------------------------
--------------------------------------------------------------------------------------------------------------------------------------------------------------------------------------------------------
--------------------------------------------------------------------------------------------------------------------------------------------------------------------------------------------------------
--------------------------------------------------------------------------------------------------------------------------------------------------------------------------------------------------------
--------------------------------------------------------------------------------------------------------------------------------------------------------------------------------------------------------
--------------------------------------------------------------------------------------------------------------------------------------------------------------------------------------------------------
--------------------------------------------------------------------------------------------------------------------------------------------------------------------------------------------------------
--------------------------------------------------------------------------------------------------------------------------------------------------------------------------------------------------------
--------------------------------------------------------------------------------------------------------------------------------------------------------------------------------------------------------
------------------------------------------------------------------------Sooo----------------------------ooSooo------------------------------------------------------------------------------------------
--------------------------oSS--------------------------------------------------------oSSo---------------------------------------------------------------------------------------------------------------
-----------------------------------Sooo---------------------------------oooooo-------------------ooooo-----ooooo-----------------------------------------------ooooS------------------------oooo--------
--------------oooSoSoo----oo-----------------------------------ooS----y-r--k---------ooooooo------g---------y--r------ooooooo-----------------Y--------oooooo-------------------oo------------rG--------
------------------------r-----k---oo--------XX----------XX-----------XXXXXXXXXXX-----------g----XXXXXXXXXXXXXXXXXXX--------------------------XXXXXX--------------oooo----------------------XXXXXX-------
----------------oooooo-XXXXXXXXX-g--K-------XX-----XX---XX---ooooo---XXXXXXXXXXX--XXXXXXXXXXX---XXXXXXXXXXXXXXXXXXX-ooooooo------------------XXXXXX-------------R--kG-XXXXXXXXXXXXXXX--oo--XXXXXX-------
---------------R----YR-XXXXXXXXXXXXXXXXXXXXXXX-----XXXXXXXXX---g-----XXXXXXXXXXXXXXXXXXXXXXXX---XXXXXXXXXXXXXXXXXXX-Rr---yy---XXX------XXXXXXXXXXXXXXX--------XXXXXXXXXXXXXXXXXXXXXXX--kg--XXXXXX-r-K-k-
XXXXXXXXXXXXXXXXXXXXXXXXXXXXXXXXXXXXXXXXXXXXXXXXXXXXXXXXXXXXXXXXXXXXXXXXXXXXXXXXXXXXXXXXXXXXXXXXXXXXXXXXXXXXXXXXXXXXXXXXXXXXXXXXXXXXXXXXXXXXXXXXXXXXXXXXXXXXXXXXXXXXXXXXXXXXXXXXXXXXXXXXXXXXXXXXXXXXXXXX

