--------------------------------------------------------------------------------------------------------------------------------------------------------------------------------------------------------
--------------------------------------------------------------------------------------------------------------------------------------------------------------------------------------------------------
--------------------------------------------------------------------------------------------------------------------------------------------------------------------------------------------------------
--------------------------------------------------------------------------------------------------------------------------------------------------------------------------------------------------------
--------------------------------------------------------------------------------------------------------------------------------------------------------------------------------------------------------
--------------------------------------------------------------------------------------------------------------------------------------------------------------------------------------------------------
--------------------------------------------------------------------------------------------------------------------------------------------------------------------------------------------------------
--------------------------------------------------------------------------------------------------------------------------------------------------------------------------------------------------------
--------------------------------------------------------------------------------------------------------------------------------------------------------------------------------------------------------
--------------------------------------------------------------------------------------------------------------------------------------------------------------------------------------------------------
--------------------------------------------------------------------------------------------------------------------------------------------------------------------------------------------------------
--------------------------------------------------------------------------------------------------------------------------------------------------------------------------------------------------------
------------------------------------------------------------------------------------------------------------------------------------------------------------------------------------Soo-------oooS------
--------------------------------------------Soooo-----------------------------ooo-----------oooSo-------------------------------------------------------------------------------------------------------
----------------SSoSooo-----------------------------------------------------------------------------------------------------------------------------------------------------------oooooo-------oooo-----
--------------------------------oSSooo-----ooo-----------------------------oooooooo-----------oooo-------------------------------------oo----------------Soo-------------oSSoSo----rg-------R---gy-y----
------------XX----oooo---------------------k----r-------XXXXX---------------------K------XX-RK-------------XX-------------XX------XXX-k-----------------------------------------XXXXXXXXXXXXXXXXXXXXX---
------------XX-y---yk------------oooooo-XXXXXXXXXX------XXXXXXXXX---------XXXXXXXXXXX----XXXXXXXXXXXXX-----XX------oooo---XX-K--g-XXXXXXXXX--------XX---oo----oo---------oooo---XXXXXXXXXXXXXXXXXXXXX---
------------XXXXXXXXXXXXXXXXX-----rY-Y--XXXXXXXXXX-Y-rk-XXXXXXXXXXXXX-----XXXXXXXXXXXXXXXXXXXXXXXXXXXXXXXXXXXXXXXX---k----XXXXXXXXXXXXXXXXXXX------XX---y-kg---RK-----g---GK----XXXXXXXXXXXXXXXXXXXXXXXX
XXXXXXXXXXXXXXXXXXXXXXXXXXXXXXXXXXXXXXXXXXXXXXXXXXXXXXXXXXXXXXXXXXXXXXXXXXXXXXXXXXXXXXXXXXXXXXXXXXXXXXXXXXXXXXXXXXXXXXXXXXXXXXXXXXXXXXXXXXXXXXXXXXXXXXXXXXXXXXXXXXXXXXXXXXXXXXXXXXXXXXXXXXXXXXXXXXXXXXXX

