--------------------------------------------------------------------------------------------------------------------------------------------------------------------------------------------------------
--------------------------------------------------------------------------------------------------------------------------------------------------------------------------------------------------------
--------------------------------------------------------------------------------------------------------------------------------------------------------------------------------------------------------
--------------------------------------------------------------------------------------------------------------------------------------------------------------------------------------------------------
--------------------------------------------------------------------------------------------------------------------------------------------------------------------------------------------------------
--------------------------------------------------------------------------------------------------------------------------------------------------------------------------------------------------------
--------------------------------------------------------------------------------------------------------------------------------------------------------------------------------------------------------
--------------------------------------------------------------------------------------------------------------------------------------------------------------------------------------------------------
--------------------------------------------------------------------------------------------------------------------------------------------------------------------------------------------------------
--------------------------------------------------------------------------------------------------------------------------------------------------------------------------------------------------------
--------------------------------------------------------------------------------------------------------------------------------------------------------------------------------------------------------
--------------------------------------------------------------------------------------------------------------------------------------------------------------------------------------------------------
----------------------------------------ooo-----Soo---------------------------oooSSooo------------------------------------------------------------------------------------------------------------------
--------------------------------------------------------------------------------------------------------------ooooSSo-----------------------------------------------------------------------------------
-------------------oooo-----------------ooo------ooo-----SoSSooo--------------ooooo---------ooSoo------------------------------------oooo-------------ooo-----oooooo---------oooSo----------------------
------------ooooo---rKr-------ooooo-----k-y-k----k-R----------------------------K---y--------------oSSSoSoo--oooooooo-----oooSooo----------oooSoo------r--------------y--Y-------------------------R----
--------------K-r-XXXXXXXXXXX---------XXXXXXXXXXXXXXXXX--ooooo---------------XXXXXXXXXX-----oooo-------------Yy-y-y-----------------ooo-------------XXXXXXXX--ooooo--XXXXXXX----ooo-------R-XXXXXXXXXXXX
----------XXXXXXXXXXXXXXXXXXX-oooooo--XXXXXXXXXXXXXXXXX----G-g--------XXXX---XXXXXXXXXXXXX-y--------oooo----XXXXXXXXXX---oooooooo-------g----ooooo--XXXXXXXX-kykK----XXXXXXX--y-G-----XXXXXXXXXXXXXXXXXX
XXXXXXXXXXXXXXXXXXXXXXXXXXXXX-k-G--g--XXXXXXXXXXXXXXXXXXXXXXXXXXXX----XXXX---XXXXXXXXXXXXXXXXXXXXX---r--Gg--XXXXXXXXXX---YG-g------XXXXXXX--r-K-----XXXXXXXXXXXXXXXXXXXXXXXXXXXXXXXXXXXXXXXXXXXXXXXXXXXX
XXXXXXXXXXXXXXXXXXXXXXXXXXXXXXXXXXXXXXXXXXXXXXXXXXXXXXXXXXXXXXXXXXXXXXXXXXXXXXXXXXXXXXXXXXXXXXXXXXXXXXXXXXXXXXXXXXXXXXXXXXXXXXXXXXXXXXXXXXXXXXXXXXXXXXXXXXXXXXXXXXXXXXXXXXXXXXXXXXXXXXXXXXXXXXXXXXXXXXXX

