--------------------------------------------------------------------------------------------------------------------------------------------------------------------------------------------------------
--------------------------------------------------------------------------------------------------------------------------------------------------------------------------------------------------------
--------------------------------------------------------------------------------------------------------------------------------------------------------------------------------------------------------
--------------------------------------------------------------------------------------------------------------------------------------------------------------------------------------------------------
--------------------------------------------------------------------------------------------------------------------------------------------------------------------------------------------------------
--------------------------------------------------------------------------------------------------------------------------------------------------------------------------------------------------------
--------------------------------------------------------------------------------------------------------------------------------------------------------------------------------------------------------
--------------------------------------------------------------------------------------------------------------------------------------------------------------------------------------------------------
--------------------------------------------------------------------------------------------------------------------------------------------------------------------------------------------------------
--------------------------------------------------------------------------------------------------------------------------------------------------------------------------------------------------------
--------------------------------------------------------------------------------------------------------------------------------------------------------------------------------------------------------
--------------------------------------------------------------------------------------------------------------------------------------------------------------------------------------------------------
---------------------------------------------Soo-------------------------------oooo-----------------------------------------------------------------------oSSoSooo--------------------------------------
-------------------------------------------------------------------------------------------------------------------oSooo----------ooo---------------------------------------oSSSS-----------------------
---------------------------------------------------oooo----------oooSoSooo----oooo------------------------------------------------------------------------ooooooo---------------------------------------
---------------------------------------yk-------------------ooo--------------y------r------ooo------------------------ooo---------oo----------------------k---r-------------oooo------------------------
--------------XXX------XXXXX--------XXXXXXXXXXXXX----------R-r-----oooo----XXXXXXXXXXX--------k----------------------k-Y----------------------k----------XXXXXXXXXXX---XXX-K--K-k---------XXX-----------
--------------XXX------XXXXX--------XXXXXXXXXXXXX------g-XXXXXXX---r-------XXXXXXXXXXX----XXXXXXX-----XXXX-----XXXXXXXXXXX------XXXXXX-----XXXXXXXX------XXXXXXXXXXXXXXXXXXXXXXXXXXX--g---XXX-----------
XXXXXXXXXXX---XXX------XXXXXXXXXXXXXXXXXXXXXXXXXXXXXXXXXXXXXXXXXXXXXXXXXXXXXXXXXXXXXXX----XXXXXXXXXXXXXXXX-----XXXXXXXXXXXXXXXXXXXXXXX-----XXXXXXXXXXXXXXXXXXXXXXXXXXXXXXXXXXXXXXXXXXXXXXXXXX--r--------
XXXXXXXXXXXXXXXXXXXXXXXXXXXXXXXXXXXXXXXXXXXXXXXXXXXXXXXXXXXXXXXXXXXXXXXXXXXXXXXXXXXXXXXXXXXXXXXXXXXXXXXXXXXXXXXXXXXXXXXXXXXXXXXXXXXXXXXXXXXXXXXXXXXXXXXXXXXXXXXXXXXXXXXXXXXXXXXXXXXXXXXXXXXXXXXXXXXXXXXX

