--------------------------------------------------------------------------------------------------------------------------------------------------------------------------------------------------------
--------------------------------------------------------------------------------------------------------------------------------------------------------------------------------------------------------
--------------------------------------------------------------------------------------------------------------------------------------------------------------------------------------------------------
--------------------------------------------------------------------------------------------------------------------------------------------------------------------------------------------------------
--------------------------------------------------------------------------------------------------------------------------------------------------------------------------------------------------------
--------------------------------------------------------------------------------------------------------------------------------------------------------------------------------------------------------
--------------------------------------------------------------------------------------------------------------------------------------------------------------------------------------------------------
--------------------------------------------------------------------------------------------------------------------------------------------------------------------------------------------------------
--------------------------------------------------------------------------------------------------------------------------------------------------------------------------------------------------------
--------------------------------------------------------------------------------------------------------------------------------------------------------------------------------------------------------
--------------------------------------------------------------------------------------------------------------------------------------------------------------------------------------------------------
--------------------------------------------------------------------------------------------------------------------------------------------------------------------------------------------------------
------------------------------------SSoooS-------------------------ooo---------------------------------oooSoo------------------ooSo-----------------------------------------------------------ooooo-----
--------------------------------------------------------------------------------------------------------------------------------------------------------------------------------------------------------
-------------------------ooSSoSo-----ooo-----------------------------------------------Sooo-------------ooooooo--------------ooooo----------------oooooo---------------------------------------ooo------
----------------------------------rg-r----------------------Soooo-------------------------------------k---y-yy--------------k-kr-K--------oooo-----------------------------oooS----------------y-YK-----
------------oooo-----------------XXXXXXXXXXX----------------------XXXXXXX--------XX-ooooo------------XXXXXXXXXXX-----------XXXXXXXXXXX-------------ooooo-------------------------------------XXXXXXX----
----------------gk--------g---G--XXXXXXXXXXX---------XXXXX--------XXXXXXX--------XX--------r--g-g----XXXXXXXXXXX------XXXXXXXXXXXXXXXX-oooooooo---r------gR-------------oooooooo--XXXXXXXXXXXXXXXXXXXXXX
XXXXXXXXXXXXXXXXXXXXXX--XXXXXXXXXXXXXXXXXXXXXXXXXXXXXXXXXX--------XXXXXXX--------XXXXXXXXXXXXXXXXXXXXXXXXXXXXXXX---XXXXXXXXXXXXXXXXXXX-k---r-G---XXXXXXXXXXXXXXXXXX------rk-K-----XXXXXXXXXXXXXXXXXXXXXX
XXXXXXXXXXXXXXXXXXXXXXXXXXXXXXXXXXXXXXXXXXXXXXXXXXXXXXXXXXXXXXXXXXXXXXXXXXXXXXXXXXXXXXXXXXXXXXXXXXXXXXXXXXXXXXXXXXXXXXXXXXXXXXXXXXXXXXXXXXXXXXXXXXXXXXXXXXXXXXXXXXXXXXXXXXXXXXXXXXXXXXXXXXXXXXXXXXXXXXXX

