--------------------------------------------------------------------------------------------------------------------------------------------------------------------------------------------------------
--------------------------------------------------------------------------------------------------------------------------------------------------------------------------------------------------------
--------------------------------------------------------------------------------------------------------------------------------------------------------------------------------------------------------
--------------------------------------------------------------------------------------------------------------------------------------------------------------------------------------------------------
--------------------------------------------------------------------------------------------------------------------------------------------------------------------------------------------------------
--------------------------------------------------------------------------------------------------------------------------------------------------------------------------------------------------------
--------------------------------------------------------------------------------------------------------------------------------------------------------------------------------------------------------
--------------------------------------------------------------------------------------------------------------------------------------------------------------------------------------------------------
--------------------------------------------------------------------------------------------------------------------------------------------------------------------------------------------------------
--------------------------------------------------------------------------------------------------------------------------------------------------------------------------------------------------------
------------------------------------------------------------------------------------------------------------------------------oo------------------------------------------------------------------------
-----------------------------------------------------------------------------------------------------------------------------gk-------------------------------------------------------------------------
-------------------------------------------------------------------------ooSo-----------------------------------------------%%%%%---------------------------------------ooSS----------------------------
----------------------------------------------oSoooSo--------------------------------SSo------------------------------------|||||-----------------------------------------------------------------------
--------------------------------------------------------ooSo------------oo---------------------------------oSSS-------------|||||----ooo-----oooo----SooooSo----------ooooo--------------Sooo-----------
------------------oo---------oooSooo-----------ooooo------------ooo----yrg-----------oo-----Soooo------------------rr-k-----||gY|k-----------------------------oooo--k-Rrk--g---------------------------
XXXXXXXXXXXXX-----R-y--------------------------yk-rk-----oo------G-ky-XXXXXXXX-----G--rr-------------------------XXXXXXXXXXXXXXXXXX-oooooo-----oo---ooooo------Yk---XXXXXXXXXXXXX------ooooo--------XXX-
XXXXXXXXXXXXX----XXXXXX----ooooooooo--ky--g-XXXXXXXXXXX---G----XXXXXXXXXXXXXXXXXXXXXXXXXX---oooooo-------------Y-XXXXXXXXXXXXXXXXXX----r-k----y-y---ky--yr---XXXXXXXXXXXXXXXXXXXXXXXXX-----y---oooo-XXX-
XXXXXXXXXXXXX----XXXXXX-----kg----k--XXXXXXXXXXXXXXXXXXXXXXXXXXXXXXXXXXXXXXXXXXXXXXXXXXXX-ky-r------------XXXXXXXXXXXXXXXXXXXXXXXXXXXXXXXXXXXXXXXXXXXXXXXXXXXXXXXXXXXXXXXXXXXXXXXXXXXXXXXXXXXX--r---XXX-
XXXXXXXXXXXXXXXXXXXXXXXXXXXXXXXXXXXXXXXXXXXXXXXXXXXXXXXXXXXXXXXXXXXXXXXXXXXXXXXXXXXXXXXXXXXXXXXXXXXXXXXXXXXXXXXXXXXXXXXXXXXXXXXXXXXXXXXXXXXXXXXXXXXXXXXXXXXXXXXXXXXXXXXXXXXXXXXXXXXXXXXXXXXXXXXXXXXXXXXX

