--------------------------------------------------------------------------------------------------------------------------------------------------------------------------------------------------------
--------------------------------------------------------------------------------------------------------------------------------------------------------------------------------------------------------
--------------------------------------------------------------------------------------------------------------------------------------------------------------------------------------------------------
--------------------------------------------------------------------------------------------------------------------------------------------------------------------------------------------------------
--------------------------------------------------------------------------------------------------------------------------------------------------------------------------------------------------------
--------------------------------------------------------------------------------------------------------------------------------------------------------------------------------------------------------
--------------------------------------------------------------------------------------------------------------------------------------------------------------------------------------------------------
--------------------------------------------------------------------------------------------------------------------------------------------------------------------------------------------------------
--------------------------------------------------------------------------------------------------------------------------------------------------------------------------------------------------------
--------------------------------------------------------------------------------------------------------------------------------------------------------------------------------------------------------
--------------------------------------------------------------------------------------------------------------------------------------------------------------------------------------------------------
--------------Ky---gg-----------------------------------------------------------------------------------------------------------------------------------------------------------------------------------
--------------%%%%%%%---------------------------------------ooooo---------------------------------------------------------------------------------------------------------SoS---------------------------
--------------|||||||------------------------oSSSo--------------------------oooo----------------------------ooooo--------------------------------------------------ooo-------------oooo------------oooo-
--------------|||||||------------------------------------oooooooo---ooo--------------------------------------------oooo-------Sooo-------------oSSS-----------------------ooo---------------------------
--------------|r|||||-------------SoSSSo-----------------g-----Ggy--------ooooooo-----------------SoSSS------oooo--------------------oooo----------------oooSo----ooo------g-k----ooooo---SSo----ooo----
--------------|%%%|||----oooo-------------------g-------XXXXXXXXXXX-oooo----y----kK-XXXXXXXX----------------g---k----oo------oooo----Rgy--------ooo---------------------XXXXXXX----r-------------y-r--k-
--------------|||||||-----Gk--XX--oooo------XXXXXXXXXXXXXXXXXXXXXXX-K--R-XXXXXXXXXXXXXXXXXXX-----ooooo----XXXXXXXX---r-------r-gY--XXXXXXX---y------k-----oooo---XXXXXXXXXXXXXX--XXXXXXX--------XXXXXXXX
XXXXXXXXXXXXX-|||||||--XXXXXXXXX---r----k---XXXXXXXXXXXXXXXXXXXXXXXXXXXXXXXXXXXXXXXXXXXXXXXXXXX----y------XXXXXXXXXXXXXXXXXXXXXXXXXXXXXXXXXXXXXXXXXXXXX----Yg----XXXXXXXXXXXXXX--XXXXXXX-k---g--XXXXXXXX
XXXXXXXXXXXXXXXXXXXXXXXXXXXXXXXXXXXXXXXXXXXXXXXXXXXXXXXXXXXXXXXXXXXXXXXXXXXXXXXXXXXXXXXXXXXXXXXXXXXXXXXXXXXXXXXXXXXXXXXXXXXXXXXXXXXXXXXXXXXXXXXXXXXXXXXXXXXXXXXXXXXXXXXXXXXXXXXXXXXXXXXXXXXXXXXXXXXXXXXX

