--------------------------------------------------------------------------------------------------------------------------------------------------------------------------------------------------------
--------------------------------------------------------------------------------------------------------------------------------------------------------------------------------------------------------
--------------------------------------------------------------------------------------------------------------------------------------------------------------------------------------------------------
--------------------------------------------------------------------------------------------------------------------------------------------------------------------------------------------------------
--------------------------------------------------------------------------------------------------------------------------------------------------------------------------------------------------------
--------------------------------------------------------------------------------------------------------------------------------------------------------------------------------------------------------
--------------------------------------------------------------------------------------------------------------------------------------------------------------------------------------------------------
--------------------------------------------------------------------------------------------------------------------------------------------------------------------------------------------------------
--------------------------------------------------------------------------------------------------------------------------------------------------------------------------------------------------------
--------------------------------------------------------------------------------------------------------------------------------------------------------------------------------------------------------
--------------------------------------------------------------------------------------------------------------------------------------------------------------------------------------------------------
--------------------------------------------------------------------------------------------------------------------------------------------------------------------------------------------------------
----------------------------------oSoSooo-----------------oSo--------------------------------SSo---------------------------SoS--------------------------------------------------------------------------
---------------------------------------------------------------------------------------------------------------------------------oSSoo------------------------------------------------------------------
-----------------------------------oooo------------------oo-----------------------ooS------oooooo--ooSSSoSoo-------------oooooo--------------------------oSo----------------------------oSo-------------
-----------------ooo--------ooo-----yk---R---SoSSoSS---k-yG-y-----oo----oooo-----------------------------------ooSoS------g---g---ooooo--------------------------------------SSoo-----------------------
---------------------XXXX------y-XXXXXXXXXX-----------XXXXXXXXX-----k---------XX--oooooo-XXXXXXXXX--ooooooo-------------XXXXXXXX-R----y----------------------------------XX--------------oooo-----------
------------XXX---oo-XXXXXXXXXXXXXXXXXXXXXX---oooooo--XXXXXXXXXXXXXXXXX----oo-XX--r-gGr--XXXXXXXXX-k--Y-gr-----ooooo----XXXXXXXXXXXXXXXXXXX-------------yk----gk-r-XXXXXXXX----ooooo------------yGry----
------------XXX--RG--XXXXXXXXXXXXXXXXXXXXXX-------RrY-XXXXXXXXXXXXXXXXX---y---XXXXXXXXXXXXXXXXXXXXXXXXXXXXXXX-Y--Y---yy-XXXXXXXXXXXXXXXXXXXXXXXXXXXX---XXXXXXXXXXXXXXXXXXXX--k--Y-g--XXXXXXXXXXXXXXXX---
XXXXXXXXXXXXXXXXXXXXXXXXXXXXXXXXXXXXXXXXXXXXXXXXXXXXXXXXXXXXXXXXXXXXXXXXXXXXXXXXXXXXXXXXXXXXXXXXXXXXXXXXXXXXXXXXXXXXXXXXXXXXXXXXXXXXXXXXXXXXXXXXXXXXXXXXXXXXXXXXXXXXXXXXXXXXXXXXXXXXXXXXXXXXXXXXXXXXXXXX

