--------------------------------------------------------------------------------------------------------------------------------------------------------------------------------------------------------
--------------------------------------------------------------------------------------------------------------------------------------------------------------------------------------------------------
--------------------------------------------------------------------------------------------------------------------------------------------------------------------------------------------------------
--------------------------------------------------------------------------------------------------------------------------------------------------------------------------------------------------------
--------------------------------------------------------------------------------------------------------------------------------------------------------------------------------------------------------
--------------------------------------------------------------------------------------------------------------------------------------------------------------------------------------------------------
--------------------------------------------------------------------------------------------------------------------------------------------------------------------------------------------------------
--------------------------------------------------------------------------------------------------------------------------------------------------------------------------------------------------------
--------------------------------------------------------------------------------------------------------------------------------------------------------------------------------------------------------
--------------------------------------------------------------------------------------------------------------------------------------------------------------------------------------------------------
--------------------------------------------------------------------------------------------------------------------------------------------------------------------------------------------------------
--------------------------------------------------------------------------------------------------------------------------------------------------------------------------------------------------------
------------------------------------------------------------------------------------------------------------------------------------------------------------oooS----------------------------------------
---------------------------------------------------------------------------------------------oSoS-------------------------------------------------------------------------------------------------------
----------------------ooo------------------oSooSSo----------------------ooSooo------Sooo-----------------------------oooSSo---------------------------------oooo------------oSSoo--------------------oo-
-------------oSooo----------------oSoooSo----------------------------------------------------oooo---------------------------------ooSoSoooo-----SoSoo--------k-----------------------Kr------------R----
-----------------------ooo------------------ooooo-------ooo--------------oooo--XXX-oooooooo----K--------XXXXXXXXX----ooooooo-XXXX--------------------------XXXXXXXX---------ooo---XXXXXXX--------XXXXXXX
--------------oooooo-------------ooooooo---k-r--R-g---r--G---XXXXXX----k---R---XXX----------XXXXXXXXX---XXXXXXXXX------yy----XXXX--oooooo------oooooo--XXXXXXXXXXXX--r---------kr-XXXXXXX----XXXXXXXXXXX
XXXXXXXXXXXX---ky----XXXXXXXXXX---gyk-----XXXXXXXXXXXXXXXXXXXXXXXXXXXXXXXXXXXXXXXXXXXXXXXXXXXXXXXXXXXXXXXXXXXXXXXXXXXXXXXXXXXXXXX-----g--G------ky-yr--XXXXXXXXXXXXXXXXXXXXXXXXXXXXXXXXXX----XXXXXXXXXXX
XXXXXXXXXXXXXXXXXXXXXXXXXXXXXXXXXXXXXXXXXXXXXXXXXXXXXXXXXXXXXXXXXXXXXXXXXXXXXXXXXXXXXXXXXXXXXXXXXXXXXXXXXXXXXXXXXXXXXXXXXXXXXXXXXXXXXXXXXXXXXXXXXXXXXXXXXXXXXXXXXXXXXXXXXXXXXXXXXXXXXXXXXXXXXXXXXXXXXXXX

