--------------------------------------------------------------------------------------------------------------------------------------------------------------------------------------------------------
--------------------------------------------------------------------------------------------------------------------------------------------------------------------------------------------------------
--------------------------------------------------------------------------------------------------------------------------------------------------------------------------------------------------------
--------------------------------------------------------------------------------------------------------------------------------------------------------------------------------------------------------
--------------------------------------------------------------------------------------------------------------------------------------------------------------------------------------------------------
--------------------------------------------------------------------------------------------------------------------------------------------------------------------------------------------------------
--------------------------------------------------------------------------------------------------------------------------------------------------------------------------------------------------------
--------------------------------------------------------------------------------------------------------------------------------------------------------------------------------------------------------
--------------------------------------------------------------------------------------------------------------------------------------------------------------------------------------------------------
--------------------------------------------------------------------------------------------------------------------------------------------------------------------------------------------------------
--------------------------------------------------------------------------------------------------------------------------------------------------------------------------------------------------------
--------------------------------------------------------------------------------------------------------------------------------------------------------------------------------------------------------
-----------------------------------------------------------------------------------------ooSoSS---------------------------------------------------------------------------------------------------------
------------------------oSoo-------ooSS------------------------------------------------------------------------ooSoo------------------------------------------------------------------------------------
------------------------------------------------------------------------------------------ooooooo-------------------------SSo--------------oSoSoo----------------------------------------oSo------------
-------------Soooooo---oooo---------------------------------------------Y----------------r---gk-Y--oo-------------ooooo------------oSSoo----------------------------------------------------------------
XXXXXXXXXX---------------r-Y-XXXXX-k---g---ooo-------------ooo------XXXXXX--------ooooo-XXXXXXXXXX--y-K-------------y----oooo--------------ooooooooo--------XXXXXX-------------XXXXX---oo----XX---------
XXXXXXXXXX--oooooooo-XXXXXXXXXXXXXXXXXXXXX--rgk--------------g------XXXXXXXXX-----Ky-y--XXXXXXXXXXXXXXXX---oo-XXXXXXXXXX-yy--K-------ooo--------kk-K--------XXXXXX-------XXXXXXXXXXX---rg----XXXXXXXXXXX
XXXXXXXXXX---r--r----XXXXXXXXXXXXXXXXXXXXXXXXXXXX-----XXXXXXXXXX----XXXXXXXXXXXXXXXXXXXXXXXXXXXXXXXXXXXX---yR-XXXXXXXXXXXXXXXXXXX-----r-R-XXXXXXXXXXX-g---r-XXXXXX-y-----XXXXXXXXXXX--XXXXXXXXXXXXXXXXXX
XXXXXXXXXXXXXXXXXXXXXXXXXXXXXXXXXXXXXXXXXXXXXXXXXXXXXXXXXXXXXXXXXXXXXXXXXXXXXXXXXXXXXXXXXXXXXXXXXXXXXXXXXXXXXXXXXXXXXXXXXXXXXXXXXXXXXXXXXXXXXXXXXXXXXXXXXXXXXXXXXXXXXXXXXXXXXXXXXXXXXXXXXXXXXXXXXXXXXXXX

