--------------------------------------------------------------------------------------------------------------------------------------------------------------------------------------------------------
--------------------------------------------------------------------------------------------------------------------------------------------------------------------------------------------------------
--------------------------------------------------------------------------------------------------------------------------------------------------------------------------------------------------------
--------------------------------------------------------------------------------------------------------------------------------------------------------------------------------------------------------
--------------------------------------------------------------------------------------------------------------------------------------------------------------------------------------------------------
--------------------------------------------------------------------------------------------------------------------------------------------------------------------------------------------------------
--------------------------------------------------------------------------------------------------------------------------------------------------------------------------------------------------------
--------------------------------------------------------------------------------------------------------------------------------------------------------------------------------------------------------
--------------------------------------------------------------------------------------------------------------------------------------------------------------------------------------------------------
--------------------------------------------------------------------------------------------------------------------------------------------------------------------------------------------------------
--------------------------------------------------------------------------------------------------------------------------------------------------------------------------------------------------------
--------------------------------------------------------------------------------------------------------------------------------------------------------------------------------------------------------
---------------------------------------------------------------------------------------------------------------------------ooo--------------------------------------------------------------------------
------------------------------------------------------------------------------------------------------------SSoS------------------------------------------ooSooo----------------------------------------
-------------------------ooooo------------SoSS-------------------SoS-----------------------------oooo-----------------------oo--------oSSo------------------------------ooo----------ooSoooo-----oSo----
-------------oSo---------------------------------------------------------------oooooSooo--------k-----------ooooooo----------y-------------------------------ooo-------r--g--oooo-----------------------
--------------------------ooooo---------ooooo--------------------ooo----k--K-------------XXXXXXXXXXXXX------------g-XXXXXXXXXXXXXX----oooo---------ooo------yk-G------XXXXXX----------oooooo--ooooo-----
-------------oooo---XX---------r--------r----gk--------XXXXXXX-----KGY-XXXXXXX----ooooo--XXXXXXXXXXXXX----XXXXXXXXXXXXXXXXXXXXXXXXXX-y--R-------------r--XXXXXXXXXXXXXXXXXXX----oo---g-y-k------gkr-----
-----------kRr--K---XXXXXXXXXXXXXXXXX--XXXXXXXXXX----y-XXXXXXXXXXXXXXXXXXXXXXX-kk------k-XXXXXXXXXXXXX----XXXXXXXXXXXXXXXXXXXXXXXXXXXXXXXXX-----XXXXXXXXXXXXXXXXXXXXXXXXXXXX-RgKr---XXXXXXXXXXXXXXXXXXX-
XXXXXXXXXXXXXXXXXXXXXXXXXXXXXXXXXXXXXXXXXXXXXXXXXXXXXXXXXXXXXXXXXXXXXXXXXXXXXXXXXXXXXXXXXXXXXXXXXXXXXXXXXXXXXXXXXXXXXXXXXXXXXXXXXXXXXXXXXXXXXXXXXXXXXXXXXXXXXXXXXXXXXXXXXXXXXXXXXXXXXXXXXXXXXXXXXXXXXXXX

