--------------------------------------------------------------------------------------------------------------------------------------------------------------------------------------------------------
--------------------------------------------------------------------------------------------------------------------------------------------------------------------------------------------------------
--------------------------------------------------------------------------------------------------------------------------------------------------------------------------------------------------------
--------------------------------------------------------------------------------------------------------------------------------------------------------------------------------------------------------
--------------------------------------------------------------------------------------------------------------------------------------------------------------------------------------------------------
--------------------------------------------------------------------------------------------------------------------------------------------------------------------------------------------------------
--------------------------------------------------------------------------------------------------------------------------------------------------------------------------------------------------------
--------------------------------------------------------------------------------------------------------------------------------------------------------------------------------------------------------
--------------------------------------------------------------------------------------------------------------------------------------------------------------------------------------------------------
--------------------------------------------------------------------------------------------------------------------------------------------------------------------------------------------------------
--------------------------------------------------------------------------------------------------------------------------------------------------------------------------------------------------------
--------------------------------------------------------------------------------------------------------------------------------------------------------------------------------------------------------
-------------------------------------ooooo------------Sooooo------------------------------------------------------ooo----------------------ooo----------ooo--------------------------------------ooooo--
------------------------------------------------------------------------------------------ooooo------------------------------------------------------------------------------------------oSoo-----------
----------------------oSoo-------------oo------ooSo--oooooo-------------------------------------------------------------oooo---------------ooo-------ooooooooo--ooS------------------------------ooooo--
-----------oooooo------------Sooo-------y--------------y---r---------------------------ooooooo---------------------Rkr---yRg--------------rkygr----------g--r-----------ooSSo-------------oooo---kGy-Y--
XXXXXXXXXX-KR---g-------------------XXXXXXX---------XXXXXXXXXXX-------XXXXXXXX------------K--Y---------K----yy---XXXXXXXXXXXX----------XXXXXXXXXX---XXXXXXXXXXX-------------------oo-----yg-----XXXXXXX-
XXXXXXXXXXXXXXXXXX----k-k-----------XXXXXXX-Y---r---XXXXXXXXXXX-----XXXXXXXXXX----XXXXXXXXXXXXXX--XXXXXXXXXXXXXXXXXXXXXXXXXXX----------XXXXXXXXXX---XXXXXXXXXXX-k-Yr--ooooooo-------G-XXXXXXXXXXXXXXXXX-
XXXXXXXXXXXXXXXXXXXXXXXXXXX---Ryr-XXXXXXXXXXXXXXXXXXXXXXXXXXXXX-----XXXXXXXXXXXXXXXXXXXXXXXXXXXXXXXXXXXXXXXXXXXXXXXXXXXXXXXXXXXXXX-----XXXXXXXXXX---XXXXXXXXXXXXXXXXX------KK--XXXXXXXXXXXXXXXXXXXXXXXXX
XXXXXXXXXXXXXXXXXXXXXXXXXXXXXXXXXXXXXXXXXXXXXXXXXXXXXXXXXXXXXXXXXXXXXXXXXXXXXXXXXXXXXXXXXXXXXXXXXXXXXXXXXXXXXXXXXXXXXXXXXXXXXXXXXXXXXXXXXXXXXXXXXXXXXXXXXXXXXXXXXXXXXXXXXXXXXXXXXXXXXXXXXXXXXXXXXXXXXXXX

