--------------------------------------------------------------------------------------------------------------------------------------------------------------------------------------------------------
--------------------------------------------------------------------------------------------------------------------------------------------------------------------------------------------------------
--------------------------------------------------------------------------------------------------------------------------------------------------------------------------------------------------------
--------------------------------------------------------------------------------------------------------------------------------------------------------------------------------------------------------
--------------------------------------------------------------------------------------------------------------------------------------------------------------------------------------------------------
--------------------------------------------------------------------------------------------------------------------------------------------------------------------------------------------------------
--------------------------------------------------------------------------------------------------------------------------------------------------------------------------------------------------------
--------------------------------------------------------------------------------------------------------------------------------------------------------------------------------------------------------
--------------------------------------------------------------------------------------------------------------------------------------------------------------------------------------------------------
--------------------------------------------------------------------------------------------------------------------------------------------------------------------------------------------------------
--------------------------------------------------------------------------------------------------------------------------------------------------------------------------------------------------------
--------------------------------------------------------------------------------------------------------------------------------------------------------------------------------------------------------
-------------------------------------------------------------------ooSoooS------------------------------------------------------------------------------Sooo--------------------------------------------
-------------------------------------------------------------------------------------------------------SSoSoo-------------------------------------------------------------------------------------------
-----------------------ooSSoo-----------------------------------------ooooo-------oSooooo---------------------------------------------------------------ooo----------oooooo-----------------------------
------------------------------------oooooo--ooo----------SooSoo--------g--G------------------------------oooooo---------SSSo-------------------oooo----r------------------------oooSoo------------------
------------------------ooo------------g----k---r-----------------XXXXXXXXXX------oooo-----------------g----Y----oo------------XXX------------------XXXXXXXXXX--------oo------------------------oo--XXXX
----------------XXXX-g---gk--------XXXXXXXXXXXXXXXX-------oooooo--XXXXXXXXXX----y--Y--------k--------XXXXXXXXXXX--g-y--ooooooo-XXX--------oo--------XXXXXXXXXX---XXX-Y-Y-----ooooooooo---Kkk--K-----XXXX
XXXXXXXXXXXXXXXXXXXXXXXXXXXXXXX----XXXXXXXXXXXXXXXX---------g--R--XXXXXXXXXX---XXXXXXXXXXXXXXXXXX----XXXXXXXXXXXXXXXXX-rry-----XXX------g-----------XXXXXXXXXXXXXXXXXXXXXXXX---K-y---k-XXXXXXXXXXXXXXXXX
XXXXXXXXXXXXXXXXXXXXXXXXXXXXXXXXXXXXXXXXXXXXXXXXXXXXXXXXXXXXXXXXXXXXXXXXXXXXXXXXXXXXXXXXXXXXXXXXXXXXXXXXXXXXXXXXXXXXXXXXXXXXXXXXXXXXXXXXXXXXXXXXXXXXXXXXXXXXXXXXXXXXXXXXXXXXXXXXXXXXXXXXXXXXXXXXXXXXXXXX

