--------------------------------------------------------------------------------------------------------------------------------------------------------------------------------------------------------
--------------------------------------------------------------------------------------------------------------------------------------------------------------------------------------------------------
--------------------------------------------------------------------------------------------------------------------------------------------------------------------------------------------------------
--------------------------------------------------------------------------------------------------------------------------------------------------------------------------------------------------------
--------------------------------------------------------------------------------------------------------------------------------------------------------------------------------------------------------
--------------------------------------------------------------------------------------------------------------------------------------------------------------------------------------------------------
--------------------------------------------------------------------------------------------------------------------------------------------------------------------------------------------------------
--------------------------------------------------------------------------------------------------------------------------------------------------------------------------------------------------------
--------------------------------------------------------------------------------------------------------------------------------------------------------------------------------------------------------
--------------------------------------------------------------------------------------------------------------------------------------------------------------------------------------------------------
--------------------------------------------------------------------------------------------------------------------------------------------------------------------------------------------------------
--------------------------------------------------------------------------------------------------------------------------------------------------------------------------------------------------------
------------------------------------------------------------------------------------------------------------------------oSooo----------------------ooSo-------------------------------------------------
------------ooSoo-----------ooo------ooSooo---------------------------------------------ooSooo------------------------------------------------------------------------------------SSSSoo--oSo-----------
------------------------------------------------ooo---------------------SoSSo--------------------ooo-------------------ooooooooo-------ooooo---------------oSoooo-----ooooSS----------------------------
-----------oooo------SSo------------oooooo-----KGG-----------------------------------------oo----------yk------oSoooo---Ygygy-yr------------------r---g-------------------------oooooooo--ooo-----------
XXXXXXXXXX-rk---G----------ykrk-------gRyr----XXXXXXXXX---------------ooooooooo---XXXXX------------oo-XXXXXX----------XXXXXXXXXXX--------oooo----XXXXXXXXX-ooooooooo--ooooo----k--y---Y------y-------XXX
XXXXXXXXXXXXXXXXXXX-------XXXXXXXXXXXXXXXXXXXXXXXXXXXXXXXXX--oooooo-----g-y-ryk-XXXXXXXXXXXXXXXX--g-r-XXXXXX----oo----XXXXXXXXXXX-------------XXXXXXXXXXXX---kK---y---Gyk-----XXXXXXXXXXXXXXXXXX-----XXX
XXXXXXXXXXXXXXXXXXX-y-g---XXXXXXXXXXXXXXXXXXXXXXXXXXXXXXXXX-----r-y--XXXXXXXXXXXXXXXXXXXXXXXXXXXXXXXXXXXXXXX--y-kR--g-XXXXXXXXXXXXXXXXXXXXXXXXXXXXXXXXXXXXXXXXXXXXXXXXXXXXXXXXXXXXXXXXXXXXXXXXXX-----XXX
XXXXXXXXXXXXXXXXXXXXXXXXXXXXXXXXXXXXXXXXXXXXXXXXXXXXXXXXXXXXXXXXXXXXXXXXXXXXXXXXXXXXXXXXXXXXXXXXXXXXXXXXXXXXXXXXXXXXXXXXXXXXXXXXXXXXXXXXXXXXXXXXXXXXXXXXXXXXXXXXXXXXXXXXXXXXXXXXXXXXXXXXXXXXXXXXXXXXXXXX

