--------------------------------------------------------------------------------------------------------------------------------------------------------------------------------------------------------
--------------------------------------------------------------------------------------------------------------------------------------------------------------------------------------------------------
--------------------------------------------------------------------------------------------------------------------------------------------------------------------------------------------------------
--------------------------------------------------------------------------------------------------------------------------------------------------------------------------------------------------------
--------------------------------------------------------------------------------------------------------------------------------------------------------------------------------------------------------
--------------------------------------------------------------------------------------------------------------------------------------------------------------------------------------------------------
--------------------------------------------------------------------------------------------------------------------------------------------------------------------------------------------------------
--------------------------------------------------------------------------------------------------------------------------------------------------------------------------------------------------------
--------------------------------------------------------------------------------------------------------------------------------------------------------------------------------------------------------
--------------------------------------------------------------------------------------------------------------------------------------------------------------------------------------------------------
--------------------------------------------------------------------------------------------------------------------------------------------------------------------------------------------------------
--------------------------------------------------------------------------------------------------------------------------------------------------------------------------------------------------------
---------------------------oooo---oSSoo-----------------------------------------------------------------------------------------------------------------oSSooo------------------------------------------
-----------------------------------------------------------------------SSoSooo-----------------------------oSooooo------------------------oSo-----------------------------------------------------------
---------------------------oo--------------------------------SSSSoo--------------ooo----------oooo------------------------------------------------------ooooooo---------oSS-----------------------------
--------------ooSo------------------r-g---------oSSSSooo----------------oooo-----------------------------ooooooo--------------------------oo--------------r--g-------------------------oSoSoo-----------
-------------------------XXXXXXXXXXXXXXX----------------------oooooo---r-----------ooo--------ooooo--------yk---------XXXX---oooooo-----r---g----------XXXXXXXXXXXXX---ooooo---XXX----------------------
XXXXXXXXXXX--oooo-----oo-XXXXXXXXXXXXXXX-----------oooooo--gk------Y-XXXXXXXXXXX-g-----XXXX--gr-g-------XXXXXXXXXXX---XXXXXX----r-----XXXXXXXXXX---XXXXXXXXXXXXXXXXX-rk--Ry----XXX--------ooo------oo---
XXXXXXXXXXX---r--g---G---XXXXXXXXXXXXXXX--rg----ky--kR----XXXXXXXXXXXXXXXXXXXXXXXXXXXXXXXXXXXXXXXXXXXXXXXXXXXXXXXXXXXXXXXXXXXXXXXXXXXXXXXXXXXXXX---XXXXXXXXXXXXXXXXXXXXXXXXXX--XXXXXXX-r------XXXX---r--
XXXXXXXXXXXXXXXXXXXXXXXXXXXXXXXXXXXXXXXXXXXXXXXXXXXXXXXXXXXXXXXXXXXXXXXXXXXXXXXXXXXXXXXXXXXXXXXXXXXXXXXXXXXXXXXXXXXXXXXXXXXXXXXXXXXXXXXXXXXXXXXXXXXXXXXXXXXXXXXXXXXXXXXXXXXXXXXXXXXXXXXXXXXXXXXXXXXXXXXX

