--------------------------------------------------------------------------------------------------------------------------------------------------------------------------------------------------------
--------------------------------------------------------------------------------------------------------------------------------------------------------------------------------------------------------
--------------------------------------------------------------------------------------------------------------------------------------------------------------------------------------------------------
--------------------------------------------------------------------------------------------------------------------------------------------------------------------------------------------------------
--------------------------------------------------------------------------------------------------------------------------------------------------------------------------------------------------------
--------------------------------------------------------------------------------------------------------------------------------------------------------------------------------------------------------
--------------------------------------------------------------------------------------------------------------------------------------------------------------------------------------------------------
--------------------------------------------------------------------------------------------------------------------------------------------------------------------------------------------------------
--------------------------------------------------------------------------------------------------------------------------------------------------------------------------------------------------------
--------------------------------------------------------------------------------------------------------------------------------------------------------------------------------------------------------
--------------------------------------------------------------------------------------------------------------------------------------------------------------------------------------------------------
--------------------------------------------------------------------------------------------------------------------------------------------------------------------------------------------------------
-----------------------------SSoo-----------ooS---------------------------------------------------------------------------------------------------------------------------------------------------------
----------------oSoo-------------------------------------------------------------oooSS---ooSoSSSoo---------------------------------------------------------------------------------------------Soo------
---------------------------ooooo----------oooooo-----oooooS-------ooo---------------------------------------------------oSooSS----oooSoSo------------------------------ooooSo-----------oo--------------
--------------oooooo-------K---------------k---g-----------------Y-GR-----------ooooooo-----oooooo-----------------------------------------------oSSooSoo----Soooo-------------------r---r-----oooo-----
---------------yg-Gy------XXXXXXXX-------XXXXXXXXXX--oooooo-----XXXXXXXXXX-------yR---k--k----k-------------------------oooooooo--ooooooo-------------------------------ooooo-------XXXXXXX----y-y------
XXXXXXXXXXX--XXXXXXXXXXXXXXXXXXXXX-------XXXXXXXXXX-------K-----XXXXXXXXXX----XXXXXXXXXXXXXXXXXXXXX-kyky-R-----XXXXX--------Gg-----g---------XXX---oooooo-----ooooo---Y----------XXXXXXXXXXXXXXXXXXXX---
XXXXXXXXXXX--XXXXXXXXXXXXXXXXXXXXXXXXX---XXXXXXXXXXXXXXXXXXXXX--XXXXXXXXXX----XXXXXXXXXXXXXXXXXXXXXXXXXXXXX----XXXXXXXXXXXXXXXXXXXXXXXXXXXXXXXXX---y-kkrg-----k-gK---XXXXXXXXXXXXXXXXXXXXXXXXXXXXXXXX---
XXXXXXXXXXXXXXXXXXXXXXXXXXXXXXXXXXXXXXXXXXXXXXXXXXXXXXXXXXXXXXXXXXXXXXXXXXXXXXXXXXXXXXXXXXXXXXXXXXXXXXXXXXXXXXXXXXXXXXXXXXXXXXXXXXXXXXXXXXXXXXXXXXXXXXXXXXXXXXXXXXXXXXXXXXXXXXXXXXXXXXXXXXXXXXXXXXXXXXXX

