--------------------------------------------------------------------------------------------------------------------------------------------------------------------------------------------------------
--------------------------------------------------------------------------------------------------------------------------------------------------------------------------------------------------------
--------------------------------------------------------------------------------------------------------------------------------------------------------------------------------------------------------
--------------------------------------------------------------------------------------------------------------------------------------------------------------------------------------------------------
--------------------------------------------------------------------------------------------------------------------------------------------------------------------------------------------------------
--------------------------------------------------------------------------------------------------------------------------------------------------------------------------------------------------------
--------------------------------------------------------------------------------------------------------------------------------------------------------------------------------------------------------
--------------------------------------------------------------------------------------------------------------------------------------------------------------------------------------------------------
--------------------------------------------------------------------------------------------------------------------------------------------------------------------------------------------------------
--------------------------------------------------------------------------------------------------------------------------------------------------------------------------------------------------------
--------------------------------------------------------------------------------------------------------------------------------------------------------------------------------------------------------
--------------------------------------------------------------------------------------------------------------------------------------------------------------------------------------------------------
------------oSoooo---------SoSSo----------------------------------------------------------------------------------------------------------------------Sooooo--------------------------------------------
---------------------------------------------------------------------------ooS------------------------------ooo---------------------SSoo------Soo---------------------oooooo-----ooSSS------------------
--------------oo-----------oooooo----------------------------------oSSo--------------------------------------------------------------------------------oo-----------------------------------------------
-----------k--gyG---------y----k----SSoSo----------------oooooSoo-------------------oSo-------ooooo--------oo------------------------ooo------ooooo--G---k------------ooooo--------oooooo---------------
----------XXXXXXXXXX----XXXXXXXXXX---------------------------------oooooo--kr----XX-----------------XXXXX-K-k---------------rk-r------gr------Y-k---XXXXXXXXX---------yyrK---XXX-k-----r---------XXXX---
XXXXXXXXXXXXXXXXXXXX----XXXXXXXXXX--oooo----r-y--XXXXXXX---ooo-----G-g-ry-XXXXXXXXX-----------ooooo-XXXXXXXXXXXX------oo-XXXXXXXXXXXXXXXXXXXXXXXXXXXXXXXXXXXX----XXXXXXXXXXXXXXXXXXXXXXXXX-----XXXXXX---
XXXXXXXXXXXXXXXXXXXX----XXXXXXXXXX-k--gr--XXXXXXXXXXXXXX---kg-----XXXXXXXXXXXXXXXXX--rG-R-----------XXXXXXXXXXXX-----rr--XXXXXXXXXXXXXXXXXXXXXXXXXXXXXXXXXXXXXXXXXXXXXXXXXXXXXXXXXXXXXXXXXXXXXXXXXXXXXXX
XXXXXXXXXXXXXXXXXXXXXXXXXXXXXXXXXXXXXXXXXXXXXXXXXXXXXXXXXXXXXXXXXXXXXXXXXXXXXXXXXXXXXXXXXXXXXXXXXXXXXXXXXXXXXXXXXXXXXXXXXXXXXXXXXXXXXXXXXXXXXXXXXXXXXXXXXXXXXXXXXXXXXXXXXXXXXXXXXXXXXXXXXXXXXXXXXXXXXXXX

