--------------------------------------------------------------------------------------------------------------------------------------------------------------------------------------------------------
--------------------------------------------------------------------------------------------------------------------------------------------------------------------------------------------------------
--------------------------------------------------------------------------------------------------------------------------------------------------------------------------------------------------------
--------------------------------------------------------------------------------------------------------------------------------------------------------------------------------------------------------
--------------------------------------------------------------------------------------------------------------------------------------------------------------------------------------------------------
--------------------------------------------------------------------------------------------------------------------------------------------------------------------------------------------------------
--------------------------------------------------------------------------------------------------------------------------------------------------------------------------------------------------------
--------------------------------------------------------------------------------------------------------------------------------------------------------------------------------------------------------
--------------------------------------------------------------------------------------------------------------------------------------------------------------------------------------------------------
--------------------------------------------------------------------------------------------------------------------------------------------------------------------------------------------------------
--------------------------------------------------------------------------------------------------------------------------------------------------------------------------------------------------------
--------------------------------------------------------------------------------------------------------------------------------------------------------------------------------------------------------
------------------------------------------------------------------------------------------------------------------oooo------------------------------------------oooSSoSo--------------------------------
----------------oooSSS------ooo--------------------------SSooS-------------------------------------------------------------------------ooo----SoSo-----------------------------------ooooSoo----SoS-----
---------------------------------------oSoS---------------------------------------------ooo--------ooSoooS-------ooooooo--oooSSooo--------------------------------ooooooo---SoSoSo----------------------
---------------ooooooooo--------------------------------oooooooo------oSoSSSS-----------Y-r----------------------r--kgrg-------------oooooo---------------------r-------Y-----------oooooo----ooooo-----
----------------G--g---k--k--K--XXX-------------oooo----y--yg--r-----------------XXXX--XXXXXX------ooooo----XXXXXXXXXXXXX-oooooooo---Rk--G---g--K----------XXXXXXXXXXXXXXX-ooooo-----------------k---R--
--------------XXXXXXXXXXXXXXXXXXXXX----y-------r-------XXXXXXXXXXXXX---ooooo---XXXXXX--XXXXXX-------y--k--G-XXXXXXXXXXXXX-gG-k--r--XXXXXXXXXXXXXXXX--ooo---XXXXXXXXXXXXXXX---k---Y-XXXXXXXXXXXXXXXXXXXX-
--------------XXXXXXXXXXXXXXXXXXXXXXXXXXXXXXXXXXXXXXXXXXXXXXXXXXXXXX---k---rG--XXXXXX--XXXXXX----XXXXXXXXXXXXXXXXXXXXXXXXXXXXXXXXXXXXXXXXXXXXXXXXXX-k----k-XXXXXXXXXXXXXXXXXXXXXXXXXXXXXXXXXXXXXXXXXXXX-
XXXXXXXXXXXXXXXXXXXXXXXXXXXXXXXXXXXXXXXXXXXXXXXXXXXXXXXXXXXXXXXXXXXXXXXXXXXXXXXXXXXXXXXXXXXXXXXXXXXXXXXXXXXXXXXXXXXXXXXXXXXXXXXXXXXXXXXXXXXXXXXXXXXXXXXXXXXXXXXXXXXXXXXXXXXXXXXXXXXXXXXXXXXXXXXXXXXXXXXX

