--------------------------------------------------------------------------------------------------------------------------------------------------------------------------------------------------------
--------------------------------------------------------------------------------------------------------------------------------------------------------------------------------------------------------
--------------------------------------------------------------------------------------------------------------------------------------------------------------------------------------------------------
--------------------------------------------------------------------------------------------------------------------------------------------------------------------------------------------------------
--------------------------------------------------------------------------------------------------------------------------------------------------------------------------------------------------------
--------------------------------------------------------------------------------------------------------------------------------------------------------------------------------------------------------
--------------------------------------------------------------------------------------------------------------------------------------------------------------------------------------------------------
--------------------------------------------------------------------------------------------------------------------------------------------------------------------------------------------------------
--------------------------------------------------------------------------------------------------------------------------------------------------------------------------------------------------------
--------------------------------------------------------------------------------------------------------------------------------------------------------------------------------------------------------
--------------------------------------------------------------------------------------------------------------------------------------------------------------------------------------------------------
--------------------------------------------------------------------------------------------------------------------------------------------------------------------------------------------------------
----------------------ooo---------------------------------ooS-----------ooooS--------------------------------------------------------------------------------------------oSoSooo------------------------
---------------------------------------------------------------------------------------------------------------------------------------oSo--------------------------------------------Soo---------------
---------------------ooooo-----------------------------------------------oooo---------------------------------oooo----ooooo------------------------------------------------ooo--------------------------
------------------------------------SSS-----oooSSo-------------------------------------oooo-----ooooo--------------------------SooS----oo-----------ooo-----oSSo----------------------oo-----------ooo--
------------------XXXXXXXXX-ooooo----------------------XXXXXXXXX-------XXXXXXXXXXXXXXX------XX-----------------------XXXXXXXX--------------g----------------------------XXXXXXXXXX-----g-------g--------
XXXXXXXXXXXXXXXXXXXXXXXXXXX---------oooo----oooooo-XXXXXXXXXXXXX-------XXXXXXXXXXXXXXXXXXXXXXX----ooooo--XXXX--------XXXXXXXX-oooo----XXXXXXXXXXXXXXXXXX----------------XXXXXXXXXXXXXXXXXXXXXXXXXXXXXXXX
XXXXXXXXXXXXXXXXXXXXXXXXXXXXXXXXXX-----------------XXXXXXXXXXXXXXXXXX--XXXXXXXXXXXXXXXXXXXXXXX-----------XXXXXXXXXXXXXXXXXXXX---------XXXXXXXXXXXXXXXXXX----------------XXXXXXXXXXXXXXXXXXXXXXXXXXXXXXXX
XXXXXXXXXXXXXXXXXXXXXXXXXXXXXXXXXXXXXXXXXXXXXXXXXXXXXXXXXXXXXXXXXXXXXXXXXXXXXXXXXXXXXXXXXXXXXXXXXXXXXXXXXXXXXXXXXXXXXXXXXXXXXXXXXXXXXXXXXXXXXXXXXXXXXXXXXXXXXXXXXXXXXXXXXXXXXXXXXXXXXXXXXXXXXXXXXXXXXXXX

