--------------------------------------------------------------------------------------------------------------------------------------------------------------------------------------------------------
--------------------------------------------------------------------------------------------------------------------------------------------------------------------------------------------------------
--------------------------------------------------------------------------------------------------------------------------------------------------------------------------------------------------------
--------------------------------------------------------------------------------------------------------------------------------------------------------------------------------------------------------
--------------------------------------------------------------------------------------------------------------------------------------------------------------------------------------------------------
--------------------------------------------------------------------------------------------------------------------------------------------------------------------------------------------------------
--------------------------------------------------------------------------------------------------------------------------------------------------------------------------------------------------------
--------------------------------------------------------------------------------------------------------------------------------------------------------------------------------------------------------
--------------------------------------------------------------------------------------------------------------------------------------------------------------------------------------------------------
--------------------------------------------------------------------------------------------------------------------------------------------------------------------------------------------------------
--------------------------------------------------------------------------------------------------------------------------------------------------------------------------------------------------------
--------------------------------------------------------------------------------------------------------------------------------------------------------------------------------------------------------
---------------------------------------------------------------------------------------SSoo---------------------------------------oSSooooo--------------------------------------------------------------
-------------------------------------------SooS------------------------------------------------ooSooo--------------------------------------------oSooSSo----ooSSo-----------------------------oSSo------
-------------------Sooo-------------------------------Soooo--------------------oooo--ooooooo---------------------SoSS--------------ooooo---------------------------oSooS------oSoooo--------------------
--------------------------------oSoo-----ooooo----------------------------------------------------oo---------------------ooSS----------------------ooooooo------------------------------------oo--------
XXXXXXXXXX--------------------------------------------ooo----------oo------XXXXXXXXXXXXXXXXXXX------------------ooooo-----------XXXXXXXXXXX---------------------g--ooooo------oooo---XXXXX------g-------
XXXXXXXXXXXXXXXX----------------oooo----XXXXXXXXXX-------------------------XXXXXXXXXXXXXXXXXXXXXXXXXXXX--XXXXXX-----------ooooo-XXXXXXXXXXX-----XXXXXXXXXXXXXXXXXX-------------------XXXXXXXXXXXXXXXXXXX
XXXXXXXXXXXXXXXXXXXXXXXX----------g-----XXXXXXXXXXXXXXXXXXXXXXXXXXXXXXX----XXXXXXXXXXXXXXXXXXXXXXXXXXXXXXXXXXXXXXXXXXXXX--------XXXXXXXXXXXXXXXXXXXXXXXXXXXXXXXXXXXXXXXXXXXXXXXXXXXXXXXXXXXXXXXXXXXXXXXX
XXXXXXXXXXXXXXXXXXXXXXXXXXXXXXXXXXXXXXXXXXXXXXXXXXXXXXXXXXXXXXXXXXXXXXXXXXXXXXXXXXXXXXXXXXXXXXXXXXXXXXXXXXXXXXXXXXXXXXXXXXXXXXXXXXXXXXXXXXXXXXXXXXXXXXXXXXXXXXXXXXXXXXXXXXXXXXXXXXXXXXXXXXXXXXXXXXXXXXXX

