--------------------------------------------------------------------------------------------------------------------------------------------------------------------------------------------------------
--------------------------------------------------------------------------------------------------------------------------------------------------------------------------------------------------------
--------------------------------------------------------------------------------------------------------------------------------------------------------------------------------------------------------
--------------------------------------------------------------------------------------------------------------------------------------------------------------------------------------------------------
--------------------------------------------------------------------------------------------------------------------------------------------------------------------------------------------------------
--------------------------------------------------------------------------------------------------------------------------------------------------------------------------------------------------------
--------------------------------------------------------------------------------------------------------------------------------------------------------------------------------------------------------
--------------------------------------------------------------------------------------------------------------------------------------------------------------------------------------------------------
--------------------------------------------------------------------------------------------------------------------------------------------------------------------------------------------------------
--------------------------------------------------------------------------------------------------------------------------------------------------------------------------------------------------------
--------------------------------------------------------------------------------------------------------------------------------------------------------------------------------------------------------
--------------------------------------------------------------------------------------------------------------------------------------------------------------------------------------------------------
----------------------------------ooSoo-----------------------------------------------SSooSo--------------------------------------------------------------------Sooooo----------------------------------
-----------------------------------------------------------------------------------------------SSoSooSo--------------------------------------------------------------------------ooSoSSo----------------
----------------------------------ooooooo-----------------------oooo-----------------oooooo------------------------------------------------ooSoo-----------------oo-------------------------------------
------------------------SooooSoo--------------------------------------------------------------ooooooo----ooSSo----------------------------------------------------------oSSo-----oooooo------ooooo------
---------------------------------XXXXXXXXXX------------------XXXXXXXXX------------XXXXXXXXXXX------------------------------------------------------oooo-------XXXXXXXXX---------------------------------
------------------ooo---oooooo---XXXXXXXXXX--XXXXXXXXXXXXXX--XXXXXXXXXXXX---oooo--XXXXXXXXXXXXXXXXXXXXXX--ooooo----------------------XXXXX----------------XX--XXXXXXXXX---oooo--XXXXXXXXXX---oo---------
XXXXXXXXXXXX---------------------XXXXXXXXXX--XXXXXXXXXXXXXXXXXXXXXXXXXXXX---------XXXXXXXXXXXXXXXXXXXXXX---------XXXXXXXXXXXXXXXXXXXXXXXXXXXXXXXXXXXXXXXXXXX--XXXXXXXXX---------XXXXXXXXXX---------XXXXX
XXXXXXXXXXXXXXXXXXXXXXXXXXXXXXXXXXXXXXXXXXXXXXXXXXXXXXXXXXXXXXXXXXXXXXXXXXXXXXXXXXXXXXXXXXXXXXXXXXXXXXXXXXXXXXXXXXXXXXXXXXXXXXXXXXXXXXXXXXXXXXXXXXXXXXXXXXXXXXXXXXXXXXXXXXXXXXXXXXXXXXXXXXXXXXXXXXXXXXXX

