--------------------------------------------------------------------------------------------------------------------------------------------------------------------------------------------------------
--------------------------------------------------------------------------------------------------------------------------------------------------------------------------------------------------------
--------------------------------------------------------------------------------------------------------------------------------------------------------------------------------------------------------
--------------------------------------------------------------------------------------------------------------------------------------------------------------------------------------------------------
--------------------------------------------------------------------------------------------------------------------------------------------------------------------------------------------------------
--------------------------------------------------------------------------------------------------------------------------------------------------------------------------------------------------------
--------------------------------------------------------------------------------------------------------------------------------------------------------------------------------------------------------
--------------------------------------------------------------------------------------------------------------------------------------------------------------------------------------------------------
--------------------------------------------------------------------------------------------------------------------------------------------------------------------------------------------------------
--------------------------------------------------------------------------------------------------------------------------------------------------------------------------------------------------------
--------------------------------------------------------------------------------------------------------------------------------------------------------------------------------------------------------
--------------------------------------------------------------------------------------------------------------------------------------------------------------------------------------------------------
----------------SSo--------------------------------------------SoSSo------------------------------------------------------------------------SSoSoo------------------------------------------------------
---------------------------------------------oSoo---ooSoo-----------------------------------oooo----------------------------------------------------ooooS--------------------------SSSSooo--------------
--------------------------------oooooS---------------------------oo----------ooooooo----------------Sooooo-------SSoo-------------oooSoo-----oo---------------------------------------------------------
---------------g--------oSooS--------------oooo-------ooooo----------------------------------ooo---------------------------------------------------------------ooo-------SSooo-----ooooo----------------
--------------XXXXXX------------oooooo-----------------------XXXXXXXXX----------ooooo--XX-----g------oooooo-XXX-ooooo-XXXXXX----ooooo----XXXXXXXXXX------------------------------------------------XXXXX
XXXXXXXXXXXXXXXXXXXX----ooooo-----g-------XXXXXXXXXXXXXXXXXXXXXXXXXXXX-----------gg----XXXXXXXXXX-----------XXX--g----XXXXXXXX-----------XXXXXXXXXXXXXXXXXX---ooooo-------oooooo-XXXXXXXXXXX-oooo--XXXXX
XXXXXXXXXXXXXXXXXXXX--------g--XXXXXXXXX--XXXXXXXXXXXXXXXXXXXXXXXXXXXXXXXXXXXXXXXXXXXXXXXXXXXXXXXXXXXXXXXXXXXXXXXXXXXXXXXXXXXXXXXXXXXXXXXXXXXXXXXXXXXXXXXXX----------------------XXXXXXXXXXX-------XXXXX
XXXXXXXXXXXXXXXXXXXXXXXXXXXXXXXXXXXXXXXXXXXXXXXXXXXXXXXXXXXXXXXXXXXXXXXXXXXXXXXXXXXXXXXXXXXXXXXXXXXXXXXXXXXXXXXXXXXXXXXXXXXXXXXXXXXXXXXXXXXXXXXXXXXXXXXXXXXXXXXXXXXXXXXXXXXXXXXXXXXXXXXXXXXXXXXXXXXXXXXX

