--------------------------------------------------------------------------------------------------------------------------------------------------------------------------------------------------------
--------------------------------------------------------------------------------------------------------------------------------------------------------------------------------------------------------
--------------------------------------------------------------------------------------------------------------------------------------------------------------------------------------------------------
--------------------------------------------------------------------------------------------------------------------------------------------------------------------------------------------------------
--------------------------------------------------------------------------------------------------------------------------------------------------------------------------------------------------------
--------------------------------------------------------------------------------------------------------------------------------------------------------------------------------------------------------
--------------------------------------------------------------------------------------------------------------------------------------------------------------------------------------------------------
--------------------------------------------------------------------------------------------------------------------------------------------------------------------------------------------------------
--------------------------------------------------------------------------------------------------------------------------------------------------------------------------------------------------------
--------------------------------------------------------------------------------------------------------------------------------------------------------------------------------------------------------
--------------------------------------------------------------------------------------------------------------------------------------------------------------------------------------------------------
--------------------------------------------------------------------------------------------------------------------------------------------------------------------------------------------------------
-------------------------------------oooo---------------ooooS---------------------------------------------------------------------------------------------oSoooo----------------------------------------
---------------------------------------------------------------------------------------------------SSoSS------------------------------------------------------------------------------------------------
---------------------ooo------------ooo------------------oooo------------------------------------------------------------------------------------oooS------ooooooo-----------------ooS------------------
-----------------------------------------------------------------ooo---------oo-----oooo-------------oo-------SSoSoo--oSSSo-----------------------------------------------------------------------------
XXXXXXXXXXXXX------XXXXXX----------XXXXXXXX--XXX-------XXXXXXXXX----------------------------------------------------------------XX--oo------------------XXXXXXXXXXX------------XX-----------------------
XXXXXXXXXXXXX------XXXXXXXXXXXXXXXXXXXXXXXX--XXX-------XXXXXXXXXXXXXXXX---XXXXXXXXXXXXXXXX-ooooo-XXXXXXXXX----ooo-------ooo-----XX--------XXXXXX-g------XXXXXXXXXXX-----XXXXXXXXX----------------XXXX---
XXXXXXXXXXXXXXX----XXXXXXXXXXXXXXXXXXXXXXXXXXXXX-------XXXXXXXXXXXXXXXX---XXXXXXXXXXXXXXXX-------XXXXXXXXX--g---------------XXXXXXXXXXXXXXXXXXXXXXXXXXXXXXXXXXXXXXX-----XXXXXXXXXXXXXXXX---------XXXXXXX
XXXXXXXXXXXXXXXXXXXXXXXXXXXXXXXXXXXXXXXXXXXXXXXXXXXXXXXXXXXXXXXXXXXXXXXXXXXXXXXXXXXXXXXXXXXXXXXXXXXXXXXXXXXXXXXXXXXXXXXXXXXXXXXXXXXXXXXXXXXXXXXXXXXXXXXXXXXXXXXXXXXXXXXXXXXXXXXXXXXXXXXXXXXXXXXXXXXXXXXX

