--------------------------------------------------------------------------------------------------------------------------------------------------------------------------------------------------------
--------------------------------------------------------------------------------------------------------------------------------------------------------------------------------------------------------
--------------------------------------------------------------------------------------------------------------------------------------------------------------------------------------------------------
--------------------------------------------------------------------------------------------------------------------------------------------------------------------------------------------------------
--------------------------------------------------------------------------------------------------------------------------------------------------------------------------------------------------------
--------------------------------------------------------------------------------------------------------------------------------------------------------------------------------------------------------
--------------------------------------------------------------------------------------------------------------------------------------------------------------------------------------------------------
--------------------------------------------------------------------------------------------------------------------------------------------------------------------------------------------------------
--------------------------------------------------------------------------------------------------------------------------------------------------------------------------------------------------------
--------------------------------------------------------------------------------------------------------------------------------------------------------------------------------------------------------
--------------------------------------------------------------------------------------------------------------------------------------------------------------------------------------------------------
--------------------------------------------------------------------------------------------------------------------------------------------------------------------------------------------------------
------------------------------------------------------------------------ooSooooo------------------------------------------------------------------------------------------------------------------------
------------------------oSo--------------------------------------------------------Soo--------------------------------------------------------------------ooS------------oooSSoSSo-----SSoSo------------
---------------------------------------ooooo------------------------------oooo---------------------------------------------oSoooo-----------------------------------------------------------------------
------------------------ooo-------------------ooSSoo--------oSooooSS---g----------ooo----------oooooo-------------------------------SSSSo------oSSooo--oooooo---ooSo-----oooooooo---oooooo--------ooooo-
----------------------------------------------------------------------XXXXXXXXXXX---------------------XX---------oo------ooooo-----------------------------------------------------------------------g--
XXXXXXXXXXXXXX--------XXXXXXX------------------ooooooo--XXX--oooooooo-XXXXXXXXXXXXXXXXXXX-------ooo---XX---XX-------XXXX-------------oooo-XXXX---oooo-XXXXXXXXX----oooo-XXXXXXXXXXXXXXXXXXXXX----XXXXXXX
XXXXXXXXXXXXXXXXXXX---XXXXXXXXXXXXXXXXXXXXXXX-----------XXX-----------XXXXXXXXXXXXXXXXXXX-----g-------XXXXXXXXXXXXXXXXXXXXXXXXXXXX--------XXXX-----g--XXXXXXXXX---------XXXXXXXXXXXXXXXXXXXXXXXXXXXXXXXX
XXXXXXXXXXXXXXXXXXXXXXXXXXXXXXXXXXXXXXXXXXXXXXXXXXXXXXXXXXXXXXXXXXXXXXXXXXXXXXXXXXXXXXXXXXXXXXXXXXXXXXXXXXXXXXXXXXXXXXXXXXXXXXXXXXXXXXXXXXXXXXXXXXXXXXXXXXXXXXXXXXXXXXXXXXXXXXXXXXXXXXXXXXXXXXXXXXXXXXXX

