--------------------------------------------------------------------------------------------------------------------------------------------------------------------------------------------------------
--------------------------------------------------------------------------------------------------------------------------------------------------------------------------------------------------------
--------------------------------------------------------------------------------------------------------------------------------------------------------------------------------------------------------
--------------------------------------------------------------------------------------------------------------------------------------------------------------------------------------------------------
--------------------------------------------------------------------------------------------------------------------------------------------------------------------------------------------------------
--------------------------------------------------------------------------------------------------------------------------------------------------------------------------------------------------------
--------------------------------------------------------------------------------------------------------------------------------------------------------------------------------------------------------
--------------------------------------------------------------------------------------------------------------------------------------------------------------------------------------------------------
--------------------------------------------------------------------------------------------------------------------------------------------------------------------------------------------------------
--------------------------------------------------------------------------------------------------------------------------------------------------------------------------------------------------------
--------------------------------------------------------------------------------------------------------------------------------------------------------------------------------------------------------
--------------------------------------------------------------------------------------------------------------------------------------------------------------------------------------------------------
-------------------------------------------------oSoSSoo--------------------------------------------oooo-----ooo---------------------------------------------------------ooo----------------------------
----------------------------ooooSoSoo-------------------------------------------------------------------------------oooSSoS-----------------------------------------------------------------------------
-------------------Soo--------------------oo-----ooooooo----------------------SSS----------------oooo--------oo-----------------------------ooo--------------------------ooo----------------------------
----------------------------oooooo--------------------g---------------g------------------ooSo-------------------------ooo---------------------------------------oooo------------------------------------
XXXXXXXXXXXXXXXX-ooooo----------------XXXXXXXXXXXXXXXXXXX---XX----XXXXXXX----oooooo-------------XXXXXXXXXXXXXXXXXX--------------------------oooo---XXXXX--------g----XXXXXXXXXX----------XXXX-----------
XXXXXXXXXXXXXXXX-----------XXXXXXXXXXXXXXXXXXXXXXXXXXXXXX---XX----XXXXXXX----------------ooooo--XXXXXXXXXXXXXXXXXXXXXXXXXXXXX---ooo----------------XXXXX-------XXXXXXXXXXXXXXXX----------XXXX--XXXXX----
XXXXXXXXXXXXXXXXXXXXXXX----XXXXXXXXXXXXXXXXXXXXXXXXXXXXXX---XXXXXXXXXXXXX--XXXXXXXXXX-----------XXXXXXXXXXXXXXXXXXXXXXXXXXXXX-------XXXXXXXXXXXXXXXXXXXXXXXXX--XXXXXXXXXXXXXXXXXXXXX-----XXXXXXXXXXX----
XXXXXXXXXXXXXXXXXXXXXXXXXXXXXXXXXXXXXXXXXXXXXXXXXXXXXXXXXXXXXXXXXXXXXXXXXXXXXXXXXXXXXXXXXXXXXXXXXXXXXXXXXXXXXXXXXXXXXXXXXXXXXXXXXXXXXXXXXXXXXXXXXXXXXXXXXXXXXXXXXXXXXXXXXXXXXXXXXXXXXXXXXXXXXXXXXXXXXXXX

