--------------------------------------------------------------------------------------------------------------------------------------------------------------------------------------------------------
--------------------------------------------------------------------------------------------------------------------------------------------------------------------------------------------------------
--------------------------------------------------------------------------------------------------------------------------------------------------------------------------------------------------------
--------------------------------------------------------------------------------------------------------------------------------------------------------------------------------------------------------
--------------------------------------------------------------------------------------------------------------------------------------------------------------------------------------------------------
--------------------------------------------------------------------------------------------------------------------------------------------------------------------------------------------------------
--------------------------------------------------------------------------------------------------------------------------------------------------------------------------------------------------------
--------------------------------------------------------------------------------------------------------------------------------------------------------------------------------------------------------
--------------------------------------------------------------------------------------------------------------------------------------------------------------------------------------------------------
--------------------------------------------------------------------------------------------------------------------------------------------------------------------------------------------------------
--------------------------------------------------------------------------------------------------------------------------------------------------------------------------------------------------------
--------------------------------------------------------------------------------------------------------------------------------------------------------------------------------------------------------
--------------------------------------------------ooS-------------------------------------------------------------------------------------------------------------------------oooSo---------------------
-------------ooSoSSo------------------------------------------------------------SSS---------------------------------------------------------------------------------------------------------------------
------------------------oSooSSo-------------oSoo--oo----------SoS----ooSSSSSo------------oooSoooo------------------------------------ooS-------ooooooo--------------------------ooo---------------------
----------------ooooo-----------------------------------------------------------oooo-------------------------------Soooooo-----------------------------------------------------------------oooooo-------
XXXXXXXXXXXX--------------ooooooo---------oooo---XXXXXXXXXXX---oooo----oooooo---------------oooooo-XXXXX---------------------oooo-----oooo--XX----ooo---------------oo-------XXXXXXXXXX-----------------
XXXXXXXXXXXXXXXXXXXXXXX--------------------------XXXXXXXXXXX-------------g----XXXXXXXX-------------XXXXXXXXX-------ooooo--------------------XX--------------ooo--------------XXXXXXXXXX-oooooo----------
XXXXXXXXXXXXXXXXXXXXXXXXXXXXXXXXXXXXXXXXXXXXXXXXXXXXXXXXXXXXXXXXXXXXXXXXXXXXXXXXXXXXXXXXXXXXXXXXXXXXXXXXXXXXXXXXX----------XXXXXXXXXXXXXXXXXXXXXXXXXXXXX---------XXXXXXXXXXXXXXXXXXXXXX----------------X
XXXXXXXXXXXXXXXXXXXXXXXXXXXXXXXXXXXXXXXXXXXXXXXXXXXXXXXXXXXXXXXXXXXXXXXXXXXXXXXXXXXXXXXXXXXXXXXXXXXXXXXXXXXXXXXXXXXXXXXXXXXXXXXXXXXXXXXXXXXXXXXXXXXXXXXXXXXXXXXXXXXXXXXXXXXXXXXXXXXXXXXXXXXXXXXXXXXXXXXX

