--------------------------------------------------------------------------------------------------------------------------------------------------------------------------------------------------------
--------------------------------------------------------------------------------------------------------------------------------------------------------------------------------------------------------
--------------------------------------------------------------------------------------------------------------------------------------------------------------------------------------------------------
--------------------------------------------------------------------------------------------------------------------------------------------------------------------------------------------------------
--------------------------------------------------------------------------------------------------------------------------------------------------------------------------------------------------------
--------------------------------------------------------------------------------------------------------------------------------------------------------------------------------------------------------
--------------------------------------------------------------------------------------------------------------------------------------------------------------------------------------------------------
--------------------------------------------------------------------------------------------------------------------------------------------------------------------------------------------------------
--------------------------------------------------------------------------------------------------------------------------------------------------------------------------------------------------------
--------------------------------------------------------------------------------------------------------------------------------------------------------------------------------------------------------
--------------------------------------------------------------------------------------------------------------------------------------------------------------------------------------------------------
--------------------------------------------------------------------------------------------------------------------------------------------------------------------------------------------------------
--------------------------------------------------------------------------------------------------------------------------------------ooo--------------------------SooooS---------------oSoooo----------
----------------------------------------------------------------------------------------------------------------------------Soooo-------------oooSS-----------------------------------------------------
---------------------oooS-----oooSo-------------------------------------------oSoo------oo-------------------ooo------------------------------------------oSSS-------ooo-----------------oooooo---------
-----------------------------------------------ooSoo--------------------------------------------------------g------oSSooo--oooooo--------------oooo-------------------------------oSSo----------g-------
XXXXXXXXXXXXXX-----ooooo------oooooo---------------------------------oooo--------ooo--XXXXXXXX------------XXXXXXX---------------g---XXXXXX-----------------ooooo-XXXXXXXXXX------------XXXXXXXXXXX------
XXXXXXXXXXXXXX------g---------------------ooo----ooo----XXXXXX------------------------XXXXXXXX---g---oo---XXXXXXX-ooooooo-XXXXXXXXXXXXXXXX---XXXXXXXXXX----------XXXXXXXXXX-oooo----oo-XXXXXXXXXXX------
XXXXXXXXXXXXXX---XXXXXXXXXXXXXXXXXXXXX------------------XXXXXXXXXXXXXXXXXXXXXXXXXXXXXXXXXXXXXXXXXXXX------XXXXXXX---------XXXXXXXXXXXXXXXX---XXXXXXXXXXXXXXXXXXXXXXXXXXXXXX------------XXXXXXXXXXXXXXXXX
XXXXXXXXXXXXXXXXXXXXXXXXXXXXXXXXXXXXXXXXXXXXXXXXXXXXXXXXXXXXXXXXXXXXXXXXXXXXXXXXXXXXXXXXXXXXXXXXXXXXXXXXXXXXXXXXXXXXXXXXXXXXXXXXXXXXXXXXXXXXXXXXXXXXXXXXXXXXXXXXXXXXXXXXXXXXXXXXXXXXXXXXXXXXXXXXXXXXXXXX

