--------------------------------------------------------------------------------------------------------------------------------------------------------------------------------------------------------
--------------------------------------------------------------------------------------------------------------------------------------------------------------------------------------------------------
--------------------------------------------------------------------------------------------------------------------------------------------------------------------------------------------------------
--------------------------------------------------------------------------------------------------------------------------------------------------------------------------------------------------------
--------------------------------------------------------------------------------------------------------------------------------------------------------------------------------------------------------
--------------------------------------------------------------------------------------------------------------------------------------------------------------------------------------------------------
--------------------------------------------------------------------------------------------------------------------------------------------------------------------------------------------------------
--------------------------------------------------------------------------------------------------------------------------------------------------------------------------------------------------------
--------------------------------------------------------------------------------------------------------------------------------------------------------------------------------------------------------
--------------------------------------------------------------------------------------------------------------------------------------------------------------------------------------------------------
--------------------------------------------------------------------------------------------------------------------------------------------------------------------------------------------------------
--------------------------------------------------------------------------------------------------------------------------------------------------------------------------------------------------------
-------------ooSo------------------------oooS-----------------------------------------------------------------------------------------------------------------------------------------------------------
---------------------ooooooSo--------------------------------------------------------------------------SSooo-------------------------------------------oSooooo------------------------------------------
--------------ooo-----------------------ooooo-----------------------------------------------------------------------SSo---------------------------------------------------------------------------------
--------------------oooooo-------------------------SSo-------------------------------------------------ooooo----------------oooo--------------------------oo--------------------------------------------
-----------XXXXXXXX--------------------XXXXXXXXX--------------------------------XXXXXXX-----------------------------oooooo----------XX------XXXXXXXXXX--------------oo----XXXXXXX-----------------------
-----------XXXXXXXXXXXXXXXXXXX---------XXXXXXXXX--ooooo-XXXXXX---oo-------XXX---XXXXXXX------------XXXXXXXXXX---------------ooooo---XX------XXXXXXXXXXXXXXXXXXXX----------XXXXXXX------------------oo--X
XXXXXXXXXXXXXXXXXXXXXXXXXXXXXX------XXXXXXXXXXXX------g-XXXXXX--------XXXXXXX---XXXXXXXXXXX-g------XXXXXXXXXX-----XXXXXXXXX---------XXXXXXXXXXXXXXXXXXXXXXXXXXXXXXXXXXXXXXXXXXXXX------XXXXXXXXXX------X
XXXXXXXXXXXXXXXXXXXXXXXXXXXXXXXXXXXXXXXXXXXXXXXXXXXXXXXXXXXXXXXXXXXXXXXXXXXXXXXXXXXXXXXXXXXXXXXXXXXXXXXXXXXXXXXXXXXXXXXXXXXXXXXXXXXXXXXXXXXXXXXXXXXXXXXXXXXXXXXXXXXXXXXXXXXXXXXXXXXXXXXXXXXXXXXXXXXXXXXX

