--------------------------------------------------------------------------------------------------------------------------------------------------------------------------------------------------------
--------------------------------------------------------------------------------------------------------------------------------------------------------------------------------------------------------
--------------------------------------------------------------------------------------------------------------------------------------------------------------------------------------------------------
--------------------------------------------------------------------------------------------------------------------------------------------------------------------------------------------------------
--------------------------------------------------------------------------------------------------------------------------------------------------------------------------------------------------------
--------------------------------------------------------------------------------------------------------------------------------------------------------------------------------------------------------
--------------------------------------------------------------------------------------------------------------------------------------------------------------------------------------------------------
--------------------------------------------------------------------------------------------------------------------------------------------------------------------------------------------------------
--------------------------------------------------------------------------------------------------------------------------------------------------------------------------------------------------------
---------------------oSSSoS-----------------------------------------------------------------------------------------------------------------------------------------------------------------------------
--------------------------------------------------------------------------------------------------------------------------------------------------------------------------------------------------------
-----------------------ooooo----------------------------------------------------------------------------------------------------------------------------------------------------------------------------
----------------------------------------------------------------------------------------------------------------------------------------------------oooo--------------------------ooo-------------------
------------oooooo---%%%%%%%---------------------oSooSSS------------------------------------------------------oSooSo---------------------------------------------------ooo------------------------------
---------------------|||||||-------------------------------oSooSo---------------------SSoSSS-----------------------------------------------------------oo--oooSoooSo--------------%%%--------------ooo--
---------------oooo--|||||||-------SoSSSooo--------oooo----------------------ooo----------------------oSoo----ooooooo--ooS----------------------------------------------oooo------|||-------------------
--------------------XXXXXXXXXXXXX------------------g--------oooooo------oo-----g--------oo------XXXXX----------------------------------------------XXXXXXX---oooooo---------------|||-------------XXXXXX
-----------XXXXXXXXXXXXXXXXXXXXXX-oooooooo------XXXXXXXXXX-----------------XXXXXXXXX----gg------XXXXX-------XXXXXXXXXX----ooo-XXXX---------XXXXXXXXXXXXXXX-----------XXXXXXXXX---g|||--------XXXXXXXXXXX
XXXXXXXXXXXXXXXXXXXXXXXXXXXXXXXXX---------------XXXXXXXXXXXXXXXXXXXXXXXXXXXXXXXXXXXXXXXXXXXXXXXXXXXXX-------XXXXXXXXXX--------XXXXXXXXXXXXXXXXXXXXXXXXXXXXXXXXXXXXXXXXXXXXXXXX--XXXXXXXXXXXXXXXXXXXXXXXX
XXXXXXXXXXXXXXXXXXXXXXXXXXXXXXXXXXXXXXXXXXXXXXXXXXXXXXXXXXXXXXXXXXXXXXXXXXXXXXXXXXXXXXXXXXXXXXXXXXXXXXXXXXXXXXXXXXXXXXXXXXXXXXXXXXXXXXXXXXXXXXXXXXXXXXXXXXXXXXXXXXXXXXXXXXXXXXXXXXXXXXXXXXXXXXXXXXXXXXXX

