--------------------------------------------------------------------------------------------------------------------------------------------------------------------------------------------------------
--------------------------------------------------------------------------------------------------------------------------------------------------------------------------------------------------------
--------------------------------------------------------------------------------------------------------------------------------------------------------------------------------------------------------
--------------------------------------------------------------------------------------------------------------------------------------------------------------------------------------------------------
--------------------------------------------------------------------------------------------------------------------------------------------------------------------------------------------------------
--------------------------------------------------------------------------------------------------------------------------------------------------------------------------------------------------------
--------------------------------------------------------------------------------------------------------------------------------------------------------------------------------------------------------
--------------------------------------------------------------------------------------------------------------------------------------------------------------------------------------------------------
--------------------------------------------------------------------------------------------------------------------------------------------------------------------------------------------------------
--------------------------------------------------------------------------------------------------------------------------------------------------------------------------------------------------------
--------------------------------------------------------------------------------------------------------------------------------------------------------------------------------------------------------
--------------------------------------------------------------------------------------------------------------------------------------------------------------------------------------------------------
--------------------------------ooo-------------------------------------------------------oSo---------------------Soo-----------------------------------------------------------------------------------
-------------------------------------------------oSoo-------------------------------------------------------------------------oooo----------------------------------------------------------ooooo-------
-------------------------------ooo--------------------------------------------------------ooooo--------------------oooo---------------Soo---------------SoS----------SooS-----------oooS----------------
-----------------------oooo-------------------oooooo---------------oo----------------------------------oSooSS-------------------------------ooooooo-----------------------------------------oooooo------
XXXXXXXXXXXXXX--------------XXXXXXXX-------XX-------g-----------------g---------------XXXXXXXXXX---------------XXXXXXXXX--------------ooo--------------oo------------ooooo----------ooooo--------------X
XXXXXXXXXXXXXX--------oooo--XXXXXXXX-------XXXXXXXXXXXXXXXX-----XXXXXXXXX----oo-XXXXXXXXXXXXXXXX--------ooo----XXXXXXXXX-----XXXXXX-----------oooooo--------------------g-----------------XXXXXXXXXXXXXX
XXXXXXXXXXXXXXXXXXX---g-----XXXXXXXXXXXX---XXXXXXXXXXXXXXXX-----XXXXXXXXX-------XXXXXXXXXXXXXXXX---------------XXXXXXXXX-----XXXXXXXXXXXXXX-----------XXXXXXX----XXXXXXXXXX-------XXXXXXXXXXXXXXXXXXXXXX
XXXXXXXXXXXXXXXXXXXXXXXXXXXXXXXXXXXXXXXXXXXXXXXXXXXXXXXXXXXXXXXXXXXXXXXXXXXXXXXXXXXXXXXXXXXXXXXXXXXXXXXXXXXXXXXXXXXXXXXXXXXXXXXXXXXXXXXXXXXXXXXXXXXXXXXXXXXXXXXXXXXXXXXXXXXXXXXXXXXXXXXXXXXXXXXXXXXXXXXX

