--------------------------------------------------------------------------------------------------------------------------------------------------------------------------------------------------------
--------------------------------------------------------------------------------------------------------------------------------------------------------------------------------------------------------
--------------------------------------------------------------------------------------------------------------------------------------------------------------------------------------------------------
--------------------------------------------------------------------------------------------------------------------------------------------------------------------------------------------------------
--------------------------------------------------------------------------------------------------------------------------------------------------------------------------------------------------------
--------------------------------------------------------------------------------------------------------------------------------------------------------------------------------------------------------
--------------------------------------------------------------------------------------------------------------------------------------------------------------------------------------------------------
--------------------------------------------------------------------------------------------------------------------------------------------------------------------------------------------------------
------------------------------------------------------------------------------------------------------------------------------------------------------------------------------------------------g-g-----
----------------------------------------------------------------------------------------------%%%%%%%-----------------------------------------------------------------------------------------%%%%%%----
----------------------------------------------------------------------------------------------|||||||-----------------------------------------------------------------------------------------||||||----
----------------------------------------------oo----------------------------------------------|||||||-----------------------------------------------------------------------------------------||||||----
-----------------------------------------------------------------oooSo--------------------g---|||||||-------oSSoo----------ooS-------------------------------------------------------------%%%%%%|||----
--------------ooS-----------------------------%%%%----------------------------------------%%%%%%|||||---------------------------------------oSo--------------------------------------------|||||||||----
----------------------------------------------||||--------SSo-----------------------------|||||||||||------ooo-------------------------------------------------------ooooo------oooSSoSoo--|||||||||----
--------------ooo---------------ooSo----------|%%%%%%-------------------------------------|g|||||||||----------------------g----------------ooo------------ooSoo---------------------------|||||||||----
----------------------------------------------|||||||---ooooo---XXXXXXX-------------XXXXXXXXXXXXXXXXXXXXXXXXXXXXXX--tt-XXXXXXXXX------XX--------XXX-----------------ooo---------oooooooo--XXXXXXXXXXXXXX
-------------XXXXXXX----------ooo----XXX------|||||||-----------XXXXXXX-------------XXXXXXXXXXXXXXXXXXXXXXXXXXXXXX--tt-XXXXXXXXXXX----XXXXXXXXXXXXX-ooo-----oooo---------------------g----XXXXXXXXXXXXXX
-------------XXXXXXXXXXXXXXX----g----XXXXXXXXXXXXXXXXXXXXXXXXXXXXXXXXXXXX---------XXXXXXXXXXXXXXXXXXXXXXXXXXXXXXXXXXXXXXXXXXXXXXXX----XXXXXXXXXXXXX---------------XXXXXXXXXXXXXXXXXXXXXXXXXXXXXXXXXXXXXX
XXXXXXXXXXXXXXXXXXXXXXXXXXXXXXXXXXXXXXXXXXXXXXXXXXXXXXXXXXXXXXXXXXXXXXXXXXXXXXXXXXXXXXXXXXXXXXXXXXXXXXXXXXXXXXXXXXXXXXXXXXXXXXXXXXXXXXXXXXXXXXXXXXXXXXXXXXXXXXXXXXXXXXXXXXXXXXXXXXXXXXXXXXXXXXXXXXXXXXXX

