--------------------------------------------------------------------------------------------------------------------------------------------------------------------------------------------------------
--------------------------------------------------------------------------------------------------------------------------------------------------------------------------------------------------------
--------------------------------------------------------------------------------------------------------------------------------------------------------------------------------------------------------
--------------------------------------------------------------------------------------------------------------------------------------------------------------------------------------------------------
--------------------------------------------------------------------------------------------------------------------------------------------------------------------------------------------------------
--------------------------------------------------------------------------------------------------------------------------------------------------------------------------------------------------------
--------------------------------------------------------------------------------------------------------------------------------------------------------------------------------------------------------
--------------------------------------------------------------------------------------------------------------------------------------------------------------------------------------------------------
--------------------------------------------------------------------------------------------------------------------------------------------------------------------------------------------------------
--------------------------------------------------------------------------------------------------------------------------------------------------------------------------------------------------------
--------------------------------------------------------------------------------------------------------------------------------------------------------------------------------------------------------
--------------------------------------------------------------------------------------------------------------------------------------------------------------------------------------------------------
-----------------------------------------------------------------------------------------------------------------------------------oSSoooo------------------------oSS-----ooSS--------------oSSS--------
---------------------oSSSSoooo--------------oooo-------------------ooooSo-------------------------------------------------------------------------------------------------------------------------------
----------------------------------------------------------------------------------------------------------------------------------oooooooo-------------------------------ooooo---------------ooooo------
--------------ooo-----ooooooo------ooo--------oooo-------ooSooo--ooooooo-----oSoSS----ooooS---oo-----oSS-----------------------------------------------oooo---------------------------------------------
----------XXX--------------------------------------------------------------------------------------------------------------------XXXXXXXXXXXXX-----------g-------XXXXXXXXXXXXXXX------oooo-XXXXXXXX-----
----------XXXXXXXXXXXXXXXXXXXXX--ooooo----XXXXXXXXX--------ooo--XXXXXXXXXXX----ooooo----oo---XXXXXXX-----------XXX----oo--XXXXXXXXXXXXXXXXXXXX------XXXXXXXX-----XXXXXXXXXXXXXXXXXXXX------XXXXXXXXXXXXX
----------XXXXXXXXXXXXXXXXXXXXX-----------XXXXXXXXX-------------XXXXXXXXXXX-------g----------XXXXXXX-------XXXXXXX--------XXXXXXXXXXXXXXXXXXXX------XXXXXXXXXXXXXXXXXXXXXXXXXXXXXXXXXXXXXXXXXXXXXXXXXXXX
XXXXXXXXXXXXXXXXXXXXXXXXXXXXXXXXXXXXXXXXXXXXXXXXXXXXXXXXXXXXXXXXXXXXXXXXXXXXXXXXXXXXXXXXXXXXXXXXXXXXXXXXXXXXXXXXXXXXXXXXXXXXXXXXXXXXXXXXXXXXXXXXXXXXXXXXXXXXXXXXXXXXXXXXXXXXXXXXXXXXXXXXXXXXXXXXXXXXXXXX

