--------------------------------------------------------------------------------------------------------------------------------------------------------------------------------------------------------
--------------------------------------------------------------------------------------------------------------------------------------------------------------------------------------------------------
--------------------------------------------------------------------------------------------------------------------------------------------------------------------------------------------------------
--------------------------------------------------------------------------------------------------------------------------------------------------------------------------------------------------------
--------------------------------------------------------------------------------------------------------------------------------------------------------------------------------------------------------
--------------------------------------------------------------------------------------------------------------------------------------------------------------------------------------------------------
--------------------------------------------------------------------------------------------------------------------------------------------------------------------------------------------------------
--------------------------------------------------------------------------------------------------------------------------------------------------------------------------------------------------------
--------------------------------------------------------------------------------------------------------------------------------------------------------------------------------------------------------
--------------------------------------------------------------------------------------------------------------------------------------------------------------------------------------------------------
--------------------------------------------------------------------------------------------------------------------------------------------------------------------------------------------------------
--------------------------------------------------------------------------------------------------------------------------------------------------------------------------------------------------------
---------------------------------------------------------------------------------------------------oSoo--------------------------------ooSS-------------------------------------------------------------
-----------------------------------------ooooSSoSo---------------ooooooSS---------------------SSo--------------Soo-------------------------------------oSo------------ooo----------------------oooooo---
-----------------------------------------------------ooooSo-------------------------------------------oo-------------------------------ooooo--oSoooo--------oSS-----------------------------------------
--------------------------------------------ooooo----------------ooooooooo------------------------------------------------------------------------------oo-----------oo-----------oSo-----------oooo----
----------------------------ooooooo-XXXX------------oooooooo---------------XX---------------------XXXXXXX----------------------------XXXXXXXX-ooo------------ooo----------------------------------------
XXXXXXXXXXXXX-----XXXXXXXX----------XXXXXXXXXXXXXXX-------------XXXXXXXXXXXXXXXX-----XXXXXXXXXXXXXXXXXXXX----XXXXXXXXXXXX-------XXXXXXXXXXXXX--------XXXXXX--------XXXXXXX--------oooo---XXXXXXXXXXXXXXX
XXXXXXXXXXXXX-----XXXXXXXXXXXXXXXXXXXXXXXXXXXXXXXXXXXXXXXXXXXXXXXXXXXXXXXXXXXXXXXXXXXXXXXXXXXXXXXXXXXXXXXXXXXXXXXXXXXXXXXXX-----XXXXXXXXXXXXXXXXXXXXXXXXXXXXXXXXXXXXXXXXXXXXXXXX---------XXXXXXXXXXXXXXX
XXXXXXXXXXXXXXXXXXXXXXXXXXXXXXXXXXXXXXXXXXXXXXXXXXXXXXXXXXXXXXXXXXXXXXXXXXXXXXXXXXXXXXXXXXXXXXXXXXXXXXXXXXXXXXXXXXXXXXXXXXXXXXXXXXXXXXXXXXXXXXXXXXXXXXXXXXXXXXXXXXXXXXXXXXXXXXXXXXXXXXXXXXXXXXXXXXXXXXXX

