--------------------------------------------------------------------------------------------------------------------------------------------------------------------------------------------------------
--------------------------------------------------------------------------------------------------------------------------------------------------------------------------------------------------------
--------------------------------------------------------------------------------------------------------------------------------------------------------------------------------------------------------
--------------------------------------------------------------------------------------------------------------------------------------------------------------------------------------------------------
--------------------------------------------------------------------------------------------------------------------------------------------------------------------------------------------------------
--------------------------------------------------------------------------------------------------------------------------------------------------------------------------------------------------------
--------------------------------------------------------------------------------------------------------------------------------------------------------------------------------------------------------
--------------------------------------------------------------------------------------------------------------------------------------------------------------------------------------------------------
--------------------------------------------------------------------------------------------------------------------------------------------------------------------------------------------------------
--------------------------------------------------------------------------------------------------------------------------------------------------------------------------------------------------------
--------------------------------------------------------------------------------------------------------------------------------------------------------------------------------------------------------
--------------------------------------------------------------------------------------------------------------------------------------------------------------------------------------------------------
-----------------ooooo----------------------------------------------------------------------------------------------------------------------------------------------------------------------------------
---------------------------------------------------------------------------------oSoSSSS--------------------------------------------------------------------------oooSoo--------------------------------
----------------oooooo----------oSSooo------ooo--------oooo------------------------------------------------------------------------------------------------------------------------ooSoooo--------oo----
----------------------------------------------------------------------------------oooooo--------------------SSSSo-----------------------------------------------oooooooo--------------------------------
-------------XXXXXXXXXX------------ooo---ooooo---XXXXXXXXXXXXXX--oooo------ooo---------------------------------------oo----------------------XXXX---------------g---------------------ooo--------XXXXXXX
-------------XXXXXXXXXX----------g---------------XXXXXXXXXXXXXX-------XXXX------XXXXXXXXXX--XXXXXXX---g------ooo-----------------------------XXXX-------ooo---XXXXXXXXXXX------------------------XXXXXXX
-------------XXXXXXXXXX--------XXXXXXXXXXXXXXXXXXXXXXXXXXXXXXXXXXXXXXXXXXXXXXXXXXXXXXXXXXXXXXXXXXXXXXXXXX---------XXXXXXXX--------------XXXXXXXXXXXXXXX-------XXXXXXXXXXX----g----XXXXXXXXX------XXXXXXX
XXXXXXXXXXXXXXXXXXXXXXXXXXXXXXXXXXXXXXXXXXXXXXXXXXXXXXXXXXXXXXXXXXXXXXXXXXXXXXXXXXXXXXXXXXXXXXXXXXXXXXXXXXXXXXXXXXXXXXXXXXXXXXXXXXXXXXXXXXXXXXXXXXXXXXXXXXXXXXXXXXXXXXXXXXXXXXXXXXXXXXXXXXXXXXXXXXXXXXXX

