--------------------------------------------------------------------------------------------------------------------------------------------------------------------------------------------------------
--------------------------------------------------------------------------------------------------------------------------------------------------------------------------------------------------------
--------------------------------------------------------------------------------------------------------------------------------------------------------------------------------------------------------
--------------------------------------------------------------------------------------------------------------------------------------------------------------------------------------------------------
--------------------------------------------------------------------------------------------------------------------------------------------------------------------------------------------------------
--------------------------------------------------------------------------------------------------------------------------------------------------------------------------------------------------------
--------------------------------------------------------------------------------------------------------------------------------------------------------------------------------------------------------
--------------------------------------------------------------------------------------------------------------------------------------------------------------------------------------------------------
--------------------------------------------------------------------------------------------------------------------------------------------------------------------------------------------------------
--------------------------------------------------------------------------------------------------------------------------------------------------------------------------------------------------------
--------------------------------------------------------------------------------------------------------------------------------------------------------------------------------------------------------
--------------------------------------------------------------------------------------------------------------------------------------------------------------------------------------------------------
-------------------------------------------------------------------------------------SoSo---------------------------------------------------oSooo----------------------------SSoSo----------------------
---------------------ooo------------------------------------------------------------------------------------------------------ooSSo------------------------oooo----------------------------oSSoo--------
------------------------------------SoSo---------------------------------------------ooo-------------------SooSSoo-----------------------------ooooo--------------------------ooo-----------------------
--------------oSo----oo--------------------------------------------------------------g-------oooooo-------------------SSo---oooooo-------------------------oooo-----------------g----------ooooo----ooo-
------------------------------------oooo---XXXXXX------XXXXXX------------oooo-XXXXXXXXXXXXXX--------------oooooo---------------------XXXXXXXXXXXXXXXX------------XXXXXXXXXXXXXXXXXXXXXXXXX-g------------
XXXXXXXXXXXXX------XXXXXXX-----------------XXXXXX------XXXXXXXXXXXXXX-------g-XXXXXXXXXXXXXXXXXXXXXXX---------------ooo----XXXXXXXXXXXXXXXXXXXXXXXXXX----XXXXXXXXXXXXXXXXXXXXXXXXXXXXXXXXXXXXXXXXXXXXXXX
XXXXXXXXXXXXX------XXXXXXX--------XXXXXXXXXXXXXXX------XXXXXXXXXXXXXXXXXXXXXXXXXXXXXXXXXXXXXXXXXXXXXXXXXXXXXXXXXXXX--------XXXXXXXXXXXXXXXXXXXXXXXXXX----XXXXXXXXXXXXXXXXXXXXXXXXXXXXXXXXXXXXXXXXXXXXXXX
XXXXXXXXXXXXXXXXXXXXXXXXXXXXXXXXXXXXXXXXXXXXXXXXXXXXXXXXXXXXXXXXXXXXXXXXXXXXXXXXXXXXXXXXXXXXXXXXXXXXXXXXXXXXXXXXXXXXXXXXXXXXXXXXXXXXXXXXXXXXXXXXXXXXXXXXXXXXXXXXXXXXXXXXXXXXXXXXXXXXXXXXXXXXXXXXXXXXXXXX

