--------------------------------------------------------------------------------------------------------------------------------------------------------------------------------------------------------
--------------------------------------------------------------------------------------------------------------------------------------------------------------------------------------------------------
--------------------------------------------------------------------------------------------------------------------------------------------------------------------------------------------------------
--------------------------------------------------------------------------------------------------------------------------------------------------------------------------------------------------------
--------------------------------------------------------------------------------------------------------------------------------------------------------------------------------------------------------
--------------------------------------------------------------------------------------------------------------------------------------------------------------------------------------------------------
--------------------------------------------------------------------------------------------------------------------------------------------------------------------------------------------------------
--------------------------------------------------------------------------------------------------------------------------------------------------------------------------------------------------------
--------------------------------------------------------------------------------------------------------------------------------------------------------------------------------------------------------
--------------------------------------------------------------------------------------------------------------------------------------------------------------------------------------------------------
--------------------------------------------------------------------------------------------------------------------------------------------------------------------------------------------------------
--------------------------------------------------------------------------------------------------------------------------------------------------------------------------------------------------------
----------------------------oSooo-----------------------------------------------------------------------------------------------------------------------------------------------------------------------
----------------------------------------------------------------------------------------------------------oSSSo-------------ooo-------------------ooSSo--------------------------------ooo--------------
----------------------------oo---------------%%%%-------------------------------------------ooo-----------------------------------------------------------------------------------------------ooooooo---
------------------------------------oSooS----||||-------------ooSoo----Soooo---SoSoo--------------------ooooo------SSSo-------------oSSo------------oooo-------------------------------oooo-------------
XXXXXXXXXXXX----oo------XXXXXXXXXX---------XXXXXXXXXXXXX-----------------------------------oo---XXXXXX---g----------------------------------XXXXX--------------XXXXXXXXXXXXXXXXX----------------ooooo---
XXXXXXXXXXXX-------XXXXXXXXXXXXXXX--ooooo--XXXXXXXXXXXXX--------oo----ooo--------ooo------------XXXXXXXXXXXXXXXX---ooooo---XXXXXX----ooo----XXXXXXXXXXXXXX-----XXXXXXXXXXXXXXXXX---XXXXXXXXX------------
XXXXXXXXXXXXXXXXXXXXXXXXXXXXXXXXXX---------XXXXXXXXXXXXX--------------------------------XXXXXXXXXXXXXXXXXXXXXXXX---g-------XXXXXX-----------XXXXXXXXXXXXXXXXXXXXXXXXXXXXXXXXXXXX---XXXXXXXXXXXXXXXXXXXX-
XXXXXXXXXXXXXXXXXXXXXXXXXXXXXXXXXXXXXXXXXXXXXXXXXXXXXXXXXXXXXXXXXXXXXXXXXXXXXXXXXXXXXXXXXXXXXXXXXXXXXXXXXXXXXXXXXXXXXXXXXXXXXXXXXXXXXXXXXXXXXXXXXXXXXXXXXXXXXXXXXXXXXXXXXXXXXXXXXXXXXXXXXXXXXXXXXXXXXXXX

