--------------------------------------------------------------------------------------------------------------------------------------------------------------------------------------------------------
--------------------------------------------------------------------------------------------------------------------------------------------------------------------------------------------------------
--------------------------------------------------------------------------------------------------------------------------------------------------------------------------------------------------------
--------------------------------------------------------------------------------------------------------------------------------------------------------------------------------------------------------
--------------------------------------------------------------------------------------------------------------------------------------------------------------------------------------------------------
--------------------------------------------------------------------------------------------------------------------------------------------------------------------------------------------------------
--------------------------------------------------------------------------------------------------------------------------------------------------------------------------------------------------------
--------------------------------------------------------------------------------------------------------------------------------------------------------------------------------------------------------
--------------------------------------------------------------------------------------------------------------------------------------------------------------------------------------------------------
--------------------------------------------------------------------------------------------------------------------------------------------------------------------------------------------------------
--------------------------------------------------------------------------------------------------------------------------------------------------------------------------------------------------------
--------------------------------------------------------------------------------------------------------------------------------------------------------------------------------------------------------
--------------------oooooooo----------------------------------------------------------------------------------------------------------------------------------------------------------------------------
------------------------------------------------------------------------------ooo--ooSSo------ooSoo----------------------------oooS------oSSSoo------------oooo---------------------ooooo---------------
--------------------ooooo------------------------------------ooooo----ooo----------------------------------------------------------------------------------------------------oo-------------------------
------------------------------------------Sooo---oSo---------------------g-----------oooooo----ooo---------ooooo-------------ooooooooo----oo---------------oooo----SoSSooo-----------oooo----------g----
------------------XXXXXXXXXXX----------------------------XXXXXXXXXXXXXXXXXX-------------------------XXXXXX-------------------------------------------------g--g------------XXXXXXXX--g--g-----XXXXXXXXXX
------------XXXXXXXXXXXXXXXXX----XXXXX---oooo---------XXXXXXXXXXXXXXXXXXXXXXXXXXXXXXXXXXXXXXXXXXXXXXXXXXXX---ooo------XXXXXXXXXXXXXXXXXXXXXXXXXXXX-----XXXXXXXXX---oooooo--XXXXXXXXXXXXXXXX---XXXXXXXXXX
------------XXXXXXXXXXXXXXXXX----XXXXX----------------XXXXXXXXXXXXXXXXXXXXXXXXXXXXXXXXXXXXXXXXXXXXXXXXXXXX------------XXXXXXXXXXXXXXXXXXXXXXXXXXXXXXXXXXXXXXXXXX-----------XXXXXXXXXXXXXXXX---XXXXXXXXXX
XXXXXXXXXXXXXXXXXXXXXXXXXXXXXXXXXXXXXXXXXXXXXXXXXXXXXXXXXXXXXXXXXXXXXXXXXXXXXXXXXXXXXXXXXXXXXXXXXXXXXXXXXXXXXXXXXXXXXXXXXXXXXXXXXXXXXXXXXXXXXXXXXXXXXXXXXXXXXXXXXXXXXXXXXXXXXXXXXXXXXXXXXXXXXXXXXXXXXXXX

