--------------------------------------------------------------------------------------------------------------------------------------------------------------------------------------------------------
--------------------------------------------------------------------------------------------------------------------------------------------------------------------------------------------------------
--------------------------------------------------------------------------------------------------------------------------------------------------------------------------------------------------------
--------------------------------------------------------------------------------------------------------------------------------------------------------------------------------------------------------
--------------------------------------------------------------------------------------------------------------------------------------------------------------------------------------------------------
--------------------------------------------------------------------------------------------------------------------------------------------------------------------------------------------------------
--------------------------------------------------------------------------------------------------------------------------------------------------------------------------------------------------------
--------------------------------------------------------------------------------------------------------------------------------------------------------------------------------------------------------
--------------------------------------------------------------------------------------------------------------------------------------------------------------------------------------------------------
--------------------------------------------------------------------------------------------------------------------------------------------------------------------------------------------------------
--------------------------------------------------------------------------------------------------------------------------------------------------------------------------------------------------------
--------------------------------------------------------------------------------------------------------------------------------------------------------------------------------------------------------
------------------------------------------------------ooooooS---ooooSo-------------------------------------------------------------------------------------------------------oooSooo--------------------
-----------------------------------------------------------------------------------oSSo----------------------------------------------------------------oooS--------------------------------------oSo----
---------------------SSSo------------------oSo---------ooooooo----oo-------------------------------------------------------------------------------------------oSSS----------oooooo---------------------
------------oSoSS--------------------------------------------------------ooSSo------oooo-------------oooo----------------------g---------------------ooooooo------------------g-------------------------
-----------------------ooo---XXXXXX---------ooooo-XXXXXXXXXXXXXXXXXXXXX-------------------------XXXX----------------------XXXXXXXX---------------------g--------ooo---------XXXXXXXXXXXXXX--------g-----
XXXXXXXXXXX---ooo------------XXXXXXXXXXXX----g----XXXXXXXXXXXXXXXXXXXXX----ooooo--XXXXXXX--oo---XXXXXXXXXXXXXXXXXXXXXXX---XXXXXXXX-----------------XXXXXXXXXXX-------XXX----XXXXXXXXXXXXXX----XXXXXXX---
XXXXXXXXXXX--------XXXXXXXXXXXXXXXXXXXXXXXXXXXXXXXXXXXXXXXXXXXXXXXXXXXX-------g---XXXXXXX-------XXXXXXXXXXXXXXXXXXXXXXXXXXXXXXXXXXXXXXX----------XXXXXXXXXXXXXXXXXXXXXXXXXXXXXXXXXXXXXXXXX----XXXXXXX---
XXXXXXXXXXXXXXXXXXXXXXXXXXXXXXXXXXXXXXXXXXXXXXXXXXXXXXXXXXXXXXXXXXXXXXXXXXXXXXXXXXXXXXXXXXXXXXXXXXXXXXXXXXXXXXXXXXXXXXXXXXXXXXXXXXXXXXXXXXXXXXXXXXXXXXXXXXXXXXXXXXXXXXXXXXXXXXXXXXXXXXXXXXXXXXXXXXXXXXXX

