--------------------------------------------------------------------------------------------------------------------------------------------------------------------------------------------------------
--------------------------------------------------------------------------------------------------------------------------------------------------------------------------------------------------------
--------------------------------------------------------------------------------------------------------------------------------------------------------------------------------------------------------
--------------------------------------------------------------------------------------------------------------------------------------------------------------------------------------------------------
--------------------------------------------------------------------------------------------------------------------------------------------------------------------------------------------------------
--------------------------------------------------------------------------------------------------------------------------------------------------------------------------------------------------------
--------------------------------------------------------------------------------------------------------------------------------------------------------------------------------------------------------
--------------------------------------------------------------------------------------------------------------------------------------------------------------------------------------------------------
--------------------------------------------------------------------------------------------------------------------------------------------------------------------------------------------------------
--------------------------------------------------------------------------------------------------------------------------------------------------------------------------------------------------------
--------------------------------------------------------------------------------------------------------------------------------------------------------------------------------------------------------
--------------------------------------------------------------------------------------------------------------------------------------------------------------------------------------------------------
---------------------------------------------------------------------------------------------------------------------------------------------------------------------ooSSoo-----------------------------
-------------------------------------------------------------------------------------------------------------------------------ooSooo-------------------------------------------------------------------
-----------------------------------------------------------------------------------------------------------------------------------------------------------------------ooooo---oSS----------------------
----------------------------------------------------------oSS--------SoSSo--ooo-------ooooooo-------------------------oooSoo---oooo-------oooo------ooooo-----ooooo------------------------------ooooo--
-----------------oo----XXXXXXXXX---------XXXXX----------------------------------------------------------XXX---------------------------------------------------------XXXXXXXXXX--ooooo-------------------
XXXXXXXXXXX------------XXXXXXXXX---------XXXXXXXX--XX------oo------ooooo--------------ooooooo-----ooo---XXX-----XXXXX---oo---XXXXXXXXX----ooo--------oooo-----ooooo-XXXXXXXXXX--------------------oo----
XXXXXXXXXXXXXXXXXXXXXXXXXXXXXXXXXXX------XXXXXXXX--XXXXXX----------------g------------g---g-------------XXX-----XXXXX--g-----XXXXXXXXX------------------------------XXXXXXXXXXXXXXXXXX-----------------X
XXXXXXXXXXXXXXXXXXXXXXXXXXXXXXXXXXXXXXXXXXXXXXXXXXXXXXXXXXXXXXXXXXXXXXXXXXXXXXXXXXXXXXXXXXXXXXXXXXXXXXXXXXXXXXXXXXXXXXXXXXXXXXXXXXXXXXXXXXXXXXXXXXXXXXXXXXXXXXXXXXXXXXXXXXXXXXXXXXXXXXXXXXXXXXXXXXXXXXXX

