--------------------------------------------------------------------------------------------------------------------------------------------------------------------------------------------------------
--------------------------------------------------------------------------------------------------------------------------------------------------------------------------------------------------------
--------------------------------------------------------------------------------------------------------------------------------------------------------------------------------------------------------
--------------------------------------------------------------------------------------------------------------------------------------------------------------------------------------------------------
--------------------------------------------------------------------------------------------------------------------------------------------------------------------------------------------------------
--------------------------------------------------------------------------------------------------------------------------------------------------------------------------------------------------------
--------------------------------------------------------------------------------------------------------------------------------------------------------------------------------------------------------
--------------------------------------------------------------------------------------------------------------------------------------------------------------------------------------------------------
--------------------------------------------------------------------------------------------------------------------------------------------------------------------------------------------------------
--------------------------------------------------------------------------------------------------------------------------------------------------------------------------------------------------------
--------------------------------------------------------------------------------------------------------------------------------------------------------------------------------------------------------
--------------------------------------------------------------------------------------------------------------------------------------------------------------------------------------------------------
------------------------------------------oSoSo----------------------------------------------------------------------------------------------------oSSoSo-------------------------------oSSoooS---------
--------------------------------------------------------------------------------------------------------------------oSoo------------ooSo----------------------------------------------------------------
--------------------------------oSoo--------oooo----------oSSSoo-----------------------------------oSooo---oooo----------------------------------ooooooo------------------SSo----------ooooooo----------
----------------------oSSSoooo----------------------------------------------------------------------------------------oo----------ooooo-----------------------------------------------------------------
--------------------------------ooooo---XXXXXXXXXX------ooooo-----------------------------XXXXXXX----ooo--oooooooo------------------------------XXXXXXXXXX-oooo------------ooo--------XXXXXXXXXXXXXX----
------------------------oooo----------XXXXXXXXXXXX-------------------XXXXX---------oooo-XXXXXXXXX---------g--------XXXXXXX-------XXXXXXXXXX-----XXXXXXXXXX---------XXXX---------------XXXXXXXXXXXXXX----
-------------------------------XXXXXXXXXXXXXXXXXXXXXXXXXXXXXXXXXXXXXXXXXXXXXX-----------XXXXXXXXXXXXXXXXXXXXXXXXXXXXXXXXXXXXXXXXXXXXXXXXXXX-----XXXXXXXXXXXXXXXXXXXXXXXXXXXXXXXXX-----XXXXXXXXXXXXXX----
XXXXXXXXXXXXXXXXXXXXXXXXXXXXXXXXXXXXXXXXXXXXXXXXXXXXXXXXXXXXXXXXXXXXXXXXXXXXXXXXXXXXXXXXXXXXXXXXXXXXXXXXXXXXXXXXXXXXXXXXXXXXXXXXXXXXXXXXXXXXXXXXXXXXXXXXXXXXXXXXXXXXXXXXXXXXXXXXXXXXXXXXXXXXXXXXXXXXXXXX

