--------------------------------------------------------------------------------------------------------------------------------------------------------------------------------------------------------
--------------------------------------------------------------------------------------------------------------------------------------------------------------------------------------------------------
--------------------------------------------------------------------------------------------------------------------------------------------------------------------------------------------------------
--------------------------------------------------------------------------------------------------------------------------------------------------------------------------------------------------------
--------------------------------------------------------------------------------------------------------------------------------------------------------------------------------------------------------
--------------------------------------------------------------------------------------------------------------------------------------------------------------------------------------------------------
--------------------------------------------------------------------------------------------------------------------------------------------------------------------------------------------------------
--------------------------------------------------------------------------------------------------------------------------------------------------------------------------------------------------------
--------------------------------------------------------------------------------------------------------------------------------------------------------------------------------------------------------
--------------------------------------------------------------------------------------------------------------------------------------------------------------------------------------------------------
--------------------------------------------------------------------------------------------------------------------------------------------------------------------------------------------------------
--------------------------------------------------------------------------------------------------------------------------------------------------------------------------------------------------------
-------------------------oooooSo-----------------ooooSo------------------------------SoSoS---------------Soo------------------------------------------------------ooSoo------------SoooS----------------
------------------------------------------oSo------------------------------------------------------------------------------------------------oooSo------------------------------------------------------
-------------------------ooooo-----------------ooooooooo----------------------------ooooooo-----------ooooo-----------------------------------------------SSo----------------------ooooo----------------
----------------------------------ooo---ooooo---g----------Sooooo-------------------------------oooo---------------------------ooo----------oooo-------------------------------------------ooooooS------
XXXXXXXXXXXX------------XXXXXXXXX-------------XXXXXXXXXXX----------XXXXX-----------XXXXXXXXXX--------XXXXXXXXXXXXXXXXXX---XX----------------------------oo----XXXXXXXXXXXXXX---XXXXXXXXXXX--------------
XXXXXXXXXXXXXXXXX-------XXXXXXXXXXXXXXXXXXXXXXXXXXXXXXXXX--ooooooo-XXXXXXXXXXXX----XXXXXXXXXXXXXXXXXXXXXXXXXXXXXXXXXXXX---XXXXXXXXX---XXXXXXXXXXXXX--------g--XXXXXXXXXXXXXX---XXXXXXXXXXX----oooo------
XXXXXXXXXXXXXXXXX----XXXXXXXXXXXXXXXXXXXXXXXXXXXXXXXXXXXX-------g--XXXXXXXXXXXXXXXXXXXXXXXXXXXXXXXXXXXXXXXXXXXXXXXXXXXXXXXXXXXXXXXX---XXXXXXXXXXXXX----XXXXXXXXXXXXXXXXXXXXX---XXXXXXXXXXX-----------XXX
XXXXXXXXXXXXXXXXXXXXXXXXXXXXXXXXXXXXXXXXXXXXXXXXXXXXXXXXXXXXXXXXXXXXXXXXXXXXXXXXXXXXXXXXXXXXXXXXXXXXXXXXXXXXXXXXXXXXXXXXXXXXXXXXXXXXXXXXXXXXXXXXXXXXXXXXXXXXXXXXXXXXXXXXXXXXXXXXXXXXXXXXXXXXXXXXXXXXXXXX

