--------------------------------------------------------------------------------------------------------------------------------------------------------------------------------------------------------
--------------------------------------------------------------------------------------------------------------------------------------------------------------------------------------------------------
--------------------------------------------------------------------------------------------------------------------------------------------------------------------------------------------------------
--------------------------------------------------------------------------------------------------------------------------------------------------------------------------------------------------------
--------------------------------------------------------------------------------------------------------------------------------------------------------------------------------------------------------
--------------------------------------------------------------------------------------------------------------------------------------------------------------------------------------------------------
--------------------------------------------------------------------------------------------------------------------------------------------------------------------------------------------------------
--------------------------------------------------------------------------------------------------------------------------------------------------------------------------------------------------------
--------------------------------------------------------------------------------------------------------------------------------------------------------------------------------------------------------
--------------------------------------------------------------------------------------------------------------------------------------------------------------------------------------------------------
--------------------------------------------------------------------------------------------------------------------------------------------------------------------------------------------------------
--------------------------------------------------------------------------------------------------------------------------------------------------------------------------------------------------------
-------------------------------------------------------------------------------------------------------------------------------------------------------------------------------------------oSoSS--------
-----------------------------------------------------------------------------------Sooo------------------------------------------------------oSoSoo-----------------------------------------------------
--------------------------------------oSoo----SoSoo--------------oooo----oooSo--------------------------------------------------------ooooo---------------------------oo------------------oooo----------
--------------------------SoooSoo-------------------------------------------------oooo---------ooSo---------------------------------------g-------------------------------------------------------------
XXXXXXXXXXXXXXXX--ooooo--------------ooooo----oo----XXXXX-----XXXXXXXXXX-oooooo--------------------------------ooo---oooo------------XXXXXXX----------------------XXXXXXXXXX------------XXXXXXXXXX------
XXXXXXXXXXXXXXXX-----------oooo---------------------XXXXXXX---XXXXXXXXXX---------XXXXXXXXXXX----oooooo-------------------------------XXXXXXXXXXXXXXXXX------------XXXXXXXXXXXXXXX--ooo--XXXXXXXXXX---XXX
XXXXXXXXXXXXXXXXXXXXXXXX-----------XXXXXXXXXXXXXXXXXXXXXXXX---XXXXXXXXXXXXXXXXXXXXXXXXXXXXXX----------------XXXXXXXXXXXXXXXXXXXXXXXXXXXXXXXXXXXXXXXXXX------------XXXXXXXXXXXXXXX-------XXXXXXXXXX---XXX
XXXXXXXXXXXXXXXXXXXXXXXXXXXXXXXXXXXXXXXXXXXXXXXXXXXXXXXXXXXXXXXXXXXXXXXXXXXXXXXXXXXXXXXXXXXXXXXXXXXXXXXXXXXXXXXXXXXXXXXXXXXXXXXXXXXXXXXXXXXXXXXXXXXXXXXXXXXXXXXXXXXXXXXXXXXXXXXXXXXXXXXXXXXXXXXXXXXXXXXX

