--------------------------------------------------------------------------------------------------------------------------------------------------------------------------------------------------------
--------------------------------------------------------------------------------------------------------------------------------------------------------------------------------------------------------
--------------------------------------------------------------------------------------------------------------------------------------------------------------------------------------------------------
--------------------------------------------------------------------------------------------------------------------------------------------------------------------------------------------------------
--------------------------------------------------------------------------------------------------------------------------------------------------------------------------------------------------------
--------------------------------------------------------------------------------------------------------------------------------------------------------------------------------------------------------
--------------------------------------------------------------------------------------------------------------------------------------------------------------------------------------------------------
--------------------------------------------------------------------------------------------------------------------------------------------------------------------------------------------------------
--------------------------------------------------------------------------------------------------------------------------------------------------------------------------------------------------------
--------------------------------------------------------------------------------------------------------------------------------------------------------------------------------------------------------
--------------------------------------------------------------------------------------------------------------------------------------------------------------------------------------------------------
--------------------------------------------------------------------------------------------------------------------------------------------------------------------------------------------------------
------------------------------------------ooooooS---oooo------------------------------------------------------oooSoo--------------------------------------------oSoSoooo--------------------------------
---------------------------------------------------------------------------------------------------------------------------------------------oooS------------------------------------SSoo---------------
--------------------------------------------oooooo--------------------oSo----------------------------------------oooooo--------------------------------ooSoo------ooo-----------------------------------
-------------------------ooooSo---------------------------------------------oooSSooo-----------oSoS--------------g-----------------oooSo------ooo-------------------------------------oooo--------ooo---
XXXXXXXXXXX---XXX-----------------------XXXXXXXXXXXXXXXXXX------XXX--ooo---------------oo--------------------XXXXXXXXXXX------XXX----------------g----oooooooo-XXXXXXXXXX-------------------------------
XXXXXXXXXXX---XXXXXXX----oooooo---------XXXXXXXXXXXXXXXXXX------XXX-----------ooooo------------oooooo--XXXXXXXXXXXXXXXXXXXXXXXXXX-oooooo---XXXXXXXXXX--------g-XXXXXXXXXX----------XXXXXXXXXX----XXXXXXX
XXXXXXXXXXX---XXXXXXX-------------XXXXXXXXXXXXXXXXXXXXXXXX------XXXXXXXXXXX----------XXXXXXX--g-g------XXXXXXXXXXXXXXXXXXXXXXXXXX----------XXXXXXXXXXXXXXXXXXXXXXXXXXXXXXXXXXXXXXXXXXXXXXXXXXXXXXXXXXXXX
XXXXXXXXXXXXXXXXXXXXXXXXXXXXXXXXXXXXXXXXXXXXXXXXXXXXXXXXXXXXXXXXXXXXXXXXXXXXXXXXXXXXXXXXXXXXXXXXXXXXXXXXXXXXXXXXXXXXXXXXXXXXXXXXXXXXXXXXXXXXXXXXXXXXXXXXXXXXXXXXXXXXXXXXXXXXXXXXXXXXXXXXXXXXXXXXXXXXXXXX

