--------------------------------------------------------------------------------------------------------------------------------------------------------------------------------------------------------
--------------------------------------------------------------------------------------------------------------------------------------------------------------------------------------------------------
--------------------------------------------------------------------------------------------------------------------------------------------------------------------------------------------------------
--------------------------------------------------------------------------------------------------------------------------------------------------------------------------------------------------------
--------------------------------------------------------------------------------------------------------------------------------------------------------------------------------------------------------
--------------------------------------------------------------------------------------------------------------------------------------------------------------------------------------------------------
--------------------------------------------------------------------------------------------------------------------------------------------------------------------------------------------------------
--------------------------------------------------------------------------------------------------------------------------------------------------------------------------------------------------------
--------------------------------------------------------------------------------------------------------------------------------------------------------------------------------------------------------
--------------------------------------------------------------------------------------------------------------------------------------------------------------------------------------------------------
--------------------------------------------------------------------------------------------------------------------------------------------------------------------------------------------------------
--------------------------------------------------------------------------------------------------------------------------------------------------------------------------------------------------------
---------------------------------------oSoS---------------------ooooSo----------------------------------------------------------------------------------------------------------------------------------
----------------------------Soo-------------------------------------------------------------------------------------------------------------------------------------------------------------------------
-----------------------------------------oo-----SSS---------------ooooo---SSoSSo---------------oo-------------------------------------------------------------------------------------------------------
-----------------oSSoS------------------------------------oo----g---------------------------------------------oooooo--------------------------oooo-----------------------------------------ooooooS------
XXXXXXXXXXX--------------------------XXXXXXXXX----oo-----------XXXXXXXXX----ooooo--------XXXXXXXXXXX----XXX-----------------------------------------------ooo-----------------XXXXXX--------------------
XXXXXXXXXXXXXXXX---oooo---XXXXXXXXXXXXXXXXXXXX----------XXXXXXXXXXXXXXXX-----------XXXXXXXXXXXXXXXXXXXXXXXX--XXXXXXXXXX-------oooo--------------ooo---------g-----ooo---XXXXXXXXXXXXXXXXXX--oooooo------
XXXXXXXXXXXXXXXX----------XXXXXXXXXXXXXXXXXXXXXXXXXXXXXXXXXXXXXXXXXXXXXXXXXXXXXXXXXXXXXXXXXXXXXXXXXXXXXXXXX--XXXXXXXXXX--------------------------------XXXXXXXX-----g-XXXXXXXXXXXXXXXXXXXX--------------
XXXXXXXXXXXXXXXXXXXXXXXXXXXXXXXXXXXXXXXXXXXXXXXXXXXXXXXXXXXXXXXXXXXXXXXXXXXXXXXXXXXXXXXXXXXXXXXXXXXXXXXXXXXXXXXXXXXXXXXXXXXXXXXXXXXXXXXXXXXXXXXXXXXXXXXXXXXXXXXXXXXXXXXXXXXXXXXXXXXXXXXXXXXXXXXXXXXXXXXX

