--------------------------------------------------------------------------------------------------------------------------------------------------------------------------------------------------------
--------------------------------------------------------------------------------------------------------------------------------------------------------------------------------------------------------
--------------------------------------------------------------------------------------------------------------------------------------------------------------------------------------------------------
--------------------------------------------------------------------------------------------------------------------------------------------------------------------------------------------------------
--------------------------------------------------------------------------------------------------------------------------------------------------------------------------------------------------------
--------------------------------------------------------------------------------------------------------------------------------------------------------------------------------------------------------
--------------------------------------------------------------------------------------------------------------------------------------------------------------------------------------------------------
--------------------------------------------------------------------------------------------------------------------------------------------------------------------------------------------------------
--------------------------------------------------------------------------------------------------------------------------------------------------------------------------------------------------------
--------------------------------------------------------------------------------------------------------------------------------------------------------------------------------------------------------
--------------------------------------------------------------------------------------------------------------------------------------------------------------------------------------------------------
--------------------------------------------------------------------------------------------------------------------------------------------------------------------------------------------------------
-------------------------------------------------------------------------------------------------------------------------------------------------------------------------------------------------Soo----
----------------------------ooooS-------------------------oooo---oSoo------------------------------------SooSo------------------------------------------------------------------------------------------
-------------oSoo--oSSSo---------------------------------------------------oooSSo---------------oooo--------------------------------------------------ooooS------------------------------------ooooo----
---------------------------oooooo--------------SSooSo-----ooo----oo----------------------------------------ooooo-----ooooo-----------oSo----------------------------oSSoSooo----------------------------
-------------------ooo------------------oo------------------------------------oo---------XXXXX----oo----------------------------------------XXXX------ooooooo-----------------------XXXX-----XXXXXXXXXX-
---------------------g----XXXXXXXXXXX-----------oooo---XXXXXXXXXXXXXXXX------------------XXXXX---------XXXXXXXXXXXXXXXXXXXX--oooo--oooooo---XXXX---------g---------ooooooo---XXXXX--XXXX-----XXXXXXXXXX-
-----------XXXXXXXXXXXXXXXXXXXXXXXXXXXXXXXXX---g-------XXXXXXXXXXXXXXXX---XXXXXXXXXXXXXXXXXXXXXXXXXXXXXXXXXXXXXXXXXXXXXXXXX-----------------XXXXXXXXXXXXXXXXXX---------------XXXXX--XXXX-----XXXXXXXXXX-
XXXXXXXXXXXXXXXXXXXXXXXXXXXXXXXXXXXXXXXXXXXXXXXXXXXXXXXXXXXXXXXXXXXXXXXXXXXXXXXXXXXXXXXXXXXXXXXXXXXXXXXXXXXXXXXXXXXXXXXXXXXXXXXXXXXXXXXXXXXXXXXXXXXXXXXXXXXXXXXXXXXXXXXXXXXXXXXXXXXXXXXXXXXXXXXXXXXXXXXX

