--------------------------------------------------------------------------------------------------------------------------------------------------------------------------------------------------------
--------------------------------------------------------------------------------------------------------------------------------------------------------------------------------------------------------
--------------------------------------------------------------------------------------------------------------------------------------------------------------------------------------------------------
--------------------------------------------------------------------------------------------------------------------------------------------------------------------------------------------------------
--------------------------------------------------------------------------------------------------------------------------------------------------------------------------------------------------------
--------------------------------------------------------------------------------------------------------------------------------------------------------------------------------------------------------
--------------------------------------------------------------------------------------------------------------------------------------------------------------------------------------------------------
--------------------------------------------------------------------------------------------------------------------------------------------------------------------------------------------------------
--------------------------------------------------------------------------------------------------------------------------------------------------------------------------------------------------------
--------------------------------------------------------------------------------------------------------------------------------------------------------------------------------------------------------
--------------------------------------------------------------------------------------------------------------------------------------------------------------------------------------------------------
--------------------------------------------------------------------------------------------------------------------------------------------------------------------------------------------------------
-------------------------------------------oooooo---------------------------Soooo-----------------------------------------------------------------------------------------------------------------------
------------------------------------------------------------------------------------------------------------------------------------------------oooooooo--------------------------------oSoSSooo--------
--------------------------------------ooo--ooooo---------------------------ooo-----------------------------------------------------------------------------oooSSoS--------------------------------------
-------------------------------------------------------------oSSSSoSo---------------------------------------------------------oo----------------ooooooo----------------ooo-----------------ooooo--------
XXXXXXXXXXXXXX----XXXXX---------------ooo-XXXXXXXXXXX-------------------XXXXXXXXXX-----------------------XXXXXXX-------oo-----------XXXXX---oo----------------ooo---------------------------------------
XXXXXXXXXXXXXX----XXXXX-------------------XXXXXXXXXXXXXXXXX----ooo------XXXXXXXXXX--------------XXX------XXXXXXX-------------XXXXXXXXXXXX------XXXXXXXXXXX----------XXXXXXXXX------XX--XXXXXXXXXX-------
XXXXXXXXXXXXXX----XXXXX-----XX----XXXXXXXXXXXXXXXXXXXXXXXXX-----------XXXXXXXXXXXX--XXXXXXXXXXXXXXXXXXXXXXXXXXXXXXXXXXXXXXXXXXXXXXXXXXXXXXXXXXXXXXXXXXXXXXXXXXXXXXXXXXXXXXXXXXXXX--XXXXXXXXXXXXXXXXXX---
XXXXXXXXXXXXXXXXXXXXXXXXXXXXXXXXXXXXXXXXXXXXXXXXXXXXXXXXXXXXXXXXXXXXXXXXXXXXXXXXXXXXXXXXXXXXXXXXXXXXXXXXXXXXXXXXXXXXXXXXXXXXXXXXXXXXXXXXXXXXXXXXXXXXXXXXXXXXXXXXXXXXXXXXXXXXXXXXXXXXXXXXXXXXXXXXXXXXXXXX

