--------------------------------------------------------------------------------------------------------------------------------------------------------------------------------------------------------
--------------------------------------------------------------------------------------------------------------------------------------------------------------------------------------------------------
--------------------------------------------------------------------------------------------------------------------------------------------------------------------------------------------------------
--------------------------------------------------------------------------------------------------------------------------------------------------------------------------------------------------------
--------------------------------------------------------------------------------------------------------------------------------------------------------------------------------------------------------
--------------------------------------------------------------------------------------------------------------------------------------------------------------------------------------------------------
--------------------------------------------------------------------------------------------------------------------------------------------------------------------------------------------------------
--------------------------------------------------------------------------------------------------------------------------------------------------------------------------------------------------------
--------------------------------------------------------------------------------------------------------------------------------------------------------------------------------------------------------
--------------------------------------------------------------------------------------------------------------------------------------------------------------------------------------------------------
--------------------------------------------------------------------------------------------------------------------------------------------------------------------------------------------------------
--------------------------------------------------------------------------------------------------------------------------------------------------------------------------------------------------------
---------------------------------------------------------------------------------------------------------------------------oooo------------------------------------------------------------ooS----------
-------------------------------Sooo--------------------------------------------------------oSoSo-------------------------------------------------------------oooo---------------ooSSoSo-----------------
------------------oooooo--------------------------------------------------------------------------------------ooSS-----------ooo------------------------------------oooo------------------ooooo---------
-------------------------------------------oSo------------------ooo----ooo---oooS----------oooo-------------------------------------------------g------------ooo-----------------ooooooo---------oooo---
----------------XXXXXXXXX-------------------------XXXXXXXXXXXXX----------------------------------XXXXXXX----ooooooooo-----XXXXXXXXX---------XXXXXXXXXXXXX---------XXXXXXX----------------XXXXXXX--------
----------------XXXXXXXXXXXXXXXXXXXXXXX-ooooooo---XXXXXXXXXXXXX---------------oooooo----XXXXXXXXXXXXXXXX--------------XX--XXXXXXXXX--oooo---XXXXXXXXXXXXXXXXXXXXXXXXXXXXX------XXXXXXXXXXXXXXXXX---ooo--
XXXXXXXXXXXXXXXXXXXXXXXXXXXXXXXXXXXXXXX-----------XXXXXXXXXXXXX-g-----------------------XXXXXXXXXXXXXXXX---XXXXXXXXXXXXXXXXXXXXXXXX---------XXXXXXXXXXXXXXXXXXXXXXXXXXXXXXXXXXXXXXXXXXXXXXXXXXXX-------X
XXXXXXXXXXXXXXXXXXXXXXXXXXXXXXXXXXXXXXXXXXXXXXXXXXXXXXXXXXXXXXXXXXXXXXXXXXXXXXXXXXXXXXXXXXXXXXXXXXXXXXXXXXXXXXXXXXXXXXXXXXXXXXXXXXXXXXXXXXXXXXXXXXXXXXXXXXXXXXXXXXXXXXXXXXXXXXXXXXXXXXXXXXXXXXXXXXXXXXXX

