--------------------------------------------------------------------------------------------------------------------------------------------------------------------------------------------------------
--------------------------------------------------------------------------------------------------------------------------------------------------------------------------------------------------------
--------------------------------------------------------------------------------------------------------------------------------------------------------------------------------------------------------
--------------------------------------------------------------------------------------------------------------------------------------------------------------------------------------------------------
--------------------------------------------------------------------------------------------------------------------------------------------------------------------------------------------------------
--------------------------------------------------------------------------------------------------------------------------------------------------------------------------------------------------------
--------------------------------------------------------------------------------------------------------------------------------------------------------------------------------------------------------
--------------------------------------------------------------------------------------------------------------------------------------------------------------------------------------------------------
--------------------------------------------------------------------------------------------------------------------------------------------------------------------------------------------------------
--------------------------------------------------------------------------------------------------------------------------------------------------------------------------------------------------------
--------------------------------------------------------------------------------------------------------------------------------------------------------------------------------------------------------
--------------------------------------------------------------------------------------------------------------------------------------------------------------------------------------------------------
-------------------------------------------------------oooSo--------------------------------oooo--------------------------------------------------------------------------------------------------------
-----------------oSSSS---ooooo---------------------------------------------------------------------------------------------------SooSo-------------------------------------------------ooSSS----ooSoo---
------------------------------------------------------ooooooooo-------------------------------oo----------------------oSoooo----------------------------------------------------------------------------
------------------ooo-----oooo---SooSooSo------------------------------------------ooooo----------------ooo----------------------oo-------oooSoo------------------------ooS-------------oooo------------
-----------------------------------------------------XXXXXXXXXXX--------------------------XXXXXXXXX--------------------oooo--------------------------------------------------XXXXXXXXX---g-------------X
--------------XXXXXXXXXXXXXXXXX---ooooooo-----XXX----XXXXXXXXXXX------XXXXXXX---oooooooo--XXXXXXXXX------oooo-XXXXXXX---------XXXXXXXXX---ooo-------------XXXXXXX--------oo--XXXXXXXXXXXXXXXXXXXXXXXXXXX
--------------XXXXXXXXXXXXXXXXX---------------XXXXXXXXXXXXXXXXXX----g-XXXXXXXXX-----------XXXXXXXXX------g----XXXXXXXXXXXXXXXXXXXXXXXXX----------XXXXXXXXXXXXXXXXXXXXX-------XXXXXXXXXXXXXXXXXXXXXXXXXXX
XXXXXXXXXXXXXXXXXXXXXXXXXXXXXXXXXXXXXXXXXXXXXXXXXXXXXXXXXXXXXXXXXXXXXXXXXXXXXXXXXXXXXXXXXXXXXXXXXXXXXXXXXXXXXXXXXXXXXXXXXXXXXXXXXXXXXXXXXXXXXXXXXXXXXXXXXXXXXXXXXXXXXXXXXXXXXXXXXXXXXXXXXXXXXXXXXXXXXXXX

