--------------------------------------------------------------------------------------------------------------------------------------------------------------------------------------------------------
--------------------------------------------------------------------------------------------------------------------------------------------------------------------------------------------------------
--------------------------------------------------------------------------------------------------------------------------------------------------------------------------------------------------------
--------------------------------------------------------------------------------------------------------------------------------------------------------------------------------------------------------
--------------------------------------------------------------------------------------------------------------------------------------------------------------------------------------------------------
--------------------------------------------------------------------------------------------------------------------------------------------------------------------------------------------------------
--------------------------------------------------------------------------------------------------------------------------------------------------------------------------------------------------------
--------------------------------------------------------------------------------------------------------------------------------------------------------------------------------------------------------
--------------------------------------------------------------------------------------------------------------------------------------------------------------------------------------------------------
--------------------------------------------------------------------------------------------------------------------------------------------------------------------------------------------------------
--------------------------------------------------------------------------------------------------------------------------------------------------------------------------------------------------------
--------------------------------------------------------------------------------------------------------------------------------------------------------------------------------------------------------
-----------------------------------------------------------ooSoo-----------------------------------------------------------------------------------------------Sooo-------------------------------------
---------------------------------------------------------------------------------------------------------------ooSoo-----------------ooSSo--------------------------------------------------------------
------------------------ooSooSo-------------------------------oooo---------------------------------------------------------------------------------oooo---------------------------oSoo------------------
--------------------------------------------------oSo----------------------------%%%%%----------------ooSoS------ooooo--------------ooooooo----------------------------oSSo-----------------------------
-------------------------ooo------------------------------XXXXXXXXX--------------|||||-----------------------------g-g----------------g------------ooo-------XXXXXXXXX--------------ooo-----------------
-----------------------g--------XXXXX-oooooo-----oooooo---XXXXXXXXX--------------|||||---------XXXX-oooooooo--XXXXXXXXXX-----------XXXXXXXXXX----------------XXXXXXXXX--------------g----------------XXX
XXXXXXXXXXXXXXXXXX----XXXXXXXXXXXXXXX--g-----XXX--------XXXXXXXXXXXXXXX----------|||||---------XXXX-g---------XXXXXXXXXXXXXXXXXXXXXXXXXXXXXXX---XXXXXXXXXXXXXXXXXXXXXX------XXX--XXXXXXXXX----XXXXXXXXXX
XXXXXXXXXXXXXXXXXXXXXXXXXXXXXXXXXXXXXXXXXXXXXXXXXXXXXXXXXXXXXXXXXXXXXXXXXXXXXXXXXXXXXXXXXXXXXXXXXXXXXXXXXXXXXXXXXXXXXXXXXXXXXXXXXXXXXXXXXXXXXXXXXXXXXXXXXXXXXXXXXXXXXXXXXXXXXXXXXXXXXXXXXXXXXXXXXXXXXXXX

