--------------------------------------------------------------------------------------------------------------------------------------------------------------------------------------------------------
--------------------------------------------------------------------------------------------------------------------------------------------------------------------------------------------------------
--------------------------------------------------------------------------------------------------------------------------------------------------------------------------------------------------------
--------------------------------------------------------------------------------------------------------------------------------------------------------------------------------------------------------
--------------------------------------------------------------------------------------------------------------------------------------------------------------------------------------------------------
--------------------------------------------------------------------------------------------------------------------------------------------------------------------------------------------------------
--------------------------------------------------------------------------------------------------------------------------------------------------------------------------------------------------------
--------------------------------------------------------------------------------------------------------------------------------------------------------------------------------------------------------
--------------------------------------------------------------------------------------------------------------------------------------------------------------------------------------------------------
--------------------------------------------------------------------------------------------------------------------------------------------------------------------------------------------------------
--------------------------------------------------------------------------------------------------------------------------------------------------------------------------------------------------------
--------------------------------------------------------------------------------------------------------------------------------------------------------------------------------------------------------
------------------------------------------oSooSoSo--oSooo---oooSSo-------------------------------------------------oSSo---------oooo----ooooSoS--------------------------ooSSoo-------------------------
---------------------------------------------------------------------------------ooSSoo--------------------------------------------------------------------------------------------------------oSSSSo---
-------------------------------------------oooo-----oooo-----ooooo--------oo-----------------oooo---------------------------------oooo----ooooo---------------------------------------------------------
------------------oSoo----------SooSoSo--------g--------------------------g--------oooo--------------------ooSo--------------------------------------------------------------g----------oSoo---oooooo---
--------------------------ooo------------XXXXXXXXXXXXXXXXXXXXXXXXXXXXXXXXXXXXXXX-----------XXXXXXXXXX-------------XXXXXXXXXXX--XXXXXXXXXXXXXXXXXX----XXXX---------------XXXXXXXX--------------------g---
---------------oooooooo--------ooooooo---XXXXXXXXXXXXXXXXXXXXXXXXXXXXXXXXXXXXXXXXXXXXXXXXXXXXXXXXXXXXXXXXX-ooo----XXXXXXXXXXXXXXXXXXXXXXXXXXXXXXX----XXXX--------XXXX---XXXXXXXX--------oooo-XXXXXXXXXX-
------------------------XXXXXX-----------XXXXXXXXXXXXXXXXXXXXXXXXXXXXXXXXXXXXXXXXXXXXXXXXXXXXXXXXXXXXXXXXX--------XXXXXXXXXXXXXXXXXXXXXXXXXXXXXXXXXXXXXXX------XXXXXX---XXXXXXXXXX-----------XXXXXXXXXXX
XXXXXXXXXXXXXXXXXXXXXXXXXXXXXXXXXXXXXXXXXXXXXXXXXXXXXXXXXXXXXXXXXXXXXXXXXXXXXXXXXXXXXXXXXXXXXXXXXXXXXXXXXXXXXXXXXXXXXXXXXXXXXXXXXXXXXXXXXXXXXXXXXXXXXXXXXXXXXXXXXXXXXXXXXXXXXXXXXXXXXXXXXXXXXXXXXXXXXXXX

