--------------------------------------------------------------------------------------------------------------------------------------------------------------------------------------------------------
--------------------------------------------------------------------------------------------------------------------------------------------------------------------------------------------------------
--------------------------------------------------------------------------------------------------------------------------------------------------------------------------------------------------------
--------------------------------------------------------------------------------------------------------------------------------------------------------------------------------------------------------
--------------------------------------------------------------------------------------------------------------------------------------------------------------------------------------------------------
--------------------------------------------------------------------------------------------------------------------------------------------------------------------------------------------------------
--------------------------------------------------------------------------------------------------------------------------------------------------------------------------------------------------------
--------------------------------------------------------------------------------------------------------------------------------------------------------------------------------------------------------
--------------------------------------------------------------------------------------------------------------------------------------------------------------------------------------------------------
--------------------------------------------------------------------------------------------------------------------------------------------------------------------------------------------------------
--------------------------------------------------------------------------------------------------------------------------------------------------------------------------------------------------------
--------------------------------------------------------------------------------------------------------------------------------------------------------------------------------------------------------
------------------------------------------------------------------------------------------------------------------------------ooSo-------------------------------oooS-----------------------------------
-------------------------------------ooSoo--------------------------------------------------------------------------------------------------------------------------------------------------------------
----------------SoS----------------------------------------------------------ooSo--ooooo-------------------------------------oooooo---ooooo----------------------ooooo---ooo----------------------------
-------------------------------------ooooooo---------------ooSoo------------------------------------------------------------------------------oooSSooS-------------------------ooo----------------------
-----------------oooo-------------g----------------XXXXXX------------oo-----------XXXXXXXX------XXXXXXXXXXXX--XXXXXXXXXXXXXXXXXXXXXXXXXXXXXXX-----------XX----XXXXXXXXXX---------------------XXX-------X
----------XXXX--------XXX-----XXXXXXXXXXXXXXXXXXXXXXXXXXX---ooo-------------------XXXXXXXX------XXXXXXXXXXXX--XXXXXXXXXXXXXXXXXXXXXXXXXXXXXXX---ooooooo-XX----XXXXXXXXXX------XXXXXXX--------XXX-----XXX
----------XXXXXXXXXXXXXXXXXXXXXXXXXXXXXXXXXXXXXXXXXXXXXXX----------XXXXXXXXXXXXXXXXXXXXXXX------XXXXXXXXXXXXXXXXXXXXXXXXXXXXXXXXXXXXXXXXXXXXX-------g---XX----XXXXXXXXXXXXXXXXXXXXXXX--------XXX-----XXX
XXXXXXXXXXXXXXXXXXXXXXXXXXXXXXXXXXXXXXXXXXXXXXXXXXXXXXXXXXXXXXXXXXXXXXXXXXXXXXXXXXXXXXXXXXXXXXXXXXXXXXXXXXXXXXXXXXXXXXXXXXXXXXXXXXXXXXXXXXXXXXXXXXXXXXXXXXXXXXXXXXXXXXXXXXXXXXXXXXXXXXXXXXXXXXXXXXXXXXXX

