--------------------------------------------------------------------------------------------------------------------------------------------------------------------------------------------------------
--------------------------------------------------------------------------------------------------------------------------------------------------------------------------------------------------------
--------------------------------------------------------------------------------------------------------------------------------------------------------------------------------------------------------
--------------------------------------------------------------------------------------------------------------------------------------------------------------------------------------------------------
--------------------------------------------------------------------------------------------------------------------------------------------------------------------------------------------------------
--------------------------------------------------------------------------------------------------------------------------------------------------------------------------------------------------------
--------------------------------------------------------------------------------------------------------------------------------------------------------------------------------------------------------
--------------------------------------------------------------------------------------------------------------------------------------------------------------------------------------------------------
--------------------------------------------------------------------------------------------------------------------------------------------------------------------------------------------------------
--------------------------------------------------------------------------------------------------------------------------------------------------------------------------------------------------------
--------------------------------------------------------------------------------------------------------------------------------------------------------------------------------------------------------
--------------------------------------------------------------------------------------------------------------------------------------------------------------------------------------------------------
------------------ooo----------------------------------------------------------------------------------------------------------------Soo----------------------------------------------------------------
-----------------------------Sooo------------------------ooo--------oSSoS-------------------------------------Sooo--------------------------------------------ooSoooo---------------------Soooo---------
------------------ooo----------------------------------------------------------------------------------------------------------------ooooo--oSo------ooooSoo---------------------------------------SoS--
--------------------------oooooooo----------------------oooooo------oooooo-------------Soo----ooo--ooSooo----ooooooo----SSS-------------------------------------oooo----------------------ooooo---------
------------XXXXXXXXXXXXX--g----------------XXXXX--------------------------XXXXXXXXXX--------------------------------------------XXXXXXXXXX--ooooo-----ooo----------------------------------------------
------------XXXXXXXXXXXXXXXXXXXXXXX------XXXXXXXXXXXXXXXXXXXXXXX---XXXXXXXXXXXXXXXXXX------XXXXXXX--ooo----XXXXXXXXXX----oooo--XXXXXXXXXXXX------------------XXXXXXXXXXX----oooo------XXXXXXXXXXX-------
XXXXXXXXXXXXXXXXXXXXXXXXXXXXXXXXXXX------XXXXXXXXXXXXXXXXXXXXXXXXXXXXXXXXXXXXXXXXXXXX------XXXXXXX----g----XXXXXXXXXX----------XXXXXXXXXXXXXXXXXXXXXXXXXXXXXXXXXXXXXXXXX-g------------XXXXXXXXXXXXXXXXXX
XXXXXXXXXXXXXXXXXXXXXXXXXXXXXXXXXXXXXXXXXXXXXXXXXXXXXXXXXXXXXXXXXXXXXXXXXXXXXXXXXXXXXXXXXXXXXXXXXXXXXXXXXXXXXXXXXXXXXXXXXXXXXXXXXXXXXXXXXXXXXXXXXXXXXXXXXXXXXXXXXXXXXXXXXXXXXXXXXXXXXXXXXXXXXXXXXXXXXXXX

