--------------------------------------------------------------------------------------------------------------------------------------------------------------------------------------------------------
--------------------------------------------------------------------------------------------------------------------------------------------------------------------------------------------------------
--------------------------------------------------------------------------------------------------------------------------------------------------------------------------------------------------------
--------------------------------------------------------------------------------------------------------------------------------------------------------------------------------------------------------
--------------------------------------------------------------------------------------------------------------------------------------------------------------------------------------------------------
--------------------------------------------------------------------------------------------------------------------------------------------------------------------------------------------------------
--------------------------------------------------------------------------------------------------------------------------------------------------------------------------------------------------------
--------------------------------------------------------------------------------------------------------------------------------------------------------------------------------------------------------
--------------------------------------------------------------------------------------------------------------------------------------------------------------------------------------------------------
--------------------------------------------------------------------------------------------------------------------------------------------------------------------------------------------------------
--------------------------------------------------------------------------------------------------------------------------------------------------------------------------------------------------------
--------------------------------------------------------------------------------------------------------------------------------------------------------------------------------------------------------
-----------------------------------------------------------------------------------------------------------------------------------------------oSooooo----ooSoo-----------------------------------------
---------------------------------------------------------------------------------------------oooSoo-----------------------oSSoSoS----oSSooo-------------------------------------------------------------
-----------------------------------SSS---------------------------------------------------------------------------------------------------------ooooooo------ooo----------------------ooSo---------------
----------------------SSSoo---------------------oSo---ooooo-----ooSSSSSo-----------------------ooo------SSoSo-----Soooo----oooooooo----ooo-----------------------------------------------------ooooooo--
XXXXXXXXXXXXXX---oo----------------ooooo---------------------XX-----------------------------------------------------------------g-------------XXXXXXXXXXXXXXXXXXXXXXXXXXXX-----------ooooo--------------
XXXXXXXXXXXXXX---------------------g-----------ooo--XXXXXXXXXXX--oooooo---------XXX---XXXXXXXXXXXXXXXX---------oooooo----XXXXXXXXXXXXXXXXXXXXXXXXXXXXXXXXXXXXXXXXXXXXXXXXX-------------------ooooooo---X
XXXXXXXXXXXXXXXXXXXX------------XXXXXXXXXXXXXX--g---XXXXXXXXXXX--------g------XXXXXXXXXXXXXXXXXXXXXXXX-----g-------------XXXXXXXXXXXXXXXXXXXXXXXXXXXXXXXXXXXXXXXXXXXXXXXXX-------XXXXXXXXXXX-----------X
XXXXXXXXXXXXXXXXXXXXXXXXXXXXXXXXXXXXXXXXXXXXXXXXXXXXXXXXXXXXXXXXXXXXXXXXXXXXXXXXXXXXXXXXXXXXXXXXXXXXXXXXXXXXXXXXXXXXXXXXXXXXXXXXXXXXXXXXXXXXXXXXXXXXXXXXXXXXXXXXXXXXXXXXXXXXXXXXXXXXXXXXXXXXXXXXXXXXXXXX

