--------------------------------------------------------------------------------------------------------------------------------------------------------------------------------------------------------
--------------------------------------------------------------------------------------------------------------------------------------------------------------------------------------------------------
--------------------------------------------------------------------------------------------------------------------------------------------------------------------------------------------------------
--------------------------------------------------------------------------------------------------------------------------------------------------------------------------------------------------------
--------------------------------------------------------------------------------------------------------------------------------------------------------------------------------------------------------
--------------------------------------------------------------------------------------------------------------------------------------------------------------------------------------------------------
--------------------------------------------------------------------------------------------------------------------------------------------------------------------------------------------------------
--------------------------------------------------------------------------------------------------------------------------------------------------------------------------------------------------------
--------------------------------------------------------------------------------------------------------------------------------------------------------------------------------------------------------
--------------------------------------------------------------------------------------------------------------------------------------------------------------------------------------------------------
--------------------------------------------------------------------------------------------------------------------------------------------------------------------------------------------------------
--------------------------------------------------------------------------------------------------------------------------------------------------------------------------------------------------------
--------------------------------------------------------------------------------------------------------------------------------------------------------------------ooSooSo-----------------------------
--------------------------------------------------------------------------------------------------------------------------------------------------------------------------------------------oooSS-------
------------------------------------------------------------------ooSS-----------------------------------------SSoooo-------------oooSSoo-----------------------------oo------------SSS-----------------
------------------------------------------------------------------------------Soooo----------------ooooS-----------------------------------oSoSoSSoo--------oooo-----------------------------ooooooo----
----------------XXXX-------------------------------------ooo-----ooooo--------------------------------------oooooo------------XX----oo----------------------------XXXXXXXXXX-------oooo-----g--------XXX
-------------XXXXXXXXX------------------ooooo-XXX---oo-----------------------ooooooo-XXXXXX--------oooo-----------------XXXXXXXX--------------ooooo--------ooo----XXXXXXXXXX----------g--g-XXXXXXXXXXXXX
-------------XXXXXXXXXXXXXXXX-g---------------XXX-------XXXXXXXXXXXXXXXX-------------XXXXXXXXXX------------XXXXXXXXXXX--XXXXXXXXXXXXXXXXXX-----------XXXXX--------XXXXXXXXXXXXXXXXXXXXXXXXXXXXXXXXXXXXXX
XXXXXXXXXXXXXXXXXXXXXXXXXXXXXXXXXXXXXXXXXXXXXXXXXXXXXXXXXXXXXXXXXXXXXXXXXXXXXXXXXXXXXXXXXXXXXXXXXXXXXXXXXXXXXXXXXXXXXXXXXXXXXXXXXXXXXXXXXXXXXXXXXXXXXXXXXXXXXXXXXXXXXXXXXXXXXXXXXXXXXXXXXXXXXXXXXXXXXXXX

