--------------------------------------------------------------------------------------------------------------------------------------------------------------------------------------------------------
--------------------------------------------------------------------------------------------------------------------------------------------------------------------------------------------------------
--------------------------------------------------------------------------------------------------------------------------------------------------------------------------------------------------------
--------------------------------------------------------------------------------------------------------------------------------------------------------------------------------------------------------
--------------------------------------------------------------------------------------------------------------------------------------------------------------------------------------------------------
--------------------------------------------------------------------------------------------------------------------------------------------------------------------------------------------------------
--------------------------------------------------------------------------------------------------------------------------------------------------------------------------------------------------------
--------------------------------------------------------------------------------------------------------------------------------------------------------------------------------------------------------
--------------------------------------------------------------------------------------------------------------------------------------------------------------------------------------------------------
--------------------------------------------------------------------------------------------------------------------------------------------------------------------------------------------------------
--------------------------------------------------------------------------------------------------------------------------------------------------------------------------------------------------------
--------------------------------------------------------------------------------------------------------------------------------------------------------------------------------------------------------
-----------------------------------------------ooSo--------------------------------------------------------------------------------------------------ooo------------------------------------------------
------------------------------------------------------------------------------------------------------------------------------------------oSooSSo-------------------------------------------------------
--------------oooo-------------oSS-------tt---ooooo-------------ooSoS---------------------------------------------------------------------------------oooo---------oSoooS-------------------------------
-----------------------------------------tt-----------------------------------------------------------oSoS-----ooSoooSoo------------------ooooo-------g------------------------------------oooooooo-----
----------------ooo----------------------tt--XXXXXXX--------------ooooo--XXXXXXXXX-------------XXXXXX----------------------ooo---ooooooo--g--------XXXXXXXX--oo-------oooooo------------------------XXXX
XXXXXXXXXXXX-----g-------XXXXX----------XXXXXXXXXXXX-------------g-------XXXXXXXXX--ooooo------XXXXXX------------ooooo-------------------XXXXXXXXXXXXXXXXXX--------------------------XXXXXXXXXXXXXXXXXXX
XXXXXXXXXXXXXXXXXXXXXX---XXXXXXXXXXXXXXXXXXXXXXXXXXXXXXX-------XXXXXXXXXXXXXXXXXXX--------XXXXXXXXXXX----------g---------XXXXXXXXXXXXXXXXXXXXXXXXXXXXXXXXXXXXXXXXXXXXXXXXXXXX--------XXXXXXXXXXXXXXXXXXX
XXXXXXXXXXXXXXXXXXXXXXXXXXXXXXXXXXXXXXXXXXXXXXXXXXXXXXXXXXXXXXXXXXXXXXXXXXXXXXXXXXXXXXXXXXXXXXXXXXXXXXXXXXXXXXXXXXXXXXXXXXXXXXXXXXXXXXXXXXXXXXXXXXXXXXXXXXXXXXXXXXXXXXXXXXXXXXXXXXXXXXXXXXXXXXXXXXXXXXXX

