--------------------------------------------------------------------------------------------------------------------------------------------------------------------------------------------------------
--------------------------------------------------------------------------------------------------------------------------------------------------------------------------------------------------------
--------------------------------------------------------------------------------------------------------------------------------------------------------------------------------------------------------
--------------------------------------------------------------------------------------------------------------------------------------------------------------------------------------------------------
--------------------------------------------------------------------------------------------------------------------------------------------------------------------------------------------------------
--------------------------------------------------------------------------------------------------------------------------------------------------------------------------------------------------------
--------------------------------------------------------------------------------------------------------------------------------------------------------------------------------------------------------
--------------------------------------------------------------------------------------------------------------------------------------------------------------------------------------------------------
--------------------------------------------------------------------------------------------------------------------------------------------------------------------------------------------------------
--------------------------------------------------------------------------------------------------------------------------------------------------------------------------------------------------------
--------------------------------------------------------------------------------------------------------------------------------------------------------------------------------------------------------
--------------------------------------------------------------------------------------------------------------------------------------------------------------------------------------------------------
------------------------------------------------ooooo---------------------------------------------------------------------------------------------------------------------------------oSooo---SSoo------
--------------------------------------------------------------ooSSS------------------------------------------------oooooo-------------------------------------------------------------------------------
-------------------------------------ooooSS------oooo---------------------------------------------------ooSoSSo------------------------------oSSo------------------------------------ooooo----ooo-------
----------------------------------------------------------------ooooo--------------------------oSSoo---------------ooooooo---------------------------------------------oSoSSoS--------------------------
XXXXXXXXXXXXXX-----------------------ooooo-----XXXXXXX---oo-------------------------------------------ooooooo--------------XX-oo------------ooooooo-----------------------------XXXXXXXXXXXXXXXXXXX-----
XXXXXXXXXXXXXX-------------------------------XXXXXXXXX-------XXXXXXXXX-----XXXX-------oooo---ooooooo------------XXXXXXXXXXXXX----------XXX-------------oooo------------oooooooo-XXXXXXXXXXXXXXXXXXX-----
XXXXXXXXXXXXXX------XXXXXXXXXXXXXXXXXXXXXXXXXXXXXXXXXXXXXXXXXXXXXXXXXX-----XXXXXXXXX-----------------XXXXXXXXXXXXXXXXXXXXXXXXXXXXXX----XXXXXXXXXXXXXX----------XXXXXX-----------XXXXXXXXXXXXXXXXXXXXXXXX
XXXXXXXXXXXXXXXXXXXXXXXXXXXXXXXXXXXXXXXXXXXXXXXXXXXXXXXXXXXXXXXXXXXXXXXXXXXXXXXXXXXXXXXXXXXXXXXXXXXXXXXXXXXXXXXXXXXXXXXXXXXXXXXXXXXXXXXXXXXXXXXXXXXXXXXXXXXXXXXXXXXXXXXXXXXXXXXXXXXXXXXXXXXXXXXXXXXXXXXX

