--------------------------------------------------------------------------------------------------------------------------------------------------------------------------------------------------------
--------------------------------------------------------------------------------------------------------------------------------------------------------------------------------------------------------
--------------------------------------------------------------------------------------------------------------------------------------------------------------------------------------------------------
--------------------------------------------------------------------------------------------------------------------------------------------------------------------------------------------------------
--------------------------------------------------------------------------------------------------------------------------------------------------------------------------------------------------------
--------------------------------------------------------------------------------------------------------------------------------------------------------------------------------------------------------
--------------------------------------------------------------------------------------------------------------------------------------------------------------------------------------------------------
--------------------------------------------------------------------------------------------------------------------------------------------------------------------------------------------------------
--------------------------------------------------------------------------------------------------------------------------------------------------------------------------------------------------------
--------------------------------------------------------------------------------------------------------------------------------------------------------------------------------------------------------
--------------------------------------------------------------------------------------------------------------------------------------------------------------------------------------------------------
--------------------------------------------------------------------------------------------------------------------------------------------------------------------------------------------------------
--------------------SoSo---------------------------------Soo----------------------SoSo-----------------Soo------------------------------------------ooooS-----------------------------------------------
------------------------------------------------------------------SoSSS---------------------------------------------------------oooooo------------------------------------------------------------------
------------------------------ooSoS---------------------ooo-----------------------oooo--------oooS----oooo------------------------------------------oooooo---ooSooo-------------------------------------
--------------------------------------------------ooo-----------oooooooo---------------------------------------oSooo------------ooooooo-------------------------------------oooooo--oooSoo--------------
----------------XXXXXXXXXXXXX--------------------------XXXXXXX-----------------XXXXXXXXXXXXXX--oooo-XXXXXXXXXX--------ooooooo---------------------XXXXXXXXXX----oooo-XXXXXX-----------------------------
-------------XXXXXXXXXXXXXXXX------------------XXXXXXXXXXXXXXXXXXXXXXXXXX----XXXXXXXXXXXXXXXX-------XXXXXXXXXX--oo-------------XXXXXXXXXXXXXXXXXXXXXXXXXXXXX---------XXXXXXXXXXXXXX-ooooooo-------------
-------------XXXXXXXXXXXXXXXXXXXXXXXXXXXXX-----XXXXXXXXXXXXXXXXXXXXXXXXXXXXXXXXXXXXXXXXXXXXXXXXXXXXXXXXXXXXXXX-------XXXXXXXXXXXXXXXXXXXXXXXXXXXXXXXXXXXXXXXXXXXXXXXXXXXXXXXXXXXXXX----------XXXXXXXXXX-
XXXXXXXXXXXXXXXXXXXXXXXXXXXXXXXXXXXXXXXXXXXXXXXXXXXXXXXXXXXXXXXXXXXXXXXXXXXXXXXXXXXXXXXXXXXXXXXXXXXXXXXXXXXXXXXXXXXXXXXXXXXXXXXXXXXXXXXXXXXXXXXXXXXXXXXXXXXXXXXXXXXXXXXXXXXXXXXXXXXXXXXXXXXXXXXXXXXXXXXX

