--------------------------------------------------------------------------------------------------------------------------------------------------------------------------------------------------------
--------------------------------------------------------------------------------------------------------------------------------------------------------------------------------------------------------
--------------------------------------------------------------------------------------------------------------------------------------------------------------------------------------------------------
--------------------------------------------------------------------------------------------------------------------------------------------------------------------------------------------------------
--------------------------------------------------------------------------------------------------------------------------------------------------------------------------------------------------------
--------------------------------------------------------------------------------------------------------------------------------------------------------------------------------------------------------
--------------------------------------------------------------------------------------------------------------------------------------------------------------------------------------------------------
--------------------------------------------------------------------------------------------------------------------------------------------------------------------------------------------------------
--------------------------------------------------------------------------------------------------------------------------------------------------------------------------------------------------------
--------------------------------------------------------------------------------------------------------------------------------------------------------------------------------------------------------
--------------------------------------------------------------------------------------------------------------------------------------------------------------------------------------------------------
--------------------------------------------------------------------------------------------------------------------------------------------------------------------------------------------------------
----------------------------------------ooSSo------ooSooo------------------------------------------------------ooooooo-----------oooo-------------------------------------------------------------------
------------------------ooo------------------------------------------------------------------------------------------------SoSo-------------------------------------------------------------------------
------------oSoSoSo------------------oooooooo------oooo-------------------------------oo------------------------ooooo---------------ooo-----oo-------------ooSS--------------------ooooooo--------------
-----------------------ooooo------------------------------------------------------------------ooooS----oSoo-------------oooo--------------g--------------------------------ooS--------------------------
------------oooooo------------------XXXXXXXXXXX--XXXXXXXXX------------------XXXXXXX--XXXXXX-------------------XXXXXXXXX---------XXXXXXXXXXXXXXXX---------ooooooo------------------XXXXXXXXX-------------
XXXXXXXXXXX-----------XXXXXXXXXXXX--XXXXXXXXXXX--XXXXXXXXX-------------oo---XXXXXXXXXXXXXXX--oooo--------oooo-XXXXXXXXXXXXXXXXXXXXXXXXXXXXXXXXXX--------------------oo------------XXXXXXXXX-------------
XXXXXXXXXXXXXXXXXXXXXXXXXXXXXXXXXXXXXXXXXXXXXXXXXXXXXXXXXX------XXXXX-------XXXXXXXXXXXXXXX-------------------XXXXXXXXXXXXXXXXXXXXXXXXXXXXXXXXXXXX-----XXXXXXXXXXX----------g-----XXXXXXXXXXXXXXXXXXXXXX
XXXXXXXXXXXXXXXXXXXXXXXXXXXXXXXXXXXXXXXXXXXXXXXXXXXXXXXXXXXXXXXXXXXXXXXXXXXXXXXXXXXXXXXXXXXXXXXXXXXXXXXXXXXXXXXXXXXXXXXXXXXXXXXXXXXXXXXXXXXXXXXXXXXXXXXXXXXXXXXXXXXXXXXXXXXXXXXXXXXXXXXXXXXXXXXXXXXXXXXX

