--------------------------------------------------------------------------------------------------------------------------------------------------------------------------------------------------------
--------------------------------------------------------------------------------------------------------------------------------------------------------------------------------------------------------
--------------------------------------------------------------------------------------------------------------------------------------------------------------------------------------------------------
--------------------------------------------------------------------------------------------------------------------------------------------------------------------------------------------------------
--------------------------------------------------------------------------------------------------------------------------------------------------------------------------------------------------------
--------------------------------------------------------------------------------------------------------------------------------------------------------------------------------------------------------
--------------------------------------------------------------------------------------------------------------------------------------------------------------------------------------------------------
--------------------------------------------------------------------------------------------------------------------------------------------------------------------------------------------------------
--------------------------------------------------------------------------------------------------------------------------------------------------------------------------------------------------------
--------------------------------------------------------------------------------------------------------------------------------------------------------------------------------------------------------
--------------------------------------------------------------------------------------------------------------------------------------------------------------------------------------------------------
--------------------------------------------------------------------------------------------------------------------------------------------------------------------------------------------------------
-------------------------------------------------------------------------------------------------------------------------------------------------------------------------oSSo------------------oSooSS---
--------------------------------------------------------ooSooo---------------------SSoo-----------------------------------------------------------------------------------------------------------------
----------------oSSoSo----------------------------------------------------------------------------------------------------------------------------oSSoo------------------ooo---ooo---------------oooo---
--------------------------------------------------------oooooo-------ooooo--------oooooo---------oSooo----------------------ooo-------oo------------------------------------g---------------------------
------------------ooo-------XX--------------------------------------------------------g------------------------XXXXXXXXX----------------------------oooo-------ooooo--XXXXXXXX----ooo---------XXXXXXXXXX
XXXXXXXXXXX-----------------XX-------ooo---------ooo---XXXXXXXXX------oo-------XXXXXXXXXXX------ooooooo--------XXXXXXXXXXXXXXXXXX---XXXXXXX---oo----------------------XXXXXXXX----------------XXXXXXXXXX
XXXXXXXXXXXXXXXXXXXXXXXXXXXXXXXXXX---------------------XXXXXXXXXXXX------------XXXXXXXXXXX---------------------XXXXXXXXXXXXXXXXXXXXXXXXXXXX------XXXXXXXXXXXXXXXXXXXXXXXXXXXXXXXXXXXXXXXXXXXXXXXXXXXXXXX
XXXXXXXXXXXXXXXXXXXXXXXXXXXXXXXXXXXXXXXXXXXXXXXXXXXXXXXXXXXXXXXXXXXXXXXXXXXXXXXXXXXXXXXXXXXXXXXXXXXXXXXXXXXXXXXXXXXXXXXXXXXXXXXXXXXXXXXXXXXXXXXXXXXXXXXXXXXXXXXXXXXXXXXXXXXXXXXXXXXXXXXXXXXXXXXXXXXXXXXX

