--------------------------------------------------------------------------------------------------------------------------------------------------------------------------------------------------------
--------------------------------------------------------------------------------------------------------------------------------------------------------------------------------------------------------
--------------------------------------------------------------------------------------------------------------------------------------------------------------------------------------------------------
--------------------------------------------------------------------------------------------------------------------------------------------------------------------------------------------------------
--------------------------------------------------------------------------------------------------------------------------------------------------------------------------------------------------------
--------------------------------------------------------------------------------------------------------------------------------------------------------------------------------------------------------
--------------------------------------------------------------------------------------------------------------------------------------------------------------------------------------------------------
--------------------------------------------------------------------------------------------------------------------------------------------------------------------------------------------------------
--------------------------------------------------------------------------------------------------------------------------------------------------------------------------------------------------------
--------------------------------------------------------------------------------------------------------------------------------------------------------------------------------------------------------
--------------------------------------------------------------------------------------------------------------------------------------------------------------------------------------------------------
--------------------------------------------------------------------------------------------------------------------------------------------------------------------------------------------------------
-------------------------------------------------------------------------------------------------------------------------------------------------------------------------------------SooS---------------
------------------------------------------SSoo---------------Sooo------------Soo----------------------------------------------------------------------ooooo---------------------------------------------
--------------SSooS-----oooS--------------------------------------------------------------------oo------ooSSSSoo-------------oooo---------------------------------------------------ooooo---------ooo---
--------------------------------------------oo------Sooo---oooooo----------oo-------------SSoo-------------------------ooS-------------------oooooo----------------------oo-----------------------------
---------------oooooo-----oo------------------------------g-------XXXXXXX--------XXXXX---------XXXXXXX----ooo----------------ooo----------------------------------XXXX-g----------XXXXXXXXXX-----XXXXXXX
----------------------------g-----ooooo-XXXXXXXX---ooooo-XXXXXXXXXXXXXXXXXXXXXXXXXXXXX---ooooo-XXXXXXX-----------------ooo------------ooo---XXXXXXXXXXXXXXXX-ooo--XXXXXXXXXXXXXXXXXXXXXXXXXX-----XXXXXXX
XXXXXXXXXXXXXXXXXXXXXXXXXXXXXX----------XXXXXXXX---g-----XXXXXXXXXXXXXXXXXXXXXXXXXXXXX---------XXXXXXXXXXXXXXXXXX-----------XXXXXXXX--------XXXXXXXXXXXXXXXX------XXXXXXXXXXXXXXXXXXXXXXXXXX-----XXXXXXX
XXXXXXXXXXXXXXXXXXXXXXXXXXXXXXXXXXXXXXXXXXXXXXXXXXXXXXXXXXXXXXXXXXXXXXXXXXXXXXXXXXXXXXXXXXXXXXXXXXXXXXXXXXXXXXXXXXXXXXXXXXXXXXXXXXXXXXXXXXXXXXXXXXXXXXXXXXXXXXXXXXXXXXXXXXXXXXXXXXXXXXXXXXXXXXXXXXXXXXXX

