--------------------------------------------------------------------------------------------------------------------------------------------------------------------------------------------------------
--------------------------------------------------------------------------------------------------------------------------------------------------------------------------------------------------------
--------------------------------------------------------------------------------------------------------------------------------------------------------------------------------------------------------
--------------------------------------------------------------------------------------------------------------------------------------------------------------------------------------------------------
--------------------------------------------------------------------------------------------------------------------------------------------------------------------------------------------------------
--------------------------------------------------------------------------------------------------------------------------------------------------------------------------------------------------------
--------------------------------------------------------------------------------------------------------------------------------------------------------------------------------------------------------
--------------------------------------------------------------------------------------------------------------------------------------------------------------------------------------------------------
--------------------------------------------------------------------------------------------------------------------------------------------------------------------------------------------------------
--------------------------------------------------------------------------------------------------------------------------------------------------------------------------------------------------------
--------------------------------------------------------------------------------------------------------------------------------------------------------------------------------------------------------
--------------------------------------------------------------------------------------------------------------------------------------------------------------------------------------------------------
----------------------------------------------------------------------------Soo-------------------------------------------------------------------------------------------------------------------------
------------ooSoSSSoo----------------oSSo-------------------------------------------------------------------------------Sooo---------------ooSSoo------oSooo--------------------SooSS-------------------
-----------------------------------------------------------------oSo---------------------------oSooSo---------oSooS------------------------------------------------oo-----------------------------------
--------------ooooo---------oo-----oooooooo-----oooooSoo-------------------------oSSoo----------------------------------ooo-------oSo------oooooooo--oooooooo-----g-----------oooooo--------------------
--------------------------------------------------------------ooooo-------XXXXXX---------------oooooo---XXXXX-ooooo-------g------------------------------------XXXXXXXXXXXXX-------------------------XXX
-----------XXXXXXXXXXX-----XXXXXXXXXXXXXXXXXX-----ooo------XX-------------XXXXXX-ooo------XXX-----------XXXXX--------XXXXXXXXX-oooooooo--XXXXXXXXXXXXXXXXXXXXXXXXXXXXXXXXXXXXXXXXXXXXXX-oo-----------XXX
-----------XXXXXXXXXXXXXXXXXXXXXXXXXXXXXXXXXX------------XXXXXXXXXXXX-----XXXXXX-------XXXXXXXXXXXXXXXXXXXXXXXXXXXXXXXXXXXXXXX-----------XXXXXXXXXXXXXXXXXXXXXXXXXXXXXXXXXXXXXXXXXXXXXX-------XXXXXXXXXX
XXXXXXXXXXXXXXXXXXXXXXXXXXXXXXXXXXXXXXXXXXXXXXXXXXXXXXXXXXXXXXXXXXXXXXXXXXXXXXXXXXXXXXXXXXXXXXXXXXXXXXXXXXXXXXXXXXXXXXXXXXXXXXXXXXXXXXXXXXXXXXXXXXXXXXXXXXXXXXXXXXXXXXXXXXXXXXXXXXXXXXXXXXXXXXXXXXXXXXXX

