--------------------------------------------------------------------------------------------------------------------------------------------------------------------------------------------------------
--------------------------------------------------------------------------------------------------------------------------------------------------------------------------------------------------------
--------------------------------------------------------------------------------------------------------------------------------------------------------------------------------------------------------
--------------------------------------------------------------------------------------------------------------------------------------------------------------------------------------------------------
--------------------------------------------------------------------------------------------------------------------------------------------------------------------------------------------------------
--------------------------------------------------------------------------------------------------------------------------------------------------------------------------------------------------------
--------------------------------------------------------------------------------------------------------------------------------------------------------------------------------------------------------
--------------------------------------------------------------------------------------------------------------------------------------------------------------------------------------------------------
--------------------------------------------------------------------------------------------------------------------------------------------------------------------------------------------------------
--------------------------------------------------------------------------------------------------------------------------------------------------------------------------------------------------------
--------------------------------------------------------------------------------------------------------------------------------------------------------------------------------------------------------
--------------------------------------------------------------------------------------------------------------------------------------------------------------------------------------------------------
--------------------------------------------------------------------------------------------Soo---------------------------------------------------------------------------------------------------------
--------------------------SoooS----------oSSoSo----ooSSo-----------------ooo-----oSoSoS---------------------------------------------------oooS------------------SooS------------------------------------
--------------------------------------------------------------------------------------------------------------------oSoSoo--oSSSoo----------------Soo---------------------------------------------------
-------------------oooo---oooo------------ooooo-----ooo-----SoS----------oooo----oooooooo---------ooooo----------------------------------ooo--------------------oooo------------SSoooo------------------
---------------------------------XX---------------------------------oo--------------------XXXXXXX-----------XXXXX---oooo-------oooooo---------g--oooooo--XXX--------------oo--------------------XXX-----
------------------XXXXXXXXXXXXXXXXX-----XXXXXXXXXXXXXXXXXX-------------XXXXXXXXXXXXXXXXXXXXXXXXXXXXXXXXX----XXXXX---------------------XXXXXXXXXX---------XXXXXXXXXXXXXX---------ooooooo---------XXXXXXXX
XXXXXXXXXXXXXX----XXXXXXXXXXXXXXXXX-----XXXXXXXXXXXXXXXXXX-------XXXXXXXXXXXXXXXXXXXXXXXXXXXXXXXXXXXXXXX----XXXXXXXXXXXXXXXXXXXXXXXXXXXXXXXXXXXXXXXXXXXXXXXXXXXXXXXXXXXXXXXXXX----------XXXX----XXXXXXXX
XXXXXXXXXXXXXXXXXXXXXXXXXXXXXXXXXXXXXXXXXXXXXXXXXXXXXXXXXXXXXXXXXXXXXXXXXXXXXXXXXXXXXXXXXXXXXXXXXXXXXXXXXXXXXXXXXXXXXXXXXXXXXXXXXXXXXXXXXXXXXXXXXXXXXXXXXXXXXXXXXXXXXXXXXXXXXXXXXXXXXXXXXXXXXXXXXXXXXXXX

