--------------------------------------------------------------------------------------------------------------------------------------------------------------------------------------------------------
--------------------------------------------------------------------------------------------------------------------------------------------------------------------------------------------------------
--------------------------------------------------------------------------------------------------------------------------------------------------------------------------------------------------------
--------------------------------------------------------------------------------------------------------------------------------------------------------------------------------------------------------
--------------------------------------------------------------------------------------------------------------------------------------------------------------------------------------------------------
--------------------------------------------------------------------------------------------------------------------------------------------------------------------------------------------------------
--------------------------------------------------------------------------------------------------------------------------------------------------------------------------------------------------------
--------------------------------------------------------------------------------------------------------------------------------------------------------------------------------------------------------
--------------------------------------------------------------------------------------------------------------------------------------------------------------------------------------------------------
--------------------------------------------------------------------------------------------------------------------------------------------------------------------------------------------------------
--------------------------------------------------------------------------------------------------------------------------------------------------------------------------------------------------------
--------------------------------------------------------------------------------------------------------------------------------------------------------------------------------------------------------
---------------------------------------------------------------------------------oSooooSS------ooo-----------------------------------------------------------SoSo-------------------oooo----------------
-----------------------------------------------SSoooSo--------------------------------------------------------------------------------------------------------------------------------------------------
-----------oooooo----------------------------------------ooooooo--------------------oooooo-----oooo----------------------ooS-------------------------------oooooooo-----------------ooo-----------------
-----------------------------------------------ooooooo------------------oSoooo---------------------------------------------------------oo-----g----SoS--------------------ooo---------------------ooo---
XXXXXXXXXX---ooooooo-XXXXX---------XXXXX------------------oooooo----------------XXXXXXXXXXXXXXXXXXXXX-------------------oooo--------------XXXXXXX---------XXXXXXXXXXX------------XXXXXXXXX--------------
XXXXXXXXXX-----------XXXXX----oo---XXXXX-----XXXXXXXXXXX--------g---------ooooo-XXXXXXXXXXXXXXXXXXXXX----XXXXXXXXXXXX---------------XXXXXXXXXXXXX--ooo----XXXXXXXXXXX---XXXXXXXXXXXXXXXXXX------oo------
XXXXXXXXXXXXXXXXXXXXXXXXXX---------XXXXXXXXXXXXXXXXXXXXXXXXXXXXXXX--------------XXXXXXXXXXXXXXXXXXXXXXXXXXXXXXXXXXXXXXXXXXXXXXXXXXXXXXXXXXXXXXXXX---------XXXXXXXXXXXXXXXXXXXXXXXXXXXXXXXX------------XX
XXXXXXXXXXXXXXXXXXXXXXXXXXXXXXXXXXXXXXXXXXXXXXXXXXXXXXXXXXXXXXXXXXXXXXXXXXXXXXXXXXXXXXXXXXXXXXXXXXXXXXXXXXXXXXXXXXXXXXXXXXXXXXXXXXXXXXXXXXXXXXXXXXXXXXXXXXXXXXXXXXXXXXXXXXXXXXXXXXXXXXXXXXXXXXXXXXXXXXXX

