--------------------------------------------------------------------------------------------------------------------------------------------------------------------------------------------------------
--------------------------------------------------------------------------------------------------------------------------------------------------------------------------------------------------------
--------------------------------------------------------------------------------------------------------------------------------------------------------------------------------------------------------
--------------------------------------------------------------------------------------------------------------------------------------------------------------------------------------------------------
--------------------------------------------------------------------------------------------------------------------------------------------------------------------------------------------------------
--------------------------------------------------------------------------------------------------------------------------------------------------------------------------------------------------------
--------------------------------------------------------------------------------------------------------------------------------------------------------------------------------------------------------
--------------------------------------------------------------------------------------------------------------------------------------------------------------------------------------------------------
--------------------------------------------------------------------------------------------------------------------------------------------------------------------------------------------------------
--------------------------------------------------------------------------------------------------------------------------------------------------------------------------------------------------------
--------------------------------------------------------------------------------------------------------------------------------------------------------------------------------------------------------
--------------------------------------------------------------------------------------------------------------------------------------------------------------------------------------------------------
---------------------------oSSSoooSo------------------------------------------------------oooo--------------------------------------------------------------------------oSo-------------ooo-------------
---------------------------------------------------SoS------------------------------------------------------------------------------------Sooo----------------------------------------------------------
----------------------------ooooooo-----------------------------------------------------ooo---------------oo-----oooo-------------------------------------------oooooo-----------ooo----ooo-------------
-------------------oSSo------------------------------oooo---Soooo----ooo---------ooo---------------------------------------oooooo-----------------------------------------------------------------------
-------------XX-----------XXXXXXXXXXX----------------------------------g--------------XXXXXXXXX--------XXXXXXXXXXXXXXXX------------------------XXXXXXXXXX------XXXXXXXXXXXXXXXXXXXXXXXXXXXXXXXX--XXXXX--
-------------XX----oooooo-XXXXXXXXXXX----XXXXXXXXXXXXXXXXX-oooooooo-XXXXXX---XXXXXXXXXXXXXXXXXXXXX-----XXXXXXXXXXXXXXXX--ooooo-------oo-XXXXXXXXXXXXXXXXX------XXXXXXXXXXXXXXXXXXXXXXXXXXXXXXXX--XXXXX--
-------------XX-----------XXXXXXXXXXX----XXXXXXXXXXXXXXXXX----------XXXXXXXXXXXXXXXXXXXXXXXXXXXXXXXXXXXXXXXXXXXXXXXXXXX-----------------XXXXXXXXXXXXXXXXX------XXXXXXXXXXXXXXXXXXXXXXXXXXXXXXXXXXXXXXXXX
XXXXXXXXXXXXXXXXXXXXXXXXXXXXXXXXXXXXXXXXXXXXXXXXXXXXXXXXXXXXXXXXXXXXXXXXXXXXXXXXXXXXXXXXXXXXXXXXXXXXXXXXXXXXXXXXXXXXXXXXXXXXXXXXXXXXXXXXXXXXXXXXXXXXXXXXXXXXXXXXXXXXXXXXXXXXXXXXXXXXXXXXXXXXXXXXXXXXXXXX

