--------------------------------------------------------------------------------------------------------------------------------------------------------------------------------------------------------
--------------------------------------------------------------------------------------------------------------------------------------------------------------------------------------------------------
--------------------------------------------------------------------------------------------------------------------------------------------------------------------------------------------------------
--------------------------------------------------------------------------------------------------------------------------------------------------------------------------------------------------------
--------------------------------------------------------------------------------------------------------------------------------------------------------------------------------------------------------
--------------------------------------------------------------------------------------------------------------------------------------------------------------------------------------------------------
--------------------------------------------------------------------------------------------------------------------------------------------------------------------------------------------------------
--------------------------------------------------------------------------------------------------------------------------------------------------------------------------------------------------------
--------------------------------------------------------------------------------------------------------------------------------------------------------------------------------------------------------
--------------------------------------------------------------------------------------------------------------------------------------------------------------------------------------------------------
--------------------------------------------------------------------------------------------------------------------------------------------------------------------------------------------------------
--------------------------------------------------------------------------------------------------------------------------------------------------------------------------------------------------------
-------------------------------------------------------------------------------ooo----ooSooSSo----------------------------------------------------------------------------------------------------------
------------------------------------------oooSooo------------------------------------------------------------------ooSooSo--------------------ooo---------oSooSSo----------------------------------SSo--
------------------------oo------oSooSoo-------------------------------------ooooo-----oooooooo----------------------------------------------------------------------------------------ooSoooo-----------
------------------------------------------ooooo----------------oooo-----------------------g---------------------------oooo---------------------------------oooo------ooSoSooo---------------------ooo---
-------------XXXX-----XXXXXXXX--ooooo--------------------------------------XXXXXXXX--XXXXXXXXXXX--oo---------------------------------XX------------------------------------------XXXX-ooooooo-----------
-------------XXXXXXXXXXXXXXXXX----------XXXXXXXXXXX------XX------ooooo-XXXXXXXXXXXXXXXXXXXXXXXXX---------XXXXXXXXXXXXXXXXXX----------XX------XXXXXXXXXXXXXXXXXXXXXX---oooo----XXXXXXX-----------XXXXXXX-
-------------XXXXXXXXXXXXXXXXXXXXXXXXXXXXXXXXXXXXXXXXXXXXXXXXX---------XXXXXXXXXXXXXXXXXXXXXXXXXXXXXXXXXXXXXXXXXXXXXXXXXXXXXXXX------XXXXXXXXXXXXXXXXXXXXXXXXXXXXXX-------g---XXXXXXXXXXXXXXXXXXXXXXXXX-
XXXXXXXXXXXXXXXXXXXXXXXXXXXXXXXXXXXXXXXXXXXXXXXXXXXXXXXXXXXXXXXXXXXXXXXXXXXXXXXXXXXXXXXXXXXXXXXXXXXXXXXXXXXXXXXXXXXXXXXXXXXXXXXXXXXXXXXXXXXXXXXXXXXXXXXXXXXXXXXXXXXXXXXXXXXXXXXXXXXXXXXXXXXXXXXXXXXXXXXX

