--------------------------------------------------------------------------------------------------------------------------------------------------------------------------------------------------------
--------------------------------------------------------------------------------------------------------------------------------------------------------------------------------------------------------
--------------------------------------------------------------------------------------------------------------------------------------------------------------------------------------------------------
--------------------------------------------------------------------------------------------------------------------------------------------------------------------------------------------------------
--------------------------------------------------------------------------------------------------------------------------------------------------------------------------------------------------------
--------------------------------------------------------------------------------------------------------------------------------------------------------------------------------------------------------
--------------------------------------------------------------------------------------------------------------------------------------------------------------------------------------------------------
--------------------------------------------------------------------------------------------------------------------------------------------------------------------------------------------------------
--------------------------------------------------------------------------------------------------------------------------------------------------------------------------------------------------------
--------------------------------------------------------------------------------------------------------------------------------------------------------------------------------------------------------
--------------------------------------------------------------------------------------------------------------------------------------------------------------------------------------------------------
--------------------------------------------------------------------------------------------------------------------------------------------------------------------------------------------------------
--------------------------------------------------------------------------------------------------------------------------------------------------------------------------------------------------------
-----------------------oSoo--------------ooSo--------oooo------------------------------------------------------------------------------------------------SooS-------------------------------------------
-------------------------------ooSSoS-------------------------------------------------------SoSoSoo-----oo-----------------ooSo-------------------------------------------------------------------------
-----------------------ooo----------------ooo--------oooo-----------------ooSoo------ooo--------------------ooo---------------------------------Soooo----oooo----SoS------------------------------------
XXXXXXXXXX------------------g----oooooo---------------------XXXXX----------------------------oooooo-XXXXXXX------------------------------------------------------------------oooo------------------XXXXX
XXXXXXXXXXXXX-------XXXXXXXXXX----------XXXXXXXXXXXXXXXXXXXXXXXXXXXXXXXXX---ooo----XXXXXX-----------XXXXXXX-oooo-----XXXX--------------ooo-----oooo---XXXXXXXXX--oo---XXXXXX-----------------------XXXXX
XXXXXXXXXXXXXXXXXXXXXXXXXXXXXXXXXXXXXXXXXXXXXXXXXXXXXXXXXXXXXXXXXXXXXXXXX-------XXXXXXXXXXXXXXXXXXXXXXXXXXX------XXXXXXXXXXXXXXXXXXXX---g-------------XXXXXXXXX-------XXXXXXXXXXXX-----XXXXXX------XXXXX
XXXXXXXXXXXXXXXXXXXXXXXXXXXXXXXXXXXXXXXXXXXXXXXXXXXXXXXXXXXXXXXXXXXXXXXXXXXXXXXXXXXXXXXXXXXXXXXXXXXXXXXXXXXXXXXXXXXXXXXXXXXXXXXXXXXXXXXXXXXXXXXXXXXXXXXXXXXXXXXXXXXXXXXXXXXXXXXXXXXXXXXXXXXXXXXXXXXXXXXX

