--------------------------------------------------------------------------------------------------------------------------------------------------------------------------------------------------------
--------------------------------------------------------------------------------------------------------------------------------------------------------------------------------------------------------
--------------------------------------------------------------------------------------------------------------------------------------------------------------------------------------------------------
--------------------------------------------------------------------------------------------------------------------------------------------------------------------------------------------------------
--------------------------------------------------------------------------------------------------------------------------------------------------------------------------------------------------------
--------------------------------------------------------------------------------------------------------------------------------------------------------------------------------------------------------
--------------------------------------------------------------------------------------------------------------------------------------------------------------------------------------------------------
--------------------------------------------------------------------------------------------------------------------------------------------------------------------------------------------------------
--------------------------------------------------------------------------------------------------------------------------------------------------------------------------------------------------------
--------------------------------------------------------------------------------------------------------------------------------------------------------------------------------------------------------
--------------------------------------------------------------------------------------------------------------------------------------------------------------------------------------------------------
--------------------------------------------------------------------------------------------------------------------------------------------------------------------------------------------------------
--------------------------------------------------------------------------------oooo----ooSooooo-------------------------------------Soo----------------------------------------------SSSoSoo-----------
--------------ooSoSo-----------------------------------------------------------------------------------------------------oooooo-------------------------------------------------------------------------
-------------------------------oo-------------------------------------SSSo----------------ooo---------------------------------------oooo-----SooS-------------------------------------oooooooo----------
------------oooooooo--oooo-----g------------------------------------------------------------------------oSo-----ooo-----ooooooo----------------------SSoSS-------------oSSoSoo--------------------------
------------g----------------XXXXXX--------oo-------------------------oooooo--XXXXXXXXXXXXXXXXXXX------------------------g-------XXXXXXXXXX--oo------------------ooo----------------XXXXXXXXXXX---------
XXXXXXXXXXXXXXXXXXXXX--oooo--XXXXXXXXXX------------------------------------g--XXXXXXXXXXXXXXXXXXX-------------ooooo-XXXXXXXXXXXXXXXXXXXXXXX-----------oooooo------------oooooo------XXXXXXXXXXX---------
XXXXXXXXXXXXXXXXXXXXX--------XXXXXXXXXXXXXXXXX--XXXXXXXXXX---------XXXXXXXXXXXXXXXXXXXXXXXXXXXXXX--------------g----XXXXXXXXXXXXXXXXXXXXXXXXXXXXXXX----------XXXXXXXX-----------XX--XXXXXXXXXXXXXXX-----
XXXXXXXXXXXXXXXXXXXXXXXXXXXXXXXXXXXXXXXXXXXXXXXXXXXXXXXXXXXXXXXXXXXXXXXXXXXXXXXXXXXXXXXXXXXXXXXXXXXXXXXXXXXXXXXXXXXXXXXXXXXXXXXXXXXXXXXXXXXXXXXXXXXXXXXXXXXXXXXXXXXXXXXXXXXXXXXXXXXXXXXXXXXXXXXXXXXXXXXX

