--------------------------------------------------------------------------------------------------------------------------------------------------------------------------------------------------------
--------------------------------------------------------------------------------------------------------------------------------------------------------------------------------------------------------
--------------------------------------------------------------------------------------------------------------------------------------------------------------------------------------------------------
--------------------------------------------------------------------------------------------------------------------------------------------------------------------------------------------------------
--------------------------------------------------------------------------------------------------------------------------------------------------------------------------------------------------------
--------------------------------------------------------------------------------------------------------------------------------------------------------------------------------------------------------
--------------------------------------------------------------------------------------------------------------------------------------------------------------------------------------------------------
--------------------------------------------------------------------------------------------------------------------------------------------------------------------------------------------------------
--------------------------------------------------------------------------------------------------------------------------------------------------------------------------------------------------------
--------------------------------------------------------------------------------------------------------------------------------------------------------------------------------------------------------
--------------------------------------------------------------------------------------------------------------------------------------------------------------------------------------------------------
--------------------------------------------------------------------------------------------------------------------------------------------------------------------------------------------------------
--------------------Soo---oSoSSoo----------------------------------------ooSoo----------------ooooo-----------------------------------------------------------------------------------------------------
-----------------------------------oSooSo----ooSoo-------------------------------------------------------------------------------ooSSSo----------------------------------------------------Sooo---------
-------------------ooo-----oooooo------------------------------------------oooo------SooSSo----------------------oo----------------------------------------------------ooooSSo--------------------------
------------------g-------------g-----oooo----ooooo---------------oSSoo---------------------------------------------------------ooooo------SSSS-----oooSS------ooooo----------------------oo------------
-----------oo---XXXXXXXXXXXXXXXXXX--------------------------------------XXXXXXXXX---oooooooo-XXXXXXX----XXXXXX--XXXXXXX--oooo-------------------------------------------ooo--------XX-------------------
----------------XXXXXXXXXXXXXXXXXXXXXXXXXXXXXXXXXXXX----XXXXXXX---------XXXXXXXXX------------XXXXXXX----XXXXXX--XXXXXXX-------XXXXXXXXXX--ooo--------ooo----XXXXXXXXX--------------XX--XXXXXXXXX--------
----------XXXXXXXXXXXXXXXXXXXXXXXXXXXXXXXXXXXXXXXXXX----XXXXXXX---------XXXXXXXXXXXXXXXXXXXXXXXXXXXX----XXXXXXXXXXXXXXXXXXXXXXXXXXXXXXXX----g---------------XXXXXXXXXXXXXXXXXXX----XX--XXXXXXXXXXXXX----
XXXXXXXXXXXXXXXXXXXXXXXXXXXXXXXXXXXXXXXXXXXXXXXXXXXXXXXXXXXXXXXXXXXXXXXXXXXXXXXXXXXXXXXXXXXXXXXXXXXXXXXXXXXXXXXXXXXXXXXXXXXXXXXXXXXXXXXXXXXXXXXXXXXXXXXXXXXXXXXXXXXXXXXXXXXXXXXXXXXXXXXXXXXXXXXXXXXXXXXX

