--------------------------------------------------------------------------------------------------------------------------------------------------------------------------------------------------------
--------------------------------------------------------------------------------------------------------------------------------------------------------------------------------------------------------
--------------------------------------------------------------------------------------------------------------------------------------------------------------------------------------------------------
--------------------------------------------------------------------------------------------------------------------------------------------------------------------------------------------------------
--------------------------------------------------------------------------------------------------------------------------------------------------------------------------------------------------------
--------------------------------------------------------------------------------------------------------------------------------------------------------------------------------------------------------
--------------------------------------------------------------------------------------------------------------------------------------------------------------------------------------------------------
--------------------------------------------------------------------------------------------------------------------------------------------------------------------------------------------------------
--------------------------------------------------------------------------------------------------------------------------------------------------------------------------------------------------------
--------------------------------------------------------------------------------------------------------------------------------------------------------------------------------------------------------
--------------------------------------------------------------------------------------------------------------------------------------------------------------------------------------------------------
--------------------------------------------------------------------------------------------------------------------------------------------------------------------------------------------------------
------------------------------------------------------------------------------ooooSoo-------------------------------------------------------------oooS--------------------------------------------------
-----------------------------------------------oSoooo--------------------------------------------------------------------------------------------------------SSo----------------------------------------
-------------------------------------------------------------------------------oooooo--------------------------------------------oSSSoSS-------ooooooo--------------------------------------------------
-------------ooooooo----------------ooSSoo-------oooooo---------oo-------------g------------------------------ooSSoS-------Soo----------------------------oooo----------oo------------------------------
XXXXXXXXXX-----------XXXXX--XXXXXX-----------------------XXXX----------------XXXXXXXXX-----------XXX-------XX--------------------oooooooo-----XXXXXXXXXXX---------XXXXX-----------------------XXXXXXXXXX
XXXXXXXXXX----ooo----XXXXXXXXXXXXX-ooooooo-XXXXXXXXXXXXXXXXXXXXXXXXXX-oooo---XXXXXXXXX-----------XXX--ooo--XX--oooo---------oo----------------XXXXXXXXXXXXXXXXXXXXXXXXXXXXXXXXXXXXX---oo------XXXXXXXXXX
XXXXXXXXXX-----------XXXXXXXXXXXXX---------XXXXXXXXXXXXXXXXXXXXXXXXXX--------XXXXXXXXXXXXXXXXXXXXXXX-------XX-------------------XXXXXXXXXX----XXXXXXXXXXXXXXXXXXXXXXXXXXXXXXXXXXXXX------XXXXXXXXXXXXXXX
XXXXXXXXXXXXXXXXXXXXXXXXXXXXXXXXXXXXXXXXXXXXXXXXXXXXXXXXXXXXXXXXXXXXXXXXXXXXXXXXXXXXXXXXXXXXXXXXXXXXXXXXXXXXXXXXXXXXXXXXXXXXXXXXXXXXXXXXXXXXXXXXXXXXXXXXXXXXXXXXXXXXXXXXXXXXXXXXXXXXXXXXXXXXXXXXXXXXXXXX

