--------------------------------------------------------------------------------------------------------------------------------------------------------------------------------------------------------
--------------------------------------------------------------------------------------------------------------------------------------------------------------------------------------------------------
--------------------------------------------------------------------------------------------------------------------------------------------------------------------------------------------------------
--------------------------------------------------------------------------------------------------------------------------------------------------------------------------------------------------------
--------------------------------------------------------------------------------------------------------------------------------------------------------------------------------------------------------
--------------------------------------------------------------------------------------------------------------------------------------------------------------------------------------------------------
--------------------------------------------------------------------------------------------------------------------------------------------------------------------------------------------------------
--------------------------------------------------------------------------------------------------------------------------------------------------------------------------------------------------------
--------------------------------------------------------------------------------------------------------------------------------------------------------------------------------------------------------
--------------------------------------------------------------------------------------------------------------------------------------------------------------------------------------------------------
--------------------------------------------------------------------------------------------------------------------------------------------------------------------------------------------------------
--------------------------------------------------------------------------------------------------------------------------------------------------------------------------------------------------------
----------------------SoS------------------------Soo--------------------------------------------------------------------------------------------------------------Sooo----------------------------------
--------------------------------------oSooo--------------------oooo------------------------------------------------------------------------------------------------------------ooSoo--------oSSoo-------
-------------------oooooooo------------------------ooo-------------------------Tt---------------------------------------------------ooSSSoSS-----ooSoo---------ooooo------------------------------------
-------------------------k-----------oooo-----------------------ooo----ooSo----Tt---------------ooS---------------------------oooo-----------------------------y-r-Yy------------ooo---------oo---------
------------------XXXXXXXXXX-------Kyrk-k--g---XXXXXXXXXXXXXX-g----k--------XXXXXXX-------------------Y--y---------------------------oooooooo------------K--g-XXXXXXXXX--------g---y------K-------------
----------------XXXXXXXXXXXX-oo---XXXXXXXXXXXXXXXXXXXXXXXXXXXXXXXXXXXX------XXXXXXX---Ygg------------XXXXXXXXX------ooo----XXXXXXXX-rg-r-y--k-----y-y---XXXXXXXXXXXXXXX--yk--XXXXXXXX----XXXXXXXXXX-----
XXXXXXXXXX------XXXXXXXXXXXX--g---XXXXXXXXXXXXXXXXXXXXXXXXXXXXXXXXXXXX--y---XXXXXXXXXXXXXXXXXX----K--XXXXXXXXX-------------XXXXXXXXXXXXXXXXXXXXXXXXXXXXXXXXXXXXXXXXXXXXXXXXXXXXXXXXXX----XXXXXXXXXX--XXX
XXXXXXXXXXXXXXXXXXXXXXXXXXXXXXXXXXXXXXXXXXXXXXXXXXXXXXXXXXXXXXXXXXXXXXXXXXXXXXXXXXXXXXXXXXXXXXXXXXXXXXXXXXXXXXXXXXXXXXXXXXXXXXXXXXXXXXXXXXXXXXXXXXXXXXXXXXXXXXXXXXXXXXXXXXXXXXXXXXXXXXXXXXXXXXXXXXXXXXXX

