--------------------------------------------------------------------------------------------------------------------------------------------------------------------------------------------------------
--------------------------------------------------------------------------------------------------------------------------------------------------------------------------------------------------------
--------------------------------------------------------------------------------------------------------------------------------------------------------------------------------------------------------
--------------------------------------------------------------------------------------------------------------------------------------------------------------------------------------------------------
--------------------------------------------------------------------------------------------------------------------------------------------------------------------------------------------------------
--------------------------------------------------------------------------------------------------------------------------------------------------------------------------------------------------------
--------------------------------------------------------------------------------------------------------------------------------------------------------------------------------------------------------
--------------------------------------------------------------------------------------------------------------------------------------------------------------------------------------------------------
--------------------------------------------------------------------------------------------------------------------------------------------------------------------------------------------------------
--------------------------------------------------------------------------------------------------------------------------------------------------------------------------------------------------------
--------------------------------------------------------------------------------------------------------------------------------------------------------------------------------------------------------
--------------------------------------------------------------------------------------------------------------------------------------------------------------------------------------------------------
------------------------------------------SoSoSo------------------------------------------------------------------------------------------SSooo-----oSooo-----------------------------------------------
--------------------------------------------------------------------------------------------------------------------------------------------------------------------------------------------------------
-------------------------oooSS-----------oooooooo---------------------------------SSoo---------------------oSoo--------------------------oooooooo--------------------SoSSo------------------------------
---------------------------------------------------------ooSSS--------oooooo-----------------------------------------ooSS----------------R-k-------g------------------------------------oo--------------
XXXXXXXXXX--XXXXX--------ooooo----------XXXXXXXXXXX-----------------------------ooo--------ooo--XXXXX-------ooo-------------------------XXXXXXXXXXXXXXXXXX---------ooooooooo----XXXX-y-r---XXX----------
XXXXXXXXXX--XXXXXXXX-----K-rGg---K----y-XXXXXXXXXXX--------oooo-XXXXX-ooooo------G-----XXX--G---XXXXX------yr---g--ooooooooo-XXXXXX-----XXXXXXXXXXXXXXXXXX----------yrkr-g-g----XXXXXXXXXXXXXXXXXX----XX
XXXXXXXXXXXXXXXXXXXXXXXXXXXXXXXXXXXXXXXXXXXXXXXXXXXXXXXX--kr--y-XXXXX-g-k---k--XXXXXXXXXXXXXXXXXXXXXX----XXXXXXXXX-g---gr-kr-XXXXXXXXXXXXXXXXXXXXXXXXXXXXX--------XXXXXXXXXXXXXXXXXXXXXXXXXXXXXXXXXXXXXX
XXXXXXXXXXXXXXXXXXXXXXXXXXXXXXXXXXXXXXXXXXXXXXXXXXXXXXXXXXXXXXXXXXXXXXXXXXXXXXXXXXXXXXXXXXXXXXXXXXXXXXXXXXXXXXXXXXXXXXXXXXXXXXXXXXXXXXXXXXXXXXXXXXXXXXXXXXXXXXXXXXXXXXXXXXXXXXXXXXXXXXXXXXXXXXXXXXXXXXXX

