--------------------------------------------------------------------------------------------------------------------------------------------------------------------------------------------------------
--------------------------------------------------------------------------------------------------------------------------------------------------------------------------------------------------------
--------------------------------------------------------------------------------------------------------------------------------------------------------------------------------------------------------
--------------------------------------------------------------------------------------------------------------------------------------------------------------------------------------------------------
--------------------------------------------------------------------------------------------------------------------------------------------------------------------------------------------------------
--------------------------------------------------------------------------------------------------------------------------------------------------------------------------------------------------------
--------------------------------------------------------------------------------------------------------------------------------------------------------------------------------------------------------
--------------------------------------------------------------------------------------------------------------------------------------------------------------------------------------------------------
--------------------------------------------------------------------------------------------------------------------------------------------------------------------------------------------------------
--------------------------------------------------------------------------------------------------------------------------------------------------------------------------------------------------------
--------------------------------------------------------------------------------------------------------------------------------------------------------------------------------------------------------
--------------------------------------------------------------------------------------------------------------------------------------------------------------------------------------------------------
--------------------------------------------------------------------------------------------------------------------------------------------------------------------------------------------------------
-----------------------------ooo-------------------------------------------------------------------------------------ooo--------------------------------------------------------------------------------
-----------------ooSoS-------------SooSoS-------------------------ooo------------------oSSo--------oSo--------------------------------------------------------------------------------------------------
-----------------------------------------------------oo----RY--------------------------------------------------oSo-------------------------------------------------------ooooSo-------------------oSSo--
-------------XXX----ooooo----k-------ooooo----------rrry--XXXXXX--oo-------------------------XXX-oooo--XXXXX---------R---k-----------------------------------ooooo-----------------Yg-------------------
XXXXXXXXXXXXXXXX-g----YrR-XXXXXXX----------------XXXXXXXXXXXXXXX----R-r------------------k---XXX-r-G---XXXXX----ooo-XXXXXXXX----XXX-ooooo-------XXXXX--------gR--G--------ooooo---XXXXXX-----r-XX--oo---
XXXXXXXXXXXXXXXXXXXXXXXXXXXXXXXXXXXXXXXXXXX------XXXXXXXXXXXXXXXXXXXXXXXXXXXXX--r-----XXXXXXXXXXXXXXXXXXXXXXXX------XXXXXXXXXXXXXXX-gk------XXXXXXXXXXX----XXXXXXXXXXXX-r---------XXXXXXXXXXXXXXX-R-----
XXXXXXXXXXXXXXXXXXXXXXXXXXXXXXXXXXXXXXXXXXXXXXXXXXXXXXXXXXXXXXXXXXXXXXXXXXXXXXXXXXXXXXXXXXXXXXXXXXXXXXXXXXXXXXXXXXXXXXXXXXXXXXXXXXXXXXXXXXXXXXXXXXXXXXXXXXXXXXXXXXXXXXXXXXXXXXXXXXXXXXXXXXXXXXXXXXXXXXXX

