--------------------------------------------------------------------------------------------------------------------------------------------------------------------------------------------------------
--------------------------------------------------------------------------------------------------------------------------------------------------------------------------------------------------------
--------------------------------------------------------------------------------------------------------------------------------------------------------------------------------------------------------
--------------------------------------------------------------------------------------------------------------------------------------------------------------------------------------------------------
--------------------------------------------------------------------------------------------------------------------------------------------------------------------------------------------------------
--------------------------------------------------------------------------------------------------------------------------------------------------------------------------------------------------------
--------------------------------------------------------------------------------------------------------------------------------------------------------------------------------------------------------
--------------------------------------------------------------------------------------------------------------------------------------------------------------------------------------------------------
--------------------------------------------------------------------------------------------------------------------------------------------------------------------------------------------------------
--------------------------------------------------------------------------------------------------------------------------------------------------------------------------------------------------------
--------------------------------------------------------------------------------------------------------------------------------------------------------------------------------------------------------
--------------------------------------------------------------------------------------------------------------------------------------------------------------------------------------------------------
---------------------------oSooo----------------------------------------------------------------------oooooo------------------------------------------------------------------oSo-----------------------
---------------------------------------------------------------------------------------------------------------------------------------------------ooo-----------ooSooSo---------------ooo--------------
-----------------------------ooo--------oooooo--------------------------------------------------------ooooo----------------ooSS-------ooooooS----------------------------------oo-----------oooo--------
-----------ooooSSo----------Y--yR-----------------------oooooo-------oSooo----SSoo-----oooSooSo----------Y---------------------------------------oooooooo---------ooooo---------------------------------
--------------------------XXXXXXXXXX----ooooo--------------------------------------------------------XXXXXXXXXXXXXXXXXXX-----ooooo-XX----oooo----------K---------rR----------XXXXXX------y---oo----XXXXX
XXXXXXXXXX---oo-----------XXXXXXXXXXXX----G---kY-XXXX----ooo------------oo---oooooo-----oooo----XXXXXXXXXXXXXXXXXXXXXXXX------y-Y--XX-----------XXXXXXXXXX------XXXXXXXXX----XXXXXXXXXXXXXX--Y-----XXXXX
XXXXXXXXXX-r-----g--r-k---XXXXXXXXXXXXXXXXXXXXXXXXXXX--rgg---r-------Y-G-----R-Rgy--r---rg--y---XXXXXXXXXXXXXXXXXXXXXXXX--XXXXXXXXXXXXXXXXXXXXXXXXXXXXXXXXXXXXXXXXXXXXXXXXXXXXXXXXXXXXXXXXXXXXXXXXXXXXXX
XXXXXXXXXXXXXXXXXXXXXXXXXXXXXXXXXXXXXXXXXXXXXXXXXXXXXXXXXXXXXXXXXXXXXXXXXXXXXXXXXXXXXXXXXXXXXXXXXXXXXXXXXXXXXXXXXXXXXXXXXXXXXXXXXXXXXXXXXXXXXXXXXXXXXXXXXXXXXXXXXXXXXXXXXXXXXXXXXXXXXXXXXXXXXXXXXXXXXXXX

