--------------------------------------------------------------------------------------------------------------------------------------------------------------------------------------------------------
--------------------------------------------------------------------------------------------------------------------------------------------------------------------------------------------------------
--------------------------------------------------------------------------------------------------------------------------------------------------------------------------------------------------------
--------------------------------------------------------------------------------------------------------------------------------------------------------------------------------------------------------
--------------------------------------------------------------------------------------------------------------------------------------------------------------------------------------------------------
--------------------------------------------------------------------------------------------------------------------------------------------------------------------------------------------------------
--------------------------------------------------------------------------------------------------------------------------------------------------------------------------------------------------------
--------------------------------------------------------------------------------------------------------------------------------------------------------------------------------------------------------
--------------------------------------------------------------------------------------------------------------------------------------------------------------------------------------------------------
--------------------------------------------------------------------------------------------------------------------------------------------------------------------------------------------------------
--------------------------------------------------------------------------------------------------------------------------------------------------------------------------------------------------------
--------------------------------------------------------------------------------------------------------------------------------------------------------------------------------------------------------
---------------------------------------------------------------------------------------------------------------------------------------------oooSS----------------------------SoSSo---------------------
----------------------oooooSSo--------------------------------------------------------------------------ooo----oSo--------------------------------------------------------------------------------------
-------------------------------------------------SSSo-----------------------------------------------------------------ooo-----------------oooooo----------------oooo-----------ooo----------------------
----------------oooo---ooooo-------------K---------------oSoSS--------------oSooooooo---------------------------oo-------------oooSoSo----r-----k---------------------------gy-----gy--oSoSoS-----------
-------------------g---k-g------------XXXXXX---------------------------------------------------------R----r----------------------------XXXXXXXXXXXXX-----------ooooooo-----XXXXXXXXXXX------------------
----------XX---XXXXXXXXXXXXXXXXXXXXXXXXXXXXX-----g-------oooo-----------G-----oooooo--------XXXXXXXXXXXXXXXXXXXXXXXX-r-y-------ooooo---XXXXXXXXXXXXX-------XX--------k-----XXXXXXXXXXX--ooooo-----------
----------XXXXXXXXXXXXXXXXXXXXXXXXXXXXXXXXXXXXXXXXXXXXX-r-k---g------XXXXXX----Gky--k-XXXXXXXXXXXXXXXXXXXXXXXXXXXXXXXXXXXXXX--G--G-yk--XXXXXXXXXXXXX-----XXXXXXXXXXXXXXXXXXXXXXXXXXXXX------ry--------XX
XXXXXXXXXXXXXXXXXXXXXXXXXXXXXXXXXXXXXXXXXXXXXXXXXXXXXXXXXXXXXXXXXXXXXXXXXXXXXXXXXXXXXXXXXXXXXXXXXXXXXXXXXXXXXXXXXXXXXXXXXXXXXXXXXXXXXXXXXXXXXXXXXXXXXXXXXXXXXXXXXXXXXXXXXXXXXXXXXXXXXXXXXXXXXXXXXXXXXXXX

