--------------------------------------------------------------------------------------------------------------------------------------------------------------------------------------------------------
--------------------------------------------------------------------------------------------------------------------------------------------------------------------------------------------------------
--------------------------------------------------------------------------------------------------------------------------------------------------------------------------------------------------------
--------------------------------------------------------------------------------------------------------------------------------------------------------------------------------------------------------
--------------------------------------------------------------------------------------------------------------------------------------------------------------------------------------------------------
--------------------------------------------------------------------------------------------------------------------------------------------------------------------------------------------------------
--------------------------------------------------------------------------------------------------------------------------------------------------------------------------------------------------------
--------------------------------------------------------------------------------------------------------------------------------------------------------------------------------------------------------
--------------------------------------------------------------------------------------------------------------------------------------------------------------------------------------------------------
--------------------------------------------------------------------------------------------------------------------------------------------------------------------------------------------------------
--------------------------------------------------------------------------------------------------------------------------------------------------------------------------------------------------------
--------------------------------------------------------------------------------------------------------------------------------------------------------------------------------------------------------
----------------SSooS-----------------------------------------------------------------------------------------------------------------------------------------ooooSSoSo---------------------------------
--------------------------------oooo-----------------------------------------SSS-----oSoS---------------------------------------oSo---------------------------------------------------------------------
--------------oooooo--------------------------------------------------------------------------oooSo--------------oSoo-------------------------------------------oooo------------------------------------
------------------ky-----oooo---oooooo-------------------------------------ooooo------oo----------------------------------------oo------------------------------k--k--G---ooo---oooooSo------------rg-G-
-------------XXXXXXXXXXX-----------r-gk---XXXXXXX--------XXXXXXXX----XX---k--y--y-----g---g---oooooo--------------------------y-----G--oooo---XXXXX-----XXXXXXXXXXXXXXXX-rG-r--------------------XXXXXXX
XXXXXXXXXXXXXXXXXXXXXXXX------XXXXXXXXXX--XXXXXXX---XXXXXXXXXXXXX----XX--XXXXXXXXXXXXXXXXXXX---k-------k--y-------r---XXXX---XXXXXXXXX--------XXXXX-----XXXXXXXXXXXXXXXXXXXXXX---ooo------oo-----XXXXXXX
XXXXXXXXXXXXXXXXXXXXXXXX-k-k--XXXXXXXXXX--XXXXXXXXXXXXXXXXXXXXXXX----XX--XXXXXXXXXXXXXXXXXXXXXXXXXXXXXXXXXXX----XXXXXXXXXXXXXXXXXXXXXXXXXXXXXXXXXXX-----XXXXXXXXXXXXXXXXXXXXXX-k-rk---K-------XXXXXXXXXX
XXXXXXXXXXXXXXXXXXXXXXXXXXXXXXXXXXXXXXXXXXXXXXXXXXXXXXXXXXXXXXXXXXXXXXXXXXXXXXXXXXXXXXXXXXXXXXXXXXXXXXXXXXXXXXXXXXXXXXXXXXXXXXXXXXXXXXXXXXXXXXXXXXXXXXXXXXXXXXXXXXXXXXXXXXXXXXXXXXXXXXXXXXXXXXXXXXXXXXXX

