--------------------------------------------------------------------------------------------------------------------------------------------------------------------------------------------------------
--------------------------------------------------------------------------------------------------------------------------------------------------------------------------------------------------------
--------------------------------------------------------------------------------------------------------------------------------------------------------------------------------------------------------
--------------------------------------------------------------------------------------------------------------------------------------------------------------------------------------------------------
--------------------------------------------------------------------------------------------------------------------------------------------------------------------------------------------------------
--------------------------------------------------------------------------------------------------------------------------------------------------------------------------------------------------------
--------------------------------------------------------------------------------------------------------------------------------------------------------------------------------------------------------
--------------------------------------------------------------------------------------------------------------------------------------------------------------------------------------------------------
--------------------------------------------------------------------------------------------------------------------------------------------------------------------------------------------------------
--------------------------------------------------------------------------------------------------------------------------------------------------------------------------------------------------------
--------------------------------------------------------------------------------------------------------------------------------------------------------------------------------------------------------
--------------------------------------------------------------------------------------------------------------------------------------------------------------------------------------------------------
--------------------ooSooooo------------------------------------------------------oooooS----------------------------------------ooo--------------ooo------ooSo---------oooSo----------------------------
---------------ooo------------------------------------SSo------------------------------------------------------------------------------------------------------------------------ooo---------------Sooo-
----------------------ooo----------------------------------------ooo--------------ooooooo--------------oooooooo---------oSoo------------ooo----------------oooo--------oooooooo-------------------------
-------------ooo-----gr-g-r------ooSoS--------oo----oooo----------r--------oSSSo------k---Y---------------------------------------Yy---------------y---------y----------yg-------oo--------------oooo---
-------------y-K---XXXXXXXXXX-----------------R----Y--kkk------XXXXXX------------XXXXXXXXXXX--------------oooooo---------oooo-XXXXXXX--ooooo-XXXXXXXXXXXXXXXXXXX---XXXXXXXXXXXXX----r------y--g---y-----
------------XXXXXXXXXXXXXXXXXXXX-ooooo------XXXXXXXXXXXXXXXXXXXXXXXXX-------oo---XXXXXXXXXXX----ooooo----yK-G----------RG-----XXXXXXX-Y-y----XXXXXXXXXXXXXXXXXXX---XXXXXXXXXXXXXXXXXXX----XXXXXXXXXXXXXX
XXXXXXXXXXXXXXXXXXXXXXXXXXXXXXXX--k---K-XXXXXXXXXXXXXXXXXXXXXXXXXXXXX-----G---y--XXXXXXXXXXX----k--yg-XXXXXXXXXXX----XXXXXXXXXXXXXXXXXXXXXXXXXXXXXXXXXXXXXXXXXXXXXXXXXXXXXXXXXXXXXXXXXXXXXXXXXXXXXXXXXXX
XXXXXXXXXXXXXXXXXXXXXXXXXXXXXXXXXXXXXXXXXXXXXXXXXXXXXXXXXXXXXXXXXXXXXXXXXXXXXXXXXXXXXXXXXXXXXXXXXXXXXXXXXXXXXXXXXXXXXXXXXXXXXXXXXXXXXXXXXXXXXXXXXXXXXXXXXXXXXXXXXXXXXXXXXXXXXXXXXXXXXXXXXXXXXXXXXXXXXXXX

