--------------------------------------------------------------------------------------------------------------------------------------------------------------------------------------------------------
--------------------------------------------------------------------------------------------------------------------------------------------------------------------------------------------------------
--------------------------------------------------------------------------------------------------------------------------------------------------------------------------------------------------------
--------------------------------------------------------------------------------------------------------------------------------------------------------------------------------------------------------
--------------------------------------------------------------------------------------------------------------------------------------------------------------------------------------------------------
--------------------------------------------------------------------------------------------------------------------------------------------------------------------------------------------------------
--------------------------------------------------------------------------------------------------------------------------------------------------------------------------------------------------------
--------------------------------------------------------------------------------------------------------------------------------------------------------------------------------------------------------
--------------------------------------------------------------------------------------------------------------------------------------------------------------------------------------------------------
--------------------------------------------------------------------------------------------------------------------------------------------------------------------------------------------------------
--------------------------------------------------------------------------------------------------------------------------------------------------------------------------------------------------------
--------------------------------------------------------------------------------------------------------------------------------------------------------------------------------------------------------
---------------------oooS---------------------------------------------------------------------------------------------------------------------------------ooSS------------------------------------------
-----------------------------------------------------------------------------------------SoS---------------------------------------------oooSoo---------------------------------------------------------
--------------------ooooo-------------------------------------------ooSooo-------------------------------------------------------------------------------oooooo----------------ooooo--------------ooooo-
--------------------r--Y--RK-----y--ooo---------ooo-----------y-------------------ooo----oo-------------------y------------oooooSo---------ooooo--oSoo---g--R--y-------ooSoS---Yr---y----oooS--------RG-
--------------XXXXXXXXXXXXXXXXXXXXX--yg--XXXXX----k---------XXXXXXX--ooooooo------r------------K-----r------XXXXXXXXXXX----------------------yrg--------XXXXXXXXX-------------XXXXXXXX-----------XXXXXXX
XXXXXXXXXXXXXXXXXXXXXXXXXXXXXXXXXXXXXXXXXXXXXXXXXXXX----XXXXXXXXXXX-g------K--XXXXXXXXXXXXXXXXXXXXXXXXXXXXXXXXXXXXXXXXX------ooooo------XXXXXXXXX-------XXXXXXXXX-------oooo--XXXXXXXX---ooooo---XXXXXXX
XXXXXXXXXXXXXXXXXXXXXXXXXXXXXXXXXXXXXXXXXXXXXXXXXXXX----XXXXXXXXXXXXXXXXXXXXXXXXXXXXXXXXXXXXXXXXXXXXXXXXXXXXXXXXXXXXXXX----k--y---y--XXXXXXXXXXXX-------XXXXXXXXX-------Yy--R-XXXXXXXX-k----y-yy-XXXXXXX
XXXXXXXXXXXXXXXXXXXXXXXXXXXXXXXXXXXXXXXXXXXXXXXXXXXXXXXXXXXXXXXXXXXXXXXXXXXXXXXXXXXXXXXXXXXXXXXXXXXXXXXXXXXXXXXXXXXXXXXXXXXXXXXXXXXXXXXXXXXXXXXXXXXXXXXXXXXXXXXXXXXXXXXXXXXXXXXXXXXXXXXXXXXXXXXXXXXXXXXX

