--------------------------------------------------------------------------------------------------------------------------------------------------------------------------------------------------------
--------------------------------------------------------------------------------------------------------------------------------------------------------------------------------------------------------
--------------------------------------------------------------------------------------------------------------------------------------------------------------------------------------------------------
--------------------------------------------------------------------------------------------------------------------------------------------------------------------------------------------------------
--------------------------------------------------------------------------------------------------------------------------------------------------------------------------------------------------------
--------------------------------------------------------------------------------------------------------------------------------------------------------------------------------------------------------
--------------------------------------------------------------------------------------------------------------------------------------------------------------------------------------------------------
--------------------------------------------------------------------------------------------------------------------------------------------------------------------------------------------------------
--------------------------------------------------------------------------------------------------------------------------------------------------------------------------------------------------------
--------------------------------------------------------------------------------------------------------------------------------------------------------------------------------------------------------
--------------------------------------------------------------------------------------------------------------------------------------------------------------------------------------------------------
--------------------------------------------------------------------------------------------------------------------------------------------------------------------------------------------------------
-----------------------------------------------ooSSooSo---------------------------------------------------oSooo-----------------------------------------------------------------------------------------
--------------------------------------------------------------------------------SoSo-----------ooooo------------------oSo-----SoSSo---------------------------------------------------------------------
-------------------------------------------------ooo-----------------SSo--------------------------------oooooo----------------------------------------------------------------Soo-----------------------
---------------------------------oo------------g--yy--k---SSSSSSS-------------ooooo---------------oooo----------r--oooooo----oooooo---------------------------------------------------------------------
---------------ooooooo-XXXXXX-----r---------y-XXXXXXXXXX------------ooooooo----y-k--g-----XXXX---Kg----XXXXXXXXXXX-k-K-g-k--yk-K---------XXXXXXX--------------------oooo------ooo-----------------------
---------------R-y---R-XXXXXXXXXXXXXXXXXXXXXXXXXXXXXXXXX--oooooo----yy---R--XXXXXXXXXXXXXXXXXXXXXXXXXXXXXXXXXXXXXXXXXXXXXXXXXXXXXXXX-----XXXXXXX------XXXXX--XX------y-y-r----g--Rk----------XXXXX------
-------------XXXXXXXXXXXXXXXXXXXXXXXXXXXXXXXXXXXXXXXXXXX-r---rYg---XXXXXXXXXXXXXXXXXXXXXXXXXXXXXXXXXXXXXXXXXXXXXXXXXXXXXXXXXXXXXXXXX-----XXXXXXX---kY-XXXXXXXXXXXXXXXXXXXXXXXXXXXXXX-------XXXXXXX---XXX
XXXXXXXXXXXXXXXXXXXXXXXXXXXXXXXXXXXXXXXXXXXXXXXXXXXXXXXXXXXXXXXXXXXXXXXXXXXXXXXXXXXXXXXXXXXXXXXXXXXXXXXXXXXXXXXXXXXXXXXXXXXXXXXXXXXXXXXXXXXXXXXXXXXXXXXXXXXXXXXXXXXXXXXXXXXXXXXXXXXXXXXXXXXXXXXXXXXXXXXX

