--------------------------------------------------------------------------------------------------------------------------------------------------------------------------------------------------------
--------------------------------------------------------------------------------------------------------------------------------------------------------------------------------------------------------
--------------------------------------------------------------------------------------------------------------------------------------------------------------------------------------------------------
--------------------------------------------------------------------------------------------------------------------------------------------------------------------------------------------------------
--------------------------------------------------------------------------------------------------------------------------------------------------------------------------------------------------------
--------------------------------------------------------------------------------------------------------------------------------------------------------------------------------------------------------
--------------------------------------------------------------------------------------------------------------------------------------------------------------------------------------------------------
--------------------------------------------------------------------------------------------------------------------------------------------------------------------------------------------------------
--------------------------------------------------------------------------------------------------------------------------------------------------------------------------------------------------------
--------------------------------------------------------------------------------------------------------------------------------------------------------------------------------------------------------
--------------------------------------------------------------------------------------------------------------------------------------------------------------------------------------------------------
--------------------------------------------------------------------------------------------------------------------------------------------------------------------------------------------------------
-----------------------------------------------ooo-----------------------------------------------------------------ooS-----ooo--------------------------------------------------------------------------
------------------------------------------------------------------------------------------------------------------------------------------------------------------------SSo-----------------------------
-----------------ooSo---------SoSSoo-------------------------------------------ooo----oooSoS-----------------------oooo----------ooooo------------------------------------------------------------------
----------------------------------------------rg---------------oSo-----------r-y--y-------------------------------------------k--k--y------------------------------------oo-----------------------------
---------------ooooooo--------ooo------------XXXXXXXX-----------------XXXXXXXXXXXXXXX----oooo------------XXX------XXXXXXXXXXXXXXXXXXXXXX---------------------------------r---------y--------------------
----------------Y-----y------krrg------ooooo-XXXXXXXX--ooo-----oooo---XXXXXXXXXXXXXXX------y--XXX--------XXX-kG---XXXXXXXXXXXXXXXXXXXXXX-------oooo---------XXXX--oo--XXXXXXXXXXXXXXX----XXX------------
XXXXXXXXXXXXXXXXXXXXXXXX--XXXXXXXXXXX-----y--XXXXXXXX--------g--r-K---XXXXXXXXXXXXXXXXXXXXXXXXXXXXXX-----XXXXXXXXXXXXXXXXXXXXXXXXXXXXXXX--------K--------XXXXXXX---Yg-XXXXXXXXXXXXXXX----XXXXXXX--------
XXXXXXXXXXXXXXXXXXXXXXXXXXXXXXXXXXXXXXXXXXXXXXXXXXXXXXXXXXXXXXXXXXXXXXXXXXXXXXXXXXXXXXXXXXXXXXXXXXXXXXXXXXXXXXXXXXXXXXXXXXXXXXXXXXXXXXXXXXXXXXXXXXXXXXXXXXXXXXXXXXXXXXXXXXXXXXXXXXXXXXXXXXXXXXXXXXXXXXXX

