--------------------------------------------------------------------------------------------------------------------------------------------------------------------------------------------------------
--------------------------------------------------------------------------------------------------------------------------------------------------------------------------------------------------------
--------------------------------------------------------------------------------------------------------------------------------------------------------------------------------------------------------
--------------------------------------------------------------------------------------------------------------------------------------------------------------------------------------------------------
--------------------------------------------------------------------------------------------------------------------------------------------------------------------------------------------------------
--------------------------------------------------------------------------------------------------------------------------------------------------------------------------------------------------------
--------------------------------------------------------------------------------------------------------------------------------------------------------------------------------------------------------
--------------------------------------------------------------------------------------------------------------------------------------------------------------------------------------------------------
--------------------------------------------------------------------------------------------------------------------------------------------------------------------------------------------------------
--------------------------------------------------------------------------------------------------------------------------------------------------------------------------------------------------------
--------------------------------------------------------------------------------------------------------------------------------------------------------------------------------------------------------
--------------------------------------------------------------------------------------------------------------------------------------------------------------------------------------------------------
--------------------------------------------------------------------------------------------------------------------------SoSooo-------------------SSoSoo-----------------------------------------------
-----------------------ooSoSo------------------------ooo------------------------------------------------------------------------------------------------------------------------------------------------
---------------------------------------------------------------------------oooo-----------------oSoSoSoo------oooooSSS-----oooooo----------oooo-----oooo----------------------------------SoS-----------
--------------------oooooo-------oooo-------ooooS-----------------------R---R----oSSoSo----------------------------------Rk---Yg--------------Y--------------oooo---------------------------------------
-----------------XX----R----------------------------y------------------XXXXXXXXX---------------ooooooo--------oooooo----XXXXXXXXXXX-------XXXXXXXXXXXXXXXX------------ooo------XX-------oooooo----------
--------------XXXXXXXXXXXXXXXX---ooooo------ooooo--XXXXXXXXXXX---------XXXXXXXXX--oooooo----------y-------------r-----G-XXXXXXXXXXX-------XXXXXXXXXXXXXXXXXXXXXXXX---------XXXXXXXXXXX--r--Y--y--ooooo-X
XXXXXXXXXXXXXXXXXXXXXXXXXXXXXX-y------G----K-------XXXXXXXXXXXXXX--r---XXXXXXXXX---gg-Gr------XXXXXXXXXXX----XXXXXXXXXXXXXXXXXXXXXX-------XXXXXXXXXXXXXXXXXXXXXXXXXXXXXXXXXXXXXXXXXXXXXXXXXXXXXX---k-K-X
XXXXXXXXXXXXXXXXXXXXXXXXXXXXXXXXXXXXXXXXXXXXXXXXXXXXXXXXXXXXXXXXXXXXXXXXXXXXXXXXXXXXXXXXXXXXXXXXXXXXXXXXXXXXXXXXXXXXXXXXXXXXXXXXXXXXXXXXXXXXXXXXXXXXXXXXXXXXXXXXXXXXXXXXXXXXXXXXXXXXXXXXXXXXXXXXXXXXXXXX

