--------------------------------------------------------------------------------------------------------------------------------------------------------------------------------------------------------
--------------------------------------------------------------------------------------------------------------------------------------------------------------------------------------------------------
--------------------------------------------------------------------------------------------------------------------------------------------------------------------------------------------------------
--------------------------------------------------------------------------------------------------------------------------------------------------------------------------------------------------------
--------------------------------------------------------------------------------------------------------------------------------------------------------------------------------------------------------
--------------------------------------------------------------------------------------------------------------------------------------------------------------------------------------------------------
--------------------------------------------------------------------------------------------------------------------------------------------------------------------------------------------------------
--------------------------------------------------------------------------------------------------------------------------------------------------------------------------------------------------------
--------------------------------------------------------------------------------------------------------------------------------------------------------------------------------------------------------
--------------------------------------------------------------------------------------------------------------------------------------------------------------------------------------------------------
--------------------------------------------------------------------------------------------------------------------------------------------------------------------------------------------------------
--------------------------------------------------------------------------------------------------------------------------------------------------------------------------------------------------------
--------------------------------------------------------------------------------------ooooSSooo--------------------------------------------------------ooooSoo------------------------------------------
-----------------------------------------------------------------------------------------------------------------------------------------------------------------------------Sooo-----------------------
----------------oo----------------------------------------------------------SoSoSoS------ooo-----------ooooo----------------------------------------------ooo------ooo-------------------Soo------------
----------------krGk---------------yy-r--ooooo-----oSooo----------------------------------y-y-----------------------------oSo--------------------oo----g--r-K--------G------ooo-------------------------
---------------XXXXXX-------------XXXXXX--g-----------------------XXXXX-----ooooooo--XXXXXXXXXXX------oooooo--------------------------------XXXX---R--XXXXXXXXXXXXXXXXXX----g-yk------ooo---------------
---------------XXXXXX--------XXXXXXXXXXXXXXXXXX---oooo----XXX-----XXXXXXXX-y---K-KRy-XXXXXXXXXXXXX-----Rgyy---g---------ooo---XXXX----------XXXXXXXXXXXXXXXXXXXXXXXXXXXX--XXXXXXXXXXX-yk----------------
---------------XXXXXX---XXXXXXXXXXXXXXXXXXXXXXX-g-----KY--XXX--XXXXXXXXXXXXXXXXXXXXXXXXXXXXXXXXXXXXXXXXXXXXXXXXX-r-----kkyr-g-XXXXXXXXXXXXXXXXXXXXXXXXXXXXXXXXXXXXXXXXXXXXXXXXXXXXXXXXXXXXXXXXXXXX---k--
XXXXXXXXXXXXXXXXXXXXXXXXXXXXXXXXXXXXXXXXXXXXXXXXXXXXXXXXXXXXXXXXXXXXXXXXXXXXXXXXXXXXXXXXXXXXXXXXXXXXXXXXXXXXXXXXXXXXXXXXXXXXXXXXXXXXXXXXXXXXXXXXXXXXXXXXXXXXXXXXXXXXXXXXXXXXXXXXXXXXXXXXXXXXXXXXXXXXXXXX

