--------------------------------------------------------------------------------------------------------------------------------------------------------------------------------------------------------
--------------------------------------------------------------------------------------------------------------------------------------------------------------------------------------------------------
--------------------------------------------------------------------------------------------------------------------------------------------------------------------------------------------------------
--------------------------------------------------------------------------------------------------------------------------------------------------------------------------------------------------------
--------------------------------------------------------------------------------------------------------------------------------------------------------------------------------------------------------
--------------------------------------------------------------------------------------------------------------------------------------------------------------------------------------------------------
--------------------------------------------------------------------------------------------------------------------------------------------------------------------------------------------------------
--------------------------------------------------------------------------------------------------------------------------------------------------------------------------------------------------------
--------------------------------------------------------------------------------------------------------------------------------------------------------------------------------------------------------
--------------------------------------------------------------------------------------------------------------------------------------------------------------------------------------------------------
--------------------------------------------------------------------------------------------------------------------------------------------------------------------------------------------------------
--------------------------------------------------------------------------------------------------------------------------------------------------------------------------------------------------------
----------------------------oSSoo-------------------------------------------------------------------------------------------oSooo-----------------------------------------------------------------------
--------------------------------------------SooSo-----Soo-----------------------------------------------------------------------------------------------------------------------------------------------
----------------------------oooooo----------------------------ooo----------------------------------------------------oooSo----ooooo---------------------------------------------------------------------
---------------------ooo---------r----------ooooo---ooooo-------------------------------------oooooSo---oooSSoSo------------y-k---YG---------------------------------------------oo---------------------
--------------------------XXXXXXXXXX--------yg--G---YkrK-------------------XXXXXXX---------------------------------ooooooo-XXXXXXXXXX-ooooooo-XX-------ooo----------------XXXXX---R---------------------
--------------------------XXXXXXXXXX------XXXXXXXXXXXXXXXXXX---k-gk--------XXXXXXX-------------ooooo----ooooo-----gy----gk-XXXXXXXXXX-k-y--Y--XXXXXXX-grg-k------XXXXX----XXXXXXXXXXX------XXXXXX-------
--------------XXXXX--y--y-XXXXXXXXXXXXXXXXXXXXXXXXXXXXXXXXXXXXXXXXXXX--k---XXXXXXX----Kg-XXXX----g-yK----K-------XXXXXXXXXXXXXXXXXXXXXXXXXXXXXXXXXXXXXXXXXXXXXXXXXXXXXXXXXXXXXXXXXXXX-k-g--XXXXXX-------
XXXXXXXXXXXXXXXXXXXXXXXXXXXXXXXXXXXXXXXXXXXXXXXXXXXXXXXXXXXXXXXXXXXXXXXXXXXXXXXXXXXXXXXXXXXXXXXXXXXXXXXXXXXXXXXXXXXXXXXXXXXXXXXXXXXXXXXXXXXXXXXXXXXXXXXXXXXXXXXXXXXXXXXXXXXXXXXXXXXXXXXXXXXXXXXXXXXXXXXX

