--------------------------------------------------------------------------------------------------------------------------------------------------------------------------------------------------------
--------------------------------------------------------------------------------------------------------------------------------------------------------------------------------------------------------
--------------------------------------------------------------------------------------------------------------------------------------------------------------------------------------------------------
--------------------------------------------------------------------------------------------------------------------------------------------------------------------------------------------------------
--------------------------------------------------------------------------------------------------------------------------------------------------------------------------------------------------------
--------------------------------------------------------------------------------------------------------------------------------------------------------------------------------------------------------
--------------------------------------------------------------------------------------------------------------------------------------------------------------------------------------------------------
--------------------------------------------------------------------------------------------------------------------------------------------------------------------------------------------------------
--------------------------------------------------------------------------------------------------------------------------------------------------------------------------------------------------------
--------------------------------------------------------------------------------------------------------------------------------------------------------------------------------------------------------
--------------------------------------------------------------------------------------------------------------------------------------------------------------------------------------------------------
--------------------------------------------------------------------------------------------------------------------------------------------------------------------------------------------------------
-----------------------------------------------------------------------------------------------------------------------------SSSo----------------------------------------oSSoo--------------------------
--------------------------------------------------------------------------Sooo--------------------------------------oooooo----------------------oooooS-----------------------------------oSSSS----------
-----------------------------------------------------------------oooo----------------------------------------------------------ooo-------------------------------------oooo-----------------------------
-----------------oSoSo--------------------------------Sooooo-----gr-g-----oooo------------g-------------------------ooo------k---G---oSoooSoo----oooo-------------------G--Y----ooSo------ooooo---------
---------------------------------------oo----XXXX--------------XXXXXXX-K-----r-r--------XXXXXXX----------XXXXXXXXX--G--rr--XXXXXXXXX---------------k---r---XX---------XXXXXXXXX-----------------XXX-----
-------------XX---oooo------------XXXX----g--XXXX-----ooooooo--XXXXXXXXXXXXXXXXXX--g-g--XXXXXXX------XXXXXXXXXXXXXXXXXXXXXXXXXXXXXXX--ooooo----XXXXXXXXXXXXXX----ooo--XXXXXXXXX--oooo--XXXXXXXXXXXX-----
-------------XX-k----R---XXXXXXX--XXXXXXXXXXXXXXXXXX--gk-rr--k-XXXXXXXXXXXXXXXXXXXXXXXXXXXXXXXXXXXXXXXXXXXXXXXXXXXXXXXXXXXXXXXXXXXXX-------rGk-XXXXXXXXXXXXXX----K----XXXXXXXXX--------XXXXXXXXXXXX-----
XXXXXXXXXXXXXXXXXXXXXXXXXXXXXXXXXXXXXXXXXXXXXXXXXXXXXXXXXXXXXXXXXXXXXXXXXXXXXXXXXXXXXXXXXXXXXXXXXXXXXXXXXXXXXXXXXXXXXXXXXXXXXXXXXXXXXXXXXXXXXXXXXXXXXXXXXXXXXXXXXXXXXXXXXXXXXXXXXXXXXXXXXXXXXXXXXXXXXXXX

