--------------------------------------------------------------------------------------------------------------------------------------------------------------------------------------------------------
--------------------------------------------------------------------------------------------------------------------------------------------------------------------------------------------------------
--------------------------------------------------------------------------------------------------------------------------------------------------------------------------------------------------------
--------------------------------------------------------------------------------------------------------------------------------------------------------------------------------------------------------
--------------------------------------------------------------------------------------------------------------------------------------------------------------------------------------------------------
--------------------------------------------------------------------------------------------------------------------------------------------------------------------------------------------------------
--------------------------------------------------------------------------------------------------------------------------------------------------------------------------------------------------------
--------------------------------------------------------------------------------------------------------------------------------------------------------------------------------------------------------
--------------------------------------------------------------------------------------------------------------------------------------------------------------------------------------------------------
--------------------------------------------------------------------------------------------------------------------------------------------------------------------------------------------------------
--------------------------------------------------------------------------------------------------------------------------------------------------------------------------------------------------------
--------------------------------------------------------------------------------------------------------------------------------------------------------------------------------------------------------
-------------------------------------------------------------------oSo------------------------------------------------------oSooo-----------------------------------------------------------------------
------------------------------SSoSo---------------------------------------------oSo---------------------------------------------------------------------------------------------------------------------
-----------------oo---------------------------------------------ooooo-----------------------------------oooo---oSoooSS------ooooooo---------------------------------------------------------------------
---------------y------------ooooooo----------------oo---------------yy--y-y----ooooo------SSSSS-----------------------------rr-g-kK---------------ooSSo--------------------------------------r-G--ooo---
--------------XXXXXXX------Yk---gk-----------------------oo----XXXXXXXXXXXXXXX---K----------------XX----oooo--ooooooo------XXXXXXXXXXXXX-------------------XX-----------------XXXXX---ooo--XXXXXX---y--X
XXXXXXXXXXXXXXXXXXXXXXXXXXXXXXXXXXXXX-----XX------XXXXXX-----r-XXXXXXXXXXXXXXXXXXXXXXXX--ooooo----XX---kgRkg--gg--y-Grk-XXXXXXXXXXXXXXXX-------------------XX-kKyy------XXX---XXXXX-G------XXXXXXXXXXXXX
XXXXXXXXXXXXXXXXXXXXXXXXXXXXXXXXXXXXX-----XXXXXXXXXXXXXXXXXXXXXXXXXXXXXXXXXXXXXXXXXXXXX---y-----K-XXXXXXXXXXXXXXXXXXXXXXXXXXXXXXXXXXXXXXXXXXXXXXX-r--------XXXXXXXX-----XXX---XXXXXXXXXXXXXXXXXXXXXXXXXX
XXXXXXXXXXXXXXXXXXXXXXXXXXXXXXXXXXXXXXXXXXXXXXXXXXXXXXXXXXXXXXXXXXXXXXXXXXXXXXXXXXXXXXXXXXXXXXXXXXXXXXXXXXXXXXXXXXXXXXXXXXXXXXXXXXXXXXXXXXXXXXXXXXXXXXXXXXXXXXXXXXXXXXXXXXXXXXXXXXXXXXXXXXXXXXXXXXXXXXXX

