--------------------------------------------------------------------------------------------------------------------------------------------------------------------------------------------------------
--------------------------------------------------------------------------------------------------------------------------------------------------------------------------------------------------------
--------------------------------------------------------------------------------------------------------------------------------------------------------------------------------------------------------
--------------------------------------------------------------------------------------------------------------------------------------------------------------------------------------------------------
--------------------------------------------------------------------------------------------------------------------------------------------------------------------------------------------------------
--------------------------------------------------------------------------------------------------------------------------------------------------------------------------------------------------------
--------------------------------------------------------------------------------------------------------------------------------------------------------------------------------------------------------
--------------------------------------------------------------------------------------------------------------------------------------------------------------------------------------------------------
--------------------------------------------------------------------------------------------------------------------------------------------------------------------------------------------------------
--------------------------------------------------------------------------------------------------------------------------------------------------------------------------------------------------------
--------------------------------------------------------------------------------------------------------------------------------------------------------------------------------------------------------
--------------------------------------------------------------------------------------------------------------------------------------------------------------------------------------------------------
----------------------------------ooSoooo------------------------------------------------------------------------------------------------------------------------oSS--------oooooo---oSSSSooo-----------
---------------------------------------------------------------------------------------------------------SoS--------------------------------------------------------------------------------------------
---------------oooooSo----ooSo------------------------------------------------SoS--------------------------------------ooooSo---------------------------------------oo--------ooooo---ooooooo-----------
-----------------------------------y--g-g------oSoooo----oooS-----oooo---------------------------------ooooooo-------------------ooo--------------oooSo---ooooo--Y-------------g--g-------G-------------
---------------ooooooo----oooooo-XXXXXXXXX-----------------------------------ooooo-------y-G-------g----yrg----------oooooooo-----------XXX---------------------XXXXXXXXXXXXXXXXXXXXXXXXXXXXXXXXX-------
XXXXXXXXXX-------K-Yy--------y---XXXXXXXXX-----oooo----ooooo------ooooooo--g---R--------XXXXXXXXXXXXXXXXXXXXXXX-----------g-k-----oo----XXXXXXXX---oooo---oooo--XXXXXXXXXXXXXXXXXXXXXXXXXXXXXXXXX-----XX
XXXXXXXXXXXXXXXXXXXXXXXXXXXXXXXXXXXXXXXXXXXXX-kG-kGK----R---k--XX-----r---XXXXXXXXXXXXXXXXXXXXXXXXXXXXXXXXXXXXXXXXXXXXXXXXXXXXX-rr----k-XXXXXXXX--KR--------k-R-XXXXXXXXXXXXXXXXXXXXXXXXXXXXXXXXXXXXXXXX
XXXXXXXXXXXXXXXXXXXXXXXXXXXXXXXXXXXXXXXXXXXXXXXXXXXXXXXXXXXXXXXXXXXXXXXXXXXXXXXXXXXXXXXXXXXXXXXXXXXXXXXXXXXXXXXXXXXXXXXXXXXXXXXXXXXXXXXXXXXXXXXXXXXXXXXXXXXXXXXXXXXXXXXXXXXXXXXXXXXXXXXXXXXXXXXXXXXXXXXX

