--------------------------------------------------------------------------------------------------------------------------------------------------------------------------------------------------------
--------------------------------------------------------------------------------------------------------------------------------------------------------------------------------------------------------
--------------------------------------------------------------------------------------------------------------------------------------------------------------------------------------------------------
--------------------------------------------------------------------------------------------------------------------------------------------------------------------------------------------------------
--------------------------------------------------------------------------------------------------------------------------------------------------------------------------------------------------------
--------------------------------------------------------------------------------------------------------------------------------------------------------------------------------------------------------
--------------------------------------------------------------------------------------------------------------------------------------------------------------------------------------------------------
--------------------------------------------------------------------------------------------------------------------------------------------------------------------------------------------------------
--------------------------------------------------------------------------------------------------------------------------------------------------------------------------------------------------------
--------------------------------------------------------------------------------------------------------------------------------------------------------------------------------------------------------
--------------------------------------------------------------------------------------------------------------------------------------------------------------------------------------------------------
--------------------------------------------------------------------------------------------------------------------------------------------------------------------------------------------------------
----------------------oSoSo-----------------------oooSoooo-------------------ooS----------------------------------------------------------------------------------------------------------ooo-----------
-----------------------------------------------------------------------------------------------------oSo------------------------------------------------------------------------------------------------
-------------------------ooo------------------------ooooo--------------------oo-----------------------------SSo----ooS----------------------------------------------------------------------------------
------------------------Yk-Y-------------------------yr---r-------------------g---------------------ooooo------------------------------oSSSoooo--------k---r-------ooo--------SSSo-----------Y----------
-----------------oo--XXXXXXXXXX------------------XXXXXXXXXXX----------------XXXXXX-----ooooo-XXXX-G--r-----oo-----oo----------XX--------------------XXXXXXXXXXXXXX-----------------------XXXXXX---------
XXXXXXXXXXX-----kg---XXXXXXXXXXXXXX----ooooo-XXXXXXXXXXXXXXX----------------XXXXXX----g--kYk-XXXXXXXXXXXXX--yy--------------XXXX---------oooooo-----XXXXXXXXXXXXXX-ooooo-----ooooooo-----XXXXXXXXXXX----
XXXXXXXXXXX----XXXXXXXXXXXXXXXXXXXXXX----k-r-XXXXXXXXXXXXXXX------XXXXXXXXXXXXXXXXXXXXXXXXXXXXXXXXXXXXXXXXXXXXXXXXXXXXXX----XXXX------k------gk-XXXXXXXXXXXXXXXXXX-g-------r---g--kk-XX--XXXXXXXXXXXXXXX
XXXXXXXXXXXXXXXXXXXXXXXXXXXXXXXXXXXXXXXXXXXXXXXXXXXXXXXXXXXXXXXXXXXXXXXXXXXXXXXXXXXXXXXXXXXXXXXXXXXXXXXXXXXXXXXXXXXXXXXXXXXXXXXXXXXXXXXXXXXXXXXXXXXXXXXXXXXXXXXXXXXXXXXXXXXXXXXXXXXXXXXXXXXXXXXXXXXXXXXX

