--------------------------------------------------------------------------------------------------------------------------------------------------------------------------------------------------------
--------------------------------------------------------------------------------------------------------------------------------------------------------------------------------------------------------
--------------------------------------------------------------------------------------------------------------------------------------------------------------------------------------------------------
--------------------------------------------------------------------------------------------------------------------------------------------------------------------------------------------------------
--------------------------------------------------------------------------------------------------------------------------------------------------------------------------------------------------------
--------------------------------------------------------------------------------------------------------------------------------------------------------------------------------------------------------
--------------------------------------------------------------------------------------------------------------------------------------------------------------------------------------------------------
--------------------------------------------------------------------------------------------------------------------------------------------------------------------------------------------------------
--------------------------------------------------------------------------------------------------------------------------------------------------------------------------------------------------------
--------------------------------------------------------------------------------------------------------------------------------------------------------------------------------------------------------
--------------------------------------------------------------------------------------------------------------------------------------------------------------------------------------------------------
--------------------------------------------------------------------------------------------------------------------------------------------------------------------------------------------------------
-------------oooSoSo------------ooo----------------------------------oSSo------------------------------------ooo------------oooSSo----------------------------------------------------------------------
-----------------------oSoSo----------------------------------------------------------------------------------------------------------------------------------------------------------------------------
--------------ooo------------------------------ooo----SooooS-------------------ooSooo--ooo------------------ooo--------------ooo-----------------------------------------------oo-----------ooSSoo------
-------------ky----k-----oooo---GkrK-----ooo------Y-------------------------------------k--g----oSooo----------------------GR-----------Sooo-----oooo-------------------r-------k-----------------------
------------XXXXXXXXX-----g----XXXXXXXX----Yy-XXXXXX-ooooo----------XXXXXXXXXX--ooo---XXXXXXXX-----------XXXXXXXX------Y--XXXXXXXXXX-------------------------yr----XXXXXXXXXXXXXXXXXXXXXX--oooooo-------
XXXXXXXXXXXXXXXXXXXXXXXXXXXXXXXXXXXXXXXXXXXXXXXXXXXX-y-----Y--------XXXXXXXXXX-K--Y---XXXXXXXX-oooooo----XXXXXXXXXXXXXXXXXXXXXXXXXXX---ooooo---XXXXXXXX---XXXXXXXXXXXXXXXXXXXXXXXXXXXXXXX-r-r----rg-XXXX
XXXXXXXXXXXXXXXXXXXXXXXXXXXXXXXXXXXXXXXXXXXXXXXXXXXXXXXXXXXXXXXXXX--XXXXXXXXXXXXXXXXXXXXXXXXXX-Yg--r-----XXXXXXXXXXXXXXXXXXXXXXXXXXX---R-------XXXXXXXX---XXXXXXXXXXXXXXXXXXXXXXXXXXXXXXXXXXXXXXXXXXXXXX
XXXXXXXXXXXXXXXXXXXXXXXXXXXXXXXXXXXXXXXXXXXXXXXXXXXXXXXXXXXXXXXXXXXXXXXXXXXXXXXXXXXXXXXXXXXXXXXXXXXXXXXXXXXXXXXXXXXXXXXXXXXXXXXXXXXXXXXXXXXXXXXXXXXXXXXXXXXXXXXXXXXXXXXXXXXXXXXXXXXXXXXXXXXXXXXXXXXXXXXX

