--------------------------------------------------------------------------------------------------------------------------------------------------------------------------------------------------------
--------------------------------------------------------------------------------------------------------------------------------------------------------------------------------------------------------
--------------------------------------------------------------------------------------------------------------------------------------------------------------------------------------------------------
--------------------------------------------------------------------------------------------------------------------------------------------------------------------------------------------------------
--------------------------------------------------------------------------------------------------------------------------------------------------------------------------------------------------------
--------------------------------------------------------------------------------------------------------------------------------------------------------------------------------------------------------
--------------------------------------------------------------------------------------------------------------------------------------------------------------------------------------------------------
--------------------------------------------------------------------------------------------------------------------------------------------------------------------------------------------------------
--------------------------------------------------------------------------------------------------------------------------------------------------------------------------------------------------------
--------------------------------------------------------------------------------------------------------------------------------------------------------------------------------------------------------
--------------------------------------------------------------------------------------------------------------------------------------------------------------------------------------------------------
--------------------------------------------------------------------------------------------------------------------------------------------------------------------------------------------------------
--------------------------oSo------------------------------------------------------------------------------------------------------------ooSSo----------------------------------------------------------
-------------------------------------------oSoSSoS--------------------------oooo-------------------------------ooSoo------------------------------------------ooo---------------------------------------
-----------oooo-----------oooo-----oSo------------------------oo------------------------ooo--oSoo------Sooo----------------------------oooooooo----------------------oSooooo----------------------------
-------------------------y---Rg------------oooooooo-----------r-----------oooooo------------------------------oooooo-------------------rr--------------------ooo----------------------------------------
----------------------XXXXXXXXXX-oooooo-------gyR--------XXXXXXXXX--------k-y-Y------ooooo------------ooo----g----G-------------------XXXXXXXXXXXXX--------Kr-Gr--XX--------------------------------XXXX
--------------g-------XXXXXXXXXX--G----yr-XXXXXXXXXXXXXXXXXXXXXXXX--ooo--XXXXXXXX-------g----k--r-----------XXXXXXXXXXXXXXX-----------XXXXXXXXXXXXX-------XXXXXXXXXX---yyg-----XXXX-------XX-RR-----XXXX
XXXXXXXXXXXXXXXX--k-K-XXXXXXXXXXXXXXXXXXXXXXXXXXXXXXXXXXXXXXXXXXXX-r--Y--XXXXXXXXXXXXXXXXXXXXXXXXX---XXXXXXXXXXXXXXXXXXXXXX-------Rk--XXXXXXXXXXXXXXXXX---XXXXXXXXXXXXXXXXXXXXXXXXXXXX----XXXXXXXXXXXXXX
XXXXXXXXXXXXXXXXXXXXXXXXXXXXXXXXXXXXXXXXXXXXXXXXXXXXXXXXXXXXXXXXXXXXXXXXXXXXXXXXXXXXXXXXXXXXXXXXXXXXXXXXXXXXXXXXXXXXXXXXXXXXXXXXXXXXXXXXXXXXXXXXXXXXXXXXXXXXXXXXXXXXXXXXXXXXXXXXXXXXXXXXXXXXXXXXXXXXXXXX

