--------------------------------------------------------------------------------------------------------------------------------------------------------------------------------------------------------
--------------------------------------------------------------------------------------------------------------------------------------------------------------------------------------------------------
--------------------------------------------------------------------------------------------------------------------------------------------------------------------------------------------------------
--------------------------------------------------------------------------------------------------------------------------------------------------------------------------------------------------------
--------------------------------------------------------------------------------------------------------------------------------------------------------------------------------------------------------
--------------------------------------------------------------------------------------------------------------------------------------------------------------------------------------------------------
--------------------------------------------------------------------------------------------------------------------------------------------------------------------------------------------------------
--------------------------------------------------------------------------------------------------------------------------------------------------------------------------------------------------------
--------------------------------------------------------------------------------------------------------------------------------------------------------------------------------------------------------
--------------------------------------------------------------------------------------------------------------------------------------------------------------------------------------------------------
--------------------------------------------------------------------------------------------------------------------------------------------------------------------------------------------------------
--------------------------------------------------------------------------------------------------------------------------------------------------------------------------------------------------------
----------------------------------------oSSoSoSo-----------------------------------------------------------Sooooo-------------------SoSo----------------------------------------------------------------
--------------------------------oooSo-----------------SSooSSoo-----------------------------------------------------------------------------------------------------------SSSSoS-----------oooooo--------
-------------oSooSSSo----------------------ooo------------------------------oooo--------------------------ooooooo-------------------oooo----------------------------------------------------------------
-----------------------------oooooo-----kK-k--Y------oooooooo---------------------------------------------Rg---kGr-----------------GGk----------------------ooooo---------ooooooo----------ooo----------
XXXXXXXXXXXX----oooo---------k-k---Y---XXXXXXXXXXX-----R-------XXXXXX--------ooo------------------------XXXXXXXXXXX-----XXX---oo--XXXXXXX-------------oo----R-------------Yrg-Gy-----------KK--rY-------
XXXXXXXXXXXX--gRR-r----oo---XXXXXXXXXXXXXXXXXXXXXXXXXXXXXXXXXXXXXXXXX-------yKy----XXXXX-----y----------XXXXXXXXXXX-----XXX-y---y-XXXXXXX-------------k--XXXXXXXXXXXXXXXXXXXXXXXXXXXXX--XXXXXXXXXX-oooo-
XXXXXXXXXXXXXXXXXXXXXX--R---XXXXXXXXXXXXXXXXXXXXXXXXXXXXXXXXXXXXXXXXXXXXXXXXXXXXXXXXXXXXXXXXXXXX----XXXXXXXXXXXXXXX---XXXXXXXXXXXXXXXXXXX----XXXXXXXXXXXXXXXXXXXXXXXXXXXXXXXXXXXXXXXXXXXXXXXXXXXXX--kYy-
XXXXXXXXXXXXXXXXXXXXXXXXXXXXXXXXXXXXXXXXXXXXXXXXXXXXXXXXXXXXXXXXXXXXXXXXXXXXXXXXXXXXXXXXXXXXXXXXXXXXXXXXXXXXXXXXXXXXXXXXXXXXXXXXXXXXXXXXXXXXXXXXXXXXXXXXXXXXXXXXXXXXXXXXXXXXXXXXXXXXXXXXXXXXXXXXXXXXXXXX

