--------------------------------------------------------------------------------------------------------------------------------------------------------------------------------------------------------
--------------------------------------------------------------------------------------------------------------------------------------------------------------------------------------------------------
--------------------------------------------------------------------------------------------------------------------------------------------------------------------------------------------------------
--------------------------------------------------------------------------------------------------------------------------------------------------------------------------------------------------------
--------------------------------------------------------------------------------------------------------------------------------------------------------------------------------------------------------
--------------------------------------------------------------------------------------------------------------------------------------------------------------------------------------------------------
--------------------------------------------------------------------------------------------------------------------------------------------------------------------------------------------------------
--------------------------------------------------------------------------------------------------------------------------------------------------------------------------------------------------------
--------------------------------------------------------------------------------------------------------------------------------------------------------------------------------------------------------
--------------------------------------------------------------------------------------------------------------------------------------------------------------------------------------------------------
--------------------------------------------------------------------------------------------------------------------------------------------------------------------------------------------------------
--------------------------------------------------------------------------------------------------------------------------------------------------------------------------------------------------------
---------------------------------------------------------------------------oSooo------------------------------------------------------------------------------------------------------------------------
------------------------------oSo-------------------------------------------------------------------ooSo----------------ooooSSS-----------------------------------------------------------oSoooo--------
---------------------------------------------------------------------------oooo-----oooo---Soooo--------------------------------------------------------------------------------------------------------
-------------------------------oo------------------------------ry----------yR-Yr-----------------------------------------ooooo----oooo---------------------oSoooo------oSSo-----------------------------
XXXXXXXXXXXXX----ooo----XXXX----gr---------------------oo---XXXXXXX-----XXXXXXXXXXXXXXXXX--ooooo-----k-gry------XXX-----y--Y---g------------------XXXXXX--------------------XXXXX--oooo---K-------------
XXXXXXXXXXXXX-------G---XXXXXXXXXXXX------ooooo---------Yky-XXXXXXXXXXXXXXXXXXXXXXXXXXXXX------k---XXXXXXXX-----XXX----XXXXXXXXXXXXXXXXXXX------XXXXXXXX---ooooooo-----oooo-XXXXX---Gkr--XXXXXXXX--K----
XXXXXXXXXXXXX---XXXXXXXXXXXXXXXXXXXX----kRRr--r--XXXXXXXXXXXXXXXXXXXXXXXXXXXXXXXXXXXXXXXXXXXXXXXX--XXXXXXXX-----XXX----XXXXXXXXXXXXXXXXXXXXXXXXXXXXXXXXX---KG-gk-----K---k--XXXXXXXXXXXXXXXXXXXXXXXXXXX-
XXXXXXXXXXXXXXXXXXXXXXXXXXXXXXXXXXXXXXXXXXXXXXXXXXXXXXXXXXXXXXXXXXXXXXXXXXXXXXXXXXXXXXXXXXXXXXXXXXXXXXXXXXXXXXXXXXXXXXXXXXXXXXXXXXXXXXXXXXXXXXXXXXXXXXXXXXXXXXXXXXXXXXXXXXXXXXXXXXXXXXXXXXXXXXXXXXXXXXXX

