--------------------------------------------------------------------------------------------------------------------------------------------------------------------------------------------------------
--------------------------------------------------------------------------------------------------------------------------------------------------------------------------------------------------------
--------------------------------------------------------------------------------------------------------------------------------------------------------------------------------------------------------
--------------------------------------------------------------------------------------------------------------------------------------------------------------------------------------------------------
--------------------------------------------------------------------------------------------------------------------------------------------------------------------------------------------------------
--------------------------------------------------------------------------------------------------------------------------------------------------------------------------------------------------------
--------------------------------------------------------------------------------------------------------------------------------------------------------------------------------------------------------
--------------------------------------------------------------------------------------------------------------------------------------------------------------------------------------------------------
--------------------------------------------------------------------------------------------------------------------------------------------------------------------------------------------------------
--------------------------------------------------------------------------------------------------------------------------------------------------------------------------------------------------------
--------------------------------------------------------------------------------------------------------------------------------------------------------------------------------------------------------
--------------------------------------------------------------------------------------------------------------------------------------------------------------------------------------------------------
--------------------------------------------------------------------------------------------------------------------------------------------------------------------------------------ooo----ooooooooo--
-------------------------------------ooooo----------------------------------------------------------------------------------------------ooo-----------SSooooo-------------------------------------------
--------------------------------------------------------------------------ooooo----------SoSoSo----oo-------------------------------------------------------------------------------oooo--------oooo----
--------------ooS----r------------oooooooo-----------------------------------Rk------------------yr-gyk----oSo-------------ooooo------ooo------K--------oo-----------------SSSS------y--------Gy--y--g--
-------------------XXXXXXXXXXXX---g--r-------------------------------XXXXXXXXXXX-------ooooo----XXXXXXXX----------------------g------g------XXXXXXXX-k-G--r-g-XX-------------------XXXXXXXXXXXXXXXXXXXX-
-----------XX------XXXXXXXXXXXX--XXXXXXXXXXXXXXXX-----XXXX-------XXXXXXXXXXXXXXX------k--y---ky-XXXXXXXX------------------XXXXXXXXXXXXXXXXXXXXXXXXXXXXXXXXXXXXXX-------------ooo---XXXXXXXXXXXXXXXXXXXXX
XXXXXXXXXXXXX---gG-XXXXXXXXXXXXXXXXXXXXXXXXXXXXXX-----XXXX-------XXXXXXXXXXXXXXX-----XXXXXXXXXXXXXXXXXXX-k--------------k-XXXXXXXXXXXXXXXXXXXXXXXXXXXXXXXXXXXXXX----XXXXX---G------XXXXXXXXXXXXXXXXXXXXX
XXXXXXXXXXXXXXXXXXXXXXXXXXXXXXXXXXXXXXXXXXXXXXXXXXXXXXXXXXXXXXXXXXXXXXXXXXXXXXXXXXXXXXXXXXXXXXXXXXXXXXXXXXXXXXXXXXXXXXXXXXXXXXXXXXXXXXXXXXXXXXXXXXXXXXXXXXXXXXXXXXXXXXXXXXXXXXXXXXXXXXXXXXXXXXXXXXXXXXXX

