--------------------------------------------------------------------------------------------------------------------------------------------------------------------------------------------------------
--------------------------------------------------------------------------------------------------------------------------------------------------------------------------------------------------------
--------------------------------------------------------------------------------------------------------------------------------------------------------------------------------------------------------
--------------------------------------------------------------------------------------------------------------------------------------------------------------------------------------------------------
--------------------------------------------------------------------------------------------------------------------------------------------------------------------------------------------------------
--------------------------------------------------------------------------------------------------------------------------------------------------------------------------------------------------------
--------------------------------------------------------------------------------------------------------------------------------------------------------------------------------------------------------
--------------------------------------------------------------------------------------------------------------------------------------------------------------------------------------------------------
--------------------------------------------------------------------------------------------------------------------------------------------------------------------------------------------------------
--------------------------------------------------------------------------------------------------------------------------------------------------------------------------------------------------------
--------------------------------------------------------------------------------------------------------------------------------------------------------------------------------------------------------
--------------------------------------------------------------------------------------------------------------------------------------------------------------------------------------------------------
-------------------------------------------------------------------------------------------------------------------ooSoooo---------------oSoS-----------------------------------------------------------
--------------------------------------------------------------SSSoo----------------------------------------------------------------------------------------------------------------------------SSooo----
---------------------------------------------------------------------------------ooooo-----------------------------ooooooo----------------ooooo----------------------------------------oSSS-------------
---------------Soo-----------------------------ooSo-------------ooooo----oo-------------ooo------------SSSoo-------g-----k----ooooSo-----g------------ooo-------ooooSS--------------------------oooo----
----------------------------------------XXXXX----------ooo----------------rK----ooo-----r------XXXX-----------XXXXXXXXXXXXX------------XXXXXXXXXX---------------------------oooo--------oo----y-k-------
XXXXXXXXXXXXX-oooooo-----XXXXX----------XXXXX-ooooo---ry-yR-XXXXXXXXXXXXXXXXX--Yg-r----XXXXXXXXXXXX----oooooo-XXXXXXXXXXXXXXX--oooooo--XXXXXXXXXX---------------ooooooo-XX-RK-r-Yg------G----XXXXXXXX---
XXXXXXXXXXXXX---y--k-----XXXXX----Kk-y--XXXXX--y---K-XXXXXXXXXXXXXXXXXXXXXXXXXXXXXXXXXXXXXXXXXXXXXX---k-K--Ky-XXXXXXXXXXXXXXX-r-k-y----XXXXXXXXXXXXX--Y-r--------g--g---XXXXXXXXXXXXXXXXXXXXXXXXXXXXX---
XXXXXXXXXXXXXXXXXXXXXXXXXXXXXXXXXXXXXXXXXXXXXXXXXXXXXXXXXXXXXXXXXXXXXXXXXXXXXXXXXXXXXXXXXXXXXXXXXXXXXXXXXXXXXXXXXXXXXXXXXXXXXXXXXXXXXXXXXXXXXXXXXXXXXXXXXXXXXXXXXXXXXXXXXXXXXXXXXXXXXXXXXXXXXXXXXXXXXXXX

