--------------------------------------------------------------------------------------------------------------------------------------------------------------------------------------------------------
--------------------------------------------------------------------------------------------------------------------------------------------------------------------------------------------------------
--------------------------------------------------------------------------------------------------------------------------------------------------------------------------------------------------------
--------------------------------------------------------------------------------------------------------------------------------------------------------------------------------------------------------
--------------------------------------------------------------------------------------------------------------------------------------------------------------------------------------------------------
--------------------------------------------------------------------------------------------------------------------------------------------------------------------------------------------------------
--------------------------------------------------------------------------------------------------------------------------------------------------------------------------------------------------------
--------------------------------------------------------------------------------------------------------------------------------------------------------------------------------------------------------
--------------------------------------------------------------------------------------------------------------------------------------------------------------------------------------------------------
--------------------------------------------------------------------------------------------------------------------------------------------------------------------------------------------------------
--------------------------------------------------------------------------------------------------------------------------------------------------------------------------------------------------------
--------------------------------------------------------------------------------------------------------------------------------------------------------------------------------------------------------
----------------------------------------------------------Soo----------------------------------------------------------------------------------------------------------------------------------ooooS----
--------------------SooSooo-----------------------------------------------------------------------------------------------------------------------------------------------------------------------------
--------------------------------------ooo-------------------oo----------------------------------------------SooS-------SSoSoo---------------oSoo----------------oooo--------------------------oooooo----
-------------------oooooooo-------------r----------------k-R----------oSSoo----------------------ooSooSSo-----------------------Sooo-------------------SSooSS---y--y-g----oooooo--ooo------------G--g---
-----------------------r------------XXXXXXXX-------oo---XXXXXXX---------------------------XXXXX---------------oo-----ooooo---------------ooooo---XXXX----------XXXXXXXX----k-r---------Y-----XXXXXXXXX--
-----------------XXXXXXXXXXXXXX-----XXXXXXXX---------GY-XXXXXXX--------ooooo--XXX---------XXXXX----ooo--------Y--k---------------ooooo----G-ggr--XXXX--oooo----XXXXXXXXXXXXXXXXXXXXXXXXXX----XXXXXXXXX--
XXXXXXXXXXXXXXXXXXXXXXXXXXXXXXX-----XXXXXXXX-----XXXXXXXXXXXXXX--XX---g-K-----XXXXX----Y--XXXXX---G---r---XXXXXXXXXXXXXXXXXXXX---k----y-XXXXXXXXXXXXX---Grk--k-XXXXXXXXXXXXXXXXXXXXXXXXXXXXXXXXXXXXXXXXX
XXXXXXXXXXXXXXXXXXXXXXXXXXXXXXXXXXXXXXXXXXXXXXXXXXXXXXXXXXXXXXXXXXXXXXXXXXXXXXXXXXXXXXXXXXXXXXXXXXXXXXXXXXXXXXXXXXXXXXXXXXXXXXXXXXXXXXXXXXXXXXXXXXXXXXXXXXXXXXXXXXXXXXXXXXXXXXXXXXXXXXXXXXXXXXXXXXXXXXXX

