--------------------------------------------------------------------------------------------------------------------------------------------------------------------------------------------------------
--------------------------------------------------------------------------------------------------------------------------------------------------------------------------------------------------------
--------------------------------------------------------------------------------------------------------------------------------------------------------------------------------------------------------
--------------------------------------------------------------------------------------------------------------------------------------------------------------------------------------------------------
--------------------------------------------------------------------------------------------------------------------------------------------------------------------------------------------------------
--------------------------------------------------------------------------------------------------------------------------------------------------------------------------------------------------------
--------------------------------------------------------------------------------------------------------------------------------------------------------------------------------------------------------
--------------------------------------------------------------------------------------------------------------------------------------------------------------------------------------------------------
--------------------------------------------------------------------------------------------------------------------------------------------------------------------------------------------------------
--------------------------------------------------------------------------------------------------------------------------------------------------------------------------------------------------------
--------------------------------------------------------------------------------------------------------------------------------------------------------------------------------------------------------
--------------------------------------------------------------------------------------------------------------------------------------------------------------------------------------------------------
---------------ooooooo--------------------------------------------------------------------------------------------------------------------------------------------------------------Soooo---------------
-------------------------------------------------------oSoo---------------ooSoS---------------ooSoooSo---------------ooSo---------------------ooSSoo----------------------------------------------------
----------------ooooo------Sooo-----SoS----oo----------------------------------------oooo---------------------------------------------------------------------oooSo----oooS-----------ooo---oooSS-------
--------------y----g-----------------------ggk------ooooooo-----SSo--------ooooooo---------------ooo----------ooS-----------oSoSoS------------oooo-------------------------------------rr---------------
XXXXXXXXXXXXXXXXXXXXXXX-ooooooo------oo---XXXXXX-----g---r-------------------y--y----oooo--------k------------------------------------------R---k-g--------ooooooo-------oo-------XXXXXXXXX-ooooooo-----
XXXXXXXXXXXXXXXXXXXXXXX-K-----ky----y-----XXXXXXXXXXXXXXXXXX-------------XXXXXXXXXX--y-y---y-XXXXXXXXXX------------XXXXXXXX----ooooo-XXXX--XXXXXXXXXXXXXXX-------gk----K----r-XXXXXXXXXXXXX-----y-------
XXXXXXXXXXXXXXXXXXXXXXXXXXXXXXXXXXXXXXXXXXXXXXXXXXXXXXXXXXXX---kr-y-XXXXXXXXXXXXXXXXXXXXXXXXXXXXXXXXXXX------rRg-g-XXXXXXXX----r-----XXXX--XXXXXXXXXXXXXXXXXXXXXXXXXXXXXXXXXXXXXXXXXXXXXXXXXXXXXXXXX----
XXXXXXXXXXXXXXXXXXXXXXXXXXXXXXXXXXXXXXXXXXXXXXXXXXXXXXXXXXXXXXXXXXXXXXXXXXXXXXXXXXXXXXXXXXXXXXXXXXXXXXXXXXXXXXXXXXXXXXXXXXXXXXXXXXXXXXXXXXXXXXXXXXXXXXXXXXXXXXXXXXXXXXXXXXXXXXXXXXXXXXXXXXXXXXXXXXXXXXXX

