--------------------------------------------------------------------------------------------------------------------------------------------------------------------------------------------------------
--------------------------------------------------------------------------------------------------------------------------------------------------------------------------------------------------------
--------------------------------------------------------------------------------------------------------------------------------------------------------------------------------------------------------
--------------------------------------------------------------------------------------------------------------------------------------------------------------------------------------------------------
--------------------------------------------------------------------------------------------------------------------------------------------------------------------------------------------------------
--------------------------------------------------------------------------------------------------------------------------------------------------------------------------------------------------------
--------------------------------------------------------------------------------------------------------------------------------------------------------------------------------------------------------
--------------------------------------------------------------------------------------------------------------------------------------------------------------------------------------------------------
--------------------------------------------------------------------------------------------------------------------------------------------------------------------------------------------------------
--------------------------------------------------------------------------------------------------------------------------------------------------------------------------------------------------------
--------------------------------------------------------------------------------------------------------------------------------------------------------------------------------------------------------
--------------------------------------------------------------------------------------------------------------------------------------------------------------------------------------------------------
----------------------------------------------------------------------ooo-------------------------------------------------------------SoSoo-----------------------ooS-----------------------------------
--------------oSoS------------------------ooooo-----------------------------------------------------SooSo-------------oSo---oSooSo----------------------------------------------------------------------
----------------------------------------------------------------------oooooo---------------------------------------------------------oooooo--oSoSSS-----------------oooo--------------------------------
------------oooooo---oSSooS---------------oooo------------oooSoooo----kk-Y-R------Krg---SSo---------ooo---------------------oooo---------yr-------------ooSo-----r---yG---------------------------------
XXXXXXXXXXX-Y------------------------------G-----------------------XXXXXXXXXXXXXXXXXXX--------------Gy-----------------y----Yy------XXXXXXXX---oo---------------XXXXXXXXX------XXXXX--------------------
XXXXXXXXXXXXXXXXXXXX--ooooo--------------XXXXXXXX----------ooooooo-XXXXXXXXXXXXXXXXXXX----ooo-XXXXXXXXXXXX-----oo---XXXXXXXXXXXXXXXXXXXXXXXX-k-Ygy-R----oooooo--XXXXXXXXX---XXXXXXXX----Rgg--XXXX-------
XXXXXXXXXXXXXXXXXXXX-g-g-ygry--XX-y------XXXXXXXXXX---g------y-R---XXXXXXXXXXXXXXXXXXX--g--G--XXXXXXXXXXXX-----K----XXXXXXXXXXXXXXXXXXXXXXXXXXXXXXXXX--kg-------XXXXXXXXXXXXXXXXXXXXXXXXXXXXXXXXX---k---
XXXXXXXXXXXXXXXXXXXXXXXXXXXXXXXXXXXXXXXXXXXXXXXXXXXXXXXXXXXXXXXXXXXXXXXXXXXXXXXXXXXXXXXXXXXXXXXXXXXXXXXXXXXXXXXXXXXXXXXXXXXXXXXXXXXXXXXXXXXXXXXXXXXXXXXXXXXXXXXXXXXXXXXXXXXXXXXXXXXXXXXXXXXXXXXXXXXXXXXX

