--------------------------------------------------------------------------------------------------------------------------------------------------------------------------------------------------------
--------------------------------------------------------------------------------------------------------------------------------------------------------------------------------------------------------
--------------------------------------------------------------------------------------------------------------------------------------------------------------------------------------------------------
--------------------------------------------------------------------------------------------------------------------------------------------------------------------------------------------------------
--------------------------------------------------------------------------------------------------------------------------------------------------------------------------------------------------------
--------------------------------------------------------------------------------------------------------------------------------------------------------------------------------------------------------
--------------------------------------------------------------------------------------------------------------------------------------------------------------------------------------------------------
--------------------------------------------------------------------------------------------------------------------------------------------------------------------------------------------------------
--------------------------------------------------------------------------------------------------------------------------------------------------------------------------------------------------------
--------------------------------------------------------------------------------------------------------------------------------------------------------------------------------------------------------
--------------------------------------------------------------------------------------------------------------------------------------------------------------------------------------------------------
--------------------------------------------------------------------------------------------------------------------------------------------------------------------------------------------------------
-----------------------------------oSo--------------------------------oooooo--------------------------------oSooooo------ooo----------------------------------------------------------------------------
-----------------------------------------------------Soooo--------------------------------------------ooo---------------------------------------------------------oooo--------------------oSSSS---------
---------------------------------ooooo------------------------------ooooooo----------------ooooo-------------ooooo--------------------------------------------------------------------------------------
---------------------------------k--y---------------ooo---------------ry-R------oo--------------------------R-----r---y-r---------------------r-kk---oSSoooSo-------------------------------------------
XXXXXXXXXXXX-------------------XXXXXXXXX-------------kg------------XXXXXXXXXX-r------------ooooooo---r-g--XXXXXXXXXXXXXXXXXXX-------XXX-----XXXXXXXX-------------------------------------y---Gr---------
XXXXXXXXXXXXXXXXX--rY----------XXXXXXXXX-----XXXXXXXXXXXXXX--------XXXXXXXXXXXXXXXXXXXXXXX-g---r----XXXXXXXXXXXXXXXXXXXXXXXXX-------XXX-----XXXXXXXX--ooooooo----XXXXXXXXXX--------XXXXXXXXXXXXXX---ooo-
XXXXXXXXXXXXXXXXXXXXXXXXXXX----XXXXXXXXX-----XXXXXXXXXXXXXXXXX-----XXXXXXXXXXXXXXXXXXXXXXXXXXXXXXXXXXXXXXXXXXXXXXXXXXXXXXXXXX--rk---XXXXXXXXXXXXXXXX---kg---Y----XXXXXXXXXX--XX----XXXXXXXXXXXXXX-Y-----
XXXXXXXXXXXXXXXXXXXXXXXXXXXXXXXXXXXXXXXXXXXXXXXXXXXXXXXXXXXXXXXXXXXXXXXXXXXXXXXXXXXXXXXXXXXXXXXXXXXXXXXXXXXXXXXXXXXXXXXXXXXXXXXXXXXXXXXXXXXXXXXXXXXXXXXXXXXXXXXXXXXXXXXXXXXXXXXXXXXXXXXXXXXXXXXXXXXXXXXX

