--------------------------------------------------------------------------------------------------------------------------------------------------------------------------------------------------------
--------------------------------------------------------------------------------------------------------------------------------------------------------------------------------------------------------
--------------------------------------------------------------------------------------------------------------------------------------------------------------------------------------------------------
--------------------------------------------------------------------------------------------------------------------------------------------------------------------------------------------------------
--------------------------------------------------------------------------------------------------------------------------------------------------------------------------------------------------------
--------------------------------------------------------------------------------------------------------------------------------------------------------------------------------------------------------
--------------------------------------------------------------------------------------------------------------------------------------------------------------------------------------------------------
--------------------------------------------------------------------------------------------------------------------------------------------------------------------------------------------------------
--------------------------------------------------------------------------------------------------------------------------------------------------------------------------------------------------------
--------------------------------------------------------------------------------------------------------------------------------------------------------------------------------------------------------
--------------------------------------------------------------------------------------------------------------------------------------------------------------------------------------------------------
--------------------------------------------------------------------------------------------------------------------------------------------------------------------------------------------------------
----------------------oooooo--------------------------------------------------------------ooo---------------------------------------------------ooooo---------------------------------------------------
--------------------------------------------------------------------------------------------------------------------------------------------------------------------------------------------------------
----------------------ooooooooo------------Soo---------------------------------------------oooo---------oSoo-----SoSo-----------ooo---------------oooo----oSoSoSo----oSSo-------------------------SSo---
-------------------------r---k---ooo------------oooSoo-----ooS-----------------------------Y-rkg------------------------------k---r--------------rYr-------------------------------ooooSo---------------
--------------XXXXXXXXXXXXXXXXXX-kg------oooo-------------------------------------------XXXXXXXXX--------------ooooooooo-----XXXXXXXX--ooo-----XXXXXXXXXX---ooooo-XX-ooo--------------------------------
--------------XXXXXXXXXXXXXXXXXXXXXXXXX-----kk--oooooo-----oooo--XXXXX--oo----------oo--XXXXXXXXX---------y----k--kKr--r-----XXXXXXXX-r--r--XXXXXXXXXXXXX--g--Rg--XX-------XXXXX----ooo----XXXXX------XX
--------------XXXXXXXXXXXXXXXXXXXXXXXXXXXXXXXXX---y-k------kG--y-XXXXX-------XXXXX--Y-g-XXXXXXXXX---XXXXXXXXXXXXXXXXXXXXX----XXXXXXXXXXXXXXXXXXXXXXXXXXXXXXXXXXXXXXXXXXXXXXXXXXX-r-Y----y--XXXXXXXXXXXXX
XXXXXXXXXXXXXXXXXXXXXXXXXXXXXXXXXXXXXXXXXXXXXXXXXXXXXXXXXXXXXXXXXXXXXXXXXXXXXXXXXXXXXXXXXXXXXXXXXXXXXXXXXXXXXXXXXXXXXXXXXXXXXXXXXXXXXXXXXXXXXXXXXXXXXXXXXXXXXXXXXXXXXXXXXXXXXXXXXXXXXXXXXXXXXXXXXXXXXXXX

