--------------------------------------------------------------------------------------------------------------------------------------------------------------------------------------------------------
--------------------------------------------------------------------------------------------------------------------------------------------------------------------------------------------------------
--------------------------------------------------------------------------------------------------------------------------------------------------------------------------------------------------------
--------------------------------------------------------------------------------------------------------------------------------------------------------------------------------------------------------
--------------------------------------------------------------------------------------------------------------------------------------------------------------------------------------------------------
--------------------------------------------------------------------------------------------------------------------------------------------------------------------------------------------------------
--------------------------------------------------------------------------------------------------------------------------------------------------------------------------------------------------------
--------------------------------------------------------------------------------------------------------------------------------------------------------------------------------------------------------
--------------------------------------------------------------------------------------------------------------------------------------------------------------------------------------------------------
--------------------------------------------------------------------------------------------------------------------------------------------------------------------------------------------------------
--------------------------------------------------------------------------------------------------------------------------------------------------------------------------------------------------------
--------------------------------------------------------------------------------------------------------------------------------------------------------------------------------------------------------
-----------------------------------------------------------------------------------------------------------------------------------------------oSoo------------ooooSo-----------------------------------
------------------------------SSoo----------ooo--------------------------------------------------------------------------------------ooSoSoo------------ooS------------------------ooS------------------
-------------------------------------------------------------oo-----------------------ooooo---ooo-----------------------------------------------ooooo-----------oooo------ooS---------------------------
-----------------ooS---------ooooo----------oo----------------R----------r------------r--y-k------kG-----------------------------------oooo---r-kgk-k-----------------------------ooooo-----------------
----------------------------kg-----g-XXX--gr--r----------XXXXXXX---XXXXXXXXXXX------XXXXXXXXXXXXXXXXX--------------------------XXXX---r--Y-g-XXXXXXXXXX----r-XXXXXXXXX------ooo-------------------------
-----------------ooo------XXXXXXXXXXXXXXXXXXXXXX---------XXXXXXX---XXXXXXXXXXXXX----XXXXXXXXXXXXXXXXX-----------XXXXXXXXXXXXXXXXXXXXXXXXXXXXXXXXXXXXXXXXXXXXXXXXXXXXXX-----G-k---XXXXXXX-----XX----XXXXX
------------XXXX-g----XXXXXXXXXXXXXXXXXXXXXXXXXX---------XXXXXXX---XXXXXXXXXXXXX----XXXXXXXXXXXXXXXXX--yky--XXXXXXXXXXXXXXXXXXXXXXXXXXXXXXXXXXXXXXXXXXXXXXXXXXXXXXXXXX--XXXXXXXXXXXXXXXXXXXXXXXXXXXXXXXX
XXXXXXXXXXXXXXXXXXXXXXXXXXXXXXXXXXXXXXXXXXXXXXXXXXXXXXXXXXXXXXXXXXXXXXXXXXXXXXXXXXXXXXXXXXXXXXXXXXXXXXXXXXXXXXXXXXXXXXXXXXXXXXXXXXXXXXXXXXXXXXXXXXXXXXXXXXXXXXXXXXXXXXXXXXXXXXXXXXXXXXXXXXXXXXXXXXXXXXXX

