--------------------------------------------------------------------------------------------------------------------------------------------------------------------------------------------------------
--------------------------------------------------------------------------------------------------------------------------------------------------------------------------------------------------------
--------------------------------------------------------------------------------------------------------------------------------------------------------------------------------------------------------
--------------------------------------------------------------------------------------------------------------------------------------------------------------------------------------------------------
--------------------------------------------------------------------------------------------------------------------------------------------------------------------------------------------------------
--------------------------------------------------------------------------------------------------------------------------------------------------------------------------------------------------------
--------------------------------------------------------------------------------------------------------------------------------------------------------------------------------------------------------
--------------------------------------------------------------------------------------------------------------------------------------------------------------------------------------------------------
--------------------------------------------------------------------------------------------------------------------------------------------------------------------------------------------------------
--------------------------------------------------------------------------------------------------------------------------------------------------------------------------------------------------------
--------------------------------------------------------------------------------------------------------------------------------------------------------------------------------------------------------
--------------------------------------------------------------------------------------------------------------------------------------------------------------------------------------------------------
------------------------------------------------------oooSo--------------ooS----------------------------------------------------------------------------------------------------------------------------
-----------------------------------------------Soo------------------------------------------------------------------------------------------------------------------------------------------------------
--------------ooo-----------------oooo----------------oo-------oSo-----ooooooo-----------------------------------------------------------------------------------------------oooooSSS-------------------
-----------------------------------rkk--------ooo------r----------------r--R--------------ooooooo---oSooSSo-------------------------------------SoSoo---ooo--------------------------------ooSoSoo------
XXXXXXXXXXXX--oooo-----oo--------XXXXXXX-----------XXXXXXXXX--ooooooo-XXXXXXXXXX----ooo-----------------------------XXXX--ooo---XXXXXXXXXXXX------------------XXXXXX------------oooo---XX----------XXXXX
XXXXXXXXXXXX-K----k-------XXXXXXXXXXXXXX----XXXXXXXXXXXXXXXX--Gr-r----XXXXXXXXXX---rg--------oo-------ooooooo--g----XXXX--k-----XXXXXXXXXXXX--oooooo----oooo--XXXXXX---------y------g--XX-ooooo----XXXXX
XXXXXXXXXXXXXXXXXXXXXXXXXXXXXXXXXXXXXXXX----XXXXXXXXXXXXXXXXXXXXXXXXXXXXXXXXXXXXXXXXXXXXX-----g-kr---------K--XXXXXXXXXXXXXXXXXXXXXXXXXXXXXX------K-----------XXXXXXXXXXXXXXXXXXXXXXXXXXX-y---GK---XXXXX
XXXXXXXXXXXXXXXXXXXXXXXXXXXXXXXXXXXXXXXXXXXXXXXXXXXXXXXXXXXXXXXXXXXXXXXXXXXXXXXXXXXXXXXXXXXXXXXXXXXXXXXXXXXXXXXXXXXXXXXXXXXXXXXXXXXXXXXXXXXXXXXXXXXXXXXXXXXXXXXXXXXXXXXXXXXXXXXXXXXXXXXXXXXXXXXXXXXXXXXX

