--------------------------------------------------------------------------------------------------------------------------------------------------------------------------------------------------------
--------------------------------------------------------------------------------------------------------------------------------------------------------------------------------------------------------
--------------------------------------------------------------------------------------------------------------------------------------------------------------------------------------------------------
--------------------------------------------------------------------------------------------------------------------------------------------------------------------------------------------------------
--------------------------------------------------------------------------------------------------------------------------------------------------------------------------------------------------------
--------------------------------------------------------------------------------------------------------------------------------------------------------------------------------------------------------
--------------------------------------------------------------------------------------------------------------------------------------------------------------------------------------------------------
--------------------------------------------------------------------------------------------------------------------------------------------------------------------------------------------------------
--------------------------------------------------------------------------------------------------------------------------------------------------------------------------------------------------------
--------------------------------------------------------------------------------------------------------------------------------------------------------------------------------------------------------
--------------------------------------------------------------------------------------------------------------------------------------------------------------------------------------------------------
--------------------------------------------------------------------------------------------------------------------------------------------------------------------------------------------------------
---------------------ooooS-----------oSooo--------------------------------------------------------------------------------------------------------------oSoS-----------------------oSS------------------
-------------------------------------------------Soo----ooSo---oooS----oSoo-------oooS-------------------------------------------------------------------------------------oooSSo---------oSSSo---------
----------------------ooooo-------------ooooo-------------------------------------------------------------------------------------------------------------oo------------------------oooo------------oSo-
-----------------------y-r-gr--------------r---ooooo---oooo-----oo-----oooo---------ooooo-------------------------oooSSSoo---------ooSoooo-----------------Y-K--------------ooooo--kr--r----------------
-------------XXXXXXXXXXXXXXXXX------XXXXXXXXXX-g--R-g--------------Y---rg------XX---r-r----ooooo-------ooo-----------------------------------------XXXXXXXXXXXX-------------r-----XXXXXXX---K---y-------
-------------XXXXXXXXXXXXXXXXX------XXXXXXXXXXXXXXXXXXXXXXXXXXXXXXXXXXXXXXXXXXXXXXXXXXXXXX-K--y---XXXX-g---k-------oooo------yrK----oooooo---------XXXXXXXXXXXX------XXXXXXXXXXXXXXXXXXXXXXXXXXXXX-gyk--
-------------XXXXXXXXXXXXXXXXX---k--XXXXXXXXXXXXXXXXXXXXXXXXXXXXXXXXXXXXXXXXXXXXXXXXXXXXXXXXXXXXXXXXXXXXXXXXX--------------XXXXXX-----R-------rkKR-XXXXXXXXXXXX------XXXXXXXXXXXXXXXXXXXXXXXXXXXXXXXXXXX
XXXXXXXXXXXXXXXXXXXXXXXXXXXXXXXXXXXXXXXXXXXXXXXXXXXXXXXXXXXXXXXXXXXXXXXXXXXXXXXXXXXXXXXXXXXXXXXXXXXXXXXXXXXXXXXXXXXXXXXXXXXXXXXXXXXXXXXXXXXXXXXXXXXXXXXXXXXXXXXXXXXXXXXXXXXXXXXXXXXXXXXXXXXXXXXXXXXXXXXX

