--------------------------------------------------------------------------------------------------------------------------------------------------------------------------------------------------------
--------------------------------------------------------------------------------------------------------------------------------------------------------------------------------------------------------
--------------------------------------------------------------------------------------------------------------------------------------------------------------------------------------------------------
--------------------------------------------------------------------------------------------------------------------------------------------------------------------------------------------------------
--------------------------------------------------------------------------------------------------------------------------------------------------------------------------------------------------------
--------------------------------------------------------------------------------------------------------------------------------------------------------------------------------------------------------
--------------------------------------------------------------------------------------------------------------------------------------------------------------------------------------------------------
--------------------------------------------------------------------------------------------------------------------------------------------------------------------------------------------------------
--------------------------------------------------------------------------------------------------------------------------------------------------------------------------------------------------------
--------------------------------------------------------------------------------------------------------------------------------------------------------------------------------------------------------
--------------------------------------------------------------------------------------------------------------------------------------------------------------------------------------------------------
--------------------------------------------------------------------------------------------------------------------------------------------------------------------------------------------------------
----------------------------------------------------------------------------------------------------------------------------------------oSoSoo----------------------------------------------------------
-----------------------------oooS------------------------oSo-----------------------------SoSo--------------------------------------------------------oooSSoo--------------------------------------------
-------------------oooo--------------ooo---------------------------------------------------------------------------------SSSo--------ooooooo-------------------------Soo--------------------------------
-------------------r----------ooooo--rG-----------------oooo--------oo-------------------ooooooo---------SSSo-----------------------------K-ky------ooooooo---------------------------------------------
------------ooooo-XXXXXXXX----r-----XXXXXXXXXXX---------kky----------K-XXXX------XXXXX----y----------XX------------------oooo-------XXXXXXXXXXX-----gky--R---------ooo----------------------------ooo---
--------------kyr-XXXXXXXXXXXXXXXXXXXXXXXXXXXXX--oo----XXXXXXXXXXXXXXXXXXXX----XXXXXXXXXXXXXXXXXXXXXXXX-----------oo------y-K--XXXXXXXXXXXXXXXX----XXXXXXXXXXXXXXX-GkY----ooo----r-----ooooo--------rg--
-----------XXXXXXXXXXXXXXXXXXXXXXXXXXXXXXXXXXXX--Yy--XXXXXXXXXXXXXXXXXXXXXXXXXXXXXXXXXXXXXXXXXXXXXXXXXX-g--y-----yy-g-XXXXXXXXXXXXXXXXXXXXXXXXXXXXXXXXXXXXXXXXXXXXXXXXXXX--RK---XXXXXX-g---k--XXXXXXXXXX
XXXXXXXXXXXXXXXXXXXXXXXXXXXXXXXXXXXXXXXXXXXXXXXXXXXXXXXXXXXXXXXXXXXXXXXXXXXXXXXXXXXXXXXXXXXXXXXXXXXXXXXXXXXXXXXXXXXXXXXXXXXXXXXXXXXXXXXXXXXXXXXXXXXXXXXXXXXXXXXXXXXXXXXXXXXXXXXXXXXXXXXXXXXXXXXXXXXXXXXX

