--------------------------------------------------------------------------------------------------------------------------------------------------------------------------------------------------------
--------------------------------------------------------------------------------------------------------------------------------------------------------------------------------------------------------
--------------------------------------------------------------------------------------------------------------------------------------------------------------------------------------------------------
--------------------------------------------------------------------------------------------------------------------------------------------------------------------------------------------------------
--------------------------------------------------------------------------------------------------------------------------------------------------------------------------------------------------------
--------------------------------------------------------------------------------------------------------------------------------------------------------------------------------------------------------
--------------------------------------------------------------------------------------------------------------------------------------------------------------------------------------------------------
--------------------------------------------------------------------------------------------------------------------------------------------------------------------------------------------------------
--------------------------------------------------------------------------------------------------------------------------------------------------------------------------------------------------------
--------------------------------------------------------------------------------------------------------------------------------------------------------------------------------------------------------
--------------------------------------------------------------------------------------------------------------------------------------------------------------------------------------------------------
--------------------------------------------------------------------------------------------------------------------------------------------------------------------------------------------------------
--------------------------------------------------SooS-------------------------------------------------------------------------------------------ooo-------------------------------------oSo------------
-----------------------------------------------------------------------------------------------------------------------------ooSooo---------------------------------ooooSo------------------------------
--------------------oSS--------------oSoSoo------oooo---------------------------oSo---------------------------oooo-------------------ooSooo-------------------------------------------------------------
------------------------------------------------Rg-g---------------------------------------------------------yK----------------oooo---------------kg------------------oo------ooSooo------yg------------
XXXXXXXXXXXXXXXXXX----ooo------------oooooooo--XXXXXXXXX---------------XXXXX------------r-------------XXX---XXXXXXXX-g----XX-k----r----ooo-----XXXXXX---------------K--R--------------XXXXXXX-----------
XXXXXXXXXXXXXXXXXX---yr-------oooo----Kykyy----XXXXXXXXX---------------XXXXXXXX--g---XXXXXX---XXXXX---XXX---XXXXXXXXXXXXXXXXXXXXXXXX---yR------XXXXXX--------------XXXXXXXX--ooooooo--XXXXXXX-----------
XXXXXXXXXXXXXXXXXXXXXXXXXXX----kr---XXXXXXXXXXXXXXXXXXXX---------------XXXXXXXXXXXXXXXXXXXX---XXXXX---XXX---XXXXXXXXXXXXXXXXXXXXXXXXXXXXXXXXXXXXXXXXXXXXXXXXXXXXXXXXXXXXXXX-------k---XXXXXXX---XXXXXXXX
XXXXXXXXXXXXXXXXXXXXXXXXXXXXXXXXXXXXXXXXXXXXXXXXXXXXXXXXXXXXXXXXXXXXXXXXXXXXXXXXXXXXXXXXXXXXXXXXXXXXXXXXXXXXXXXXXXXXXXXXXXXXXXXXXXXXXXXXXXXXXXXXXXXXXXXXXXXXXXXXXXXXXXXXXXXXXXXXXXXXXXXXXXXXXXXXXXXXXXXX

