--------------------------------------------------------------------------------------------------------------------------------------------------------------------------------------------------------
--------------------------------------------------------------------------------------------------------------------------------------------------------------------------------------------------------
--------------------------------------------------------------------------------------------------------------------------------------------------------------------------------------------------------
--------------------------------------------------------------------------------------------------------------------------------------------------------------------------------------------------------
--------------------------------------------------------------------------------------------------------------------------------------------------------------------------------------------------------
--------------------------------------------------------------------------------------------------------------------------------------------------------------------------------------------------------
--------------------------------------------------------------------------------------------------------------------------------------------------------------------------------------------------------
--------------------------------------------------------------------------------------------------------------------------------------------------------------------------------------------------------
--------------------------------------------------------------------------------------------------------------------------------------------------------------------------------------------------------
--------------------------------------------------------------------------------------------------------------------------------------------------------------------------------------------------------
--------------------------------------------------------------------------------------------------------------------------------------------------------------------------------------------------------
--------------------------------------------------------------------------------------------------------------------------------------------------------------------------------------------------------
------------------------oooSo---------------------------------------------------------------oooooS------------------ooooSo----------------------------------oooo----------------------------------------
----------------------------------------------------------------SSo-------------------------------------------------------------------------------------------------------------------------------------
------------------------oooo----------------ooSo--------------------------------------------ooooooo-------------------oooo------------------------------------------ooo---------------oSSooooo----------
---------------oooSoS------g-Y-----------------------------------oo--------SSoooo-----y--r-------r-Y--------------------g----oSo------y-yy-----ooooS----------k-g------gG--ooooSo-----------------------
-----------------------XXXXXXXX----XXXXX---oooooo---XX-----------k-----------------XXXXXXXXXXXXXXXXXX--------------XXXXXXXX----------XXXXXXXXX-------------XXXXXXXXXXXXXXX------------oooooooo----ooo---
XXXXXXXXXXXX--ooooooo--XXXXXXXX----XXXXX---k--------XX-------XXXXXXX------ooooooo--XXXXXXXXXXXXXXXXXX--------------XXXXXXXX----------XXXXXXXXX-ooooo---XXXXXXXXXXXXXXXXXXX-oooooo-----G------k--------y-
XXXXXXXXXXXX------GG-k-XXXXXXXXXXXXXXXXXXXXXXXXXXXXXXX---y---XXXXXXXXXXXX-K--r---g-XXXXXXXXXXXXXXXXXX-g--g-XXXXXXXXXXXXXXXX---r------XXXXXXXXX----gr-r-XXXXXXXXXXXXXXXXXXX-----------XXXXXXXXXXXXXXXXXXX
XXXXXXXXXXXXXXXXXXXXXXXXXXXXXXXXXXXXXXXXXXXXXXXXXXXXXXXXXXXXXXXXXXXXXXXXXXXXXXXXXXXXXXXXXXXXXXXXXXXXXXXXXXXXXXXXXXXXXXXXXXXXXXXXXXXXXXXXXXXXXXXXXXXXXXXXXXXXXXXXXXXXXXXXXXXXXXXXXXXXXXXXXXXXXXXXXXXXXXXX

