--------------------------------------------------------------------------------------------------------------------------------------------------------------------------------------------------------
--------------------------------------------------------------------------------------------------------------------------------------------------------------------------------------------------------
--------------------------------------------------------------------------------------------------------------------------------------------------------------------------------------------------------
--------------------------------------------------------------------------------------------------------------------------------------------------------------------------------------------------------
--------------------------------------------------------------------------------------------------------------------------------------------------------------------------------------------------------
--------------------------------------------------------------------------------------------------------------------------------------------------------------------------------------------------------
--------------------------------------------------------------------------------------------------------------------------------------------------------------------------------------------------------
--------------------------------------------------------------------------------------------------------------------------------------------------------------------------------------------------------
--------------------------------------------------------------------------------------------------------------------------------------------------------------------------------------------------------
--------------------------------------------------------------------------------------------------------------------------------------------------------------------------------------------------------
--------------------------------------------------------------------------------------------------------------------------------------------------------------------------------------------------------
--------------------------------------------------------------------------------------------------------------------------------------------------------------------------------------------------------
---------------------oooo-------------------oSooo-----ooo--------------------------------------------------------------ooo------------------------------------------------------------------------------
----------------------------------------------------------------------------------------------------------------------------------SSoSo---------------------SoSoo----------------------ooSoSoo----------
---------------------ooo--------------------oooo-------oo------------------------------------SSS----------------------oooo---------------------------------------------ooSSSo-----ooo-------------------
---------------------------ooS-------------------------rg--------------oSoo--------SoooS--------------oooooSo--k-----r---kr------ooooo------------Soo-----ooooo-------------------------ooooooo---------
XXXXXXXXXX--------XXXXXXXX----------------XXXXXXXXXXXXXXXX------------------XXXXX-------------ooo-------------XXXXXXXXXXXXXX------y---G---------------XX----YGR----------ooooo-XXXXXXX----y--g----------
XXXXXXXXXXXXX-----XXXXXXXX---oo-XXXXXXXXXXXXXXXXXXXXXXXXXX-----XXXX---ooo---XXXXX-oooooo---g---rkr------ooooo-XXXXXXXXXXXXXX----XXXXXXXX--G-----------XXXXXXXXXXXX------ggG-ky-XXXXXXXXXXXXXXXXXX-------
XXXXXXXXXXXXX-----XXXXXXXX------XXXXXXXXXXXXXXXXXXXXXXXXXX-----XXXX---y-Y---XXXXX------k--XXXXXXXXXX----g-----XXXXXXXXXXXXXX----XXXXXXXXXXXXXXX---kk--XXXXXXXXXXXX----XXXXXXXXXXXXXXXXXXXXXXXXXXX-----XX
XXXXXXXXXXXXXXXXXXXXXXXXXXXXXXXXXXXXXXXXXXXXXXXXXXXXXXXXXXXXXXXXXXXXXXXXXXXXXXXXXXXXXXXXXXXXXXXXXXXXXXXXXXXXXXXXXXXXXXXXXXXXXXXXXXXXXXXXXXXXXXXXXXXXXXXXXXXXXXXXXXXXXXXXXXXXXXXXXXXXXXXXXXXXXXXXXXXXXXXX

