--------------------------------------------------------------------------------------------------------------------------------------------------------------------------------------------------------
--------------------------------------------------------------------------------------------------------------------------------------------------------------------------------------------------------
--------------------------------------------------------------------------------------------------------------------------------------------------------------------------------------------------------
--------------------------------------------------------------------------------------------------------------------------------------------------------------------------------------------------------
--------------------------------------------------------------------------------------------------------------------------------------------------------------------------------------------------------
--------------------------------------------------------------------------------------------------------------------------------------------------------------------------------------------------------
--------------------------------------------------------------------------------------------------------------------------------------------------------------------------------------------------------
--------------------------------------------------------------------------------------------------------------------------------------------------------------------------------------------------------
--------------------------------------------------------------------------------------------------------------------------------------------------------------------------------------------------------
--------------------------------------------------------------------------------------------------------------------------------------------------------------------------------------------------------
--------------------------------------------------------------------------------------------------------------------------------------------------------------------------------------------------------
--------------------------------------------------------------------------------------------------------------------------------------------------------------------------------------------------------
--------------------------------------------------oSoS--------------------------oSo---------------------ooooooo---------------------------------------------------------------------------oooo----------
-------------------------------------------------------------------------------------------------oooo---------------------------------------------------------------------------------------------------
-------------------oSoSooo--------------ooo--------ooo---------------------------ooo----------------------ooo-----------------------------------ooSooS-----ooo--------------------------oooooooo--------
--------------------------------oooS-----------------y-----------k--R------------k-y--oooSSS---oooo--------g------------------SoSoS----------------------------Y---ooooo--------ooS----k------k---------
XXXXXXXXXX---oo-----ooooo--------------XXXXXX--XXXXXXXXX--oooo--XXXXXX---------XXXXXX----------r-y--y-XXXXXXXXXXX----------------------XX-------ooooooo---XXXXXXX------Y--------------XXXXXXXXXXX-------
XXXXXXXXXX--g------yyr-yk-------ooooo--XXXXXXXXXXXXXXXXX------g-XXXXXX---------XXXXXX----ooo--XXXXXXXXXXXXXXXXXXX--oooo---XX----ooo----XX-r-Y------r---g--XXXXXXXXXXXXXXXX----ooooooo-XXXXXXXXXXX-------
XXXXXXXXXXXXXXXXXXXXXXXXXXXX-Y-Y-----y-XXXXXXXXXXXXXXXXXXXXXXXXXXXXXXXXXXXXXXXXXXXXXX------g--XXXXXXXXXXXXXXXXXXX-k-y-----XX--------Kk-XXXXXXXXXXXXXXXXXXXXXXXXXXXXXXXXXXX----K-------XXXXXXXXXXXXXXXXXX
XXXXXXXXXXXXXXXXXXXXXXXXXXXXXXXXXXXXXXXXXXXXXXXXXXXXXXXXXXXXXXXXXXXXXXXXXXXXXXXXXXXXXXXXXXXXXXXXXXXXXXXXXXXXXXXXXXXXXXXXXXXXXXXXXXXXXXXXXXXXXXXXXXXXXXXXXXXXXXXXXXXXXXXXXXXXXXXXXXXXXXXXXXXXXXXXXXXXXXXX

