--------------------------------------------------------------------------------------------------------------------------------------------------------------------------------------------------------
--------------------------------------------------------------------------------------------------------------------------------------------------------------------------------------------------------
--------------------------------------------------------------------------------------------------------------------------------------------------------------------------------------------------------
--------------------------------------------------------------------------------------------------------------------------------------------------------------------------------------------------------
--------------------------------------------------------------------------------------------------------------------------------------------------------------------------------------------------------
--------------------------------------------------------------------------------------------------------------------------------------------------------------------------------------------------------
--------------------------------------------------------------------------------------------------------------------------------------------------------------------------------------------------------
--------------------------------------------------------------------------------------------------------------------------------------------------------------------------------------------------------
--------------------------------------------------------------------------------------------------------------------------------------------------------------------------------------------------------
--------------------------------------------------------------------------------------------------------------------------------------------------------------------------------------------------------
--------------------------------------------------------------------------------------------------------------------------------------------------------------------------------------------------------
--------------------------------------------------------------------------------------------------------------------------------------------------------------------------------------------------------
-----------------------------------------------------------------------------------------oooSo----------------------------------------------------------------------------------------------------------
---------------------------ooS--------------------------------------ooSooSo------------------------------------ooSoo-------------------------------oooo--------------------------------oSo---------oooo-
------------------ooooo------------------------------------oooooo----------------------ooooooo-------------------------------------------SSoSoo-------------------SSSSSoo-------------------------------
----------------------g-----ooooo-----ooo-----------------------------ooooo----------------G-yK-----------------ooooo-----oooSo--------------------ooo---------------------------------ooo--------oo----
XXXXXXXXXXXXXXXXXXXXXXXX----g---r--------------oo-------oooooo-----YGY-g-yr-------XX--XXXXXXXXXX---------XXX-----Y---r------------------oooooooo-----g------------ooooo----XXXXX-oo-------------------k-
XXXXXXXXXXXXXXXXXXXXXXXXXXXXXXXXXX-oooooo--------------------Y-y--XXXXXXXXXXXXXXXXXXXXXXXXXXXXXXXXXXX----XXXXXXXXXXXXXX--ooooo--XX------k-k--kkyr-XXXXXXX---------------y--XXXXX--y-r-XXXXXX---XXXXXXXXX
XXXXXXXXXXXXXXXXXXXXXXXXXXXXXXXXXX----k--kY-XXXXXX-----XXXXXXXXXXXXXXXXXXXXXXXXXXXXXXXXXXXXXXXXXXXXXX----XXXXXXXXXXXXXX-----gY--XXXXXXXXXXXXXXXXXXXXXXXXXXXXXXXXXXXXXXXXXXXXXXXXXXXXXXXXXXXXXXXXXXXXXXXX
XXXXXXXXXXXXXXXXXXXXXXXXXXXXXXXXXXXXXXXXXXXXXXXXXXXXXXXXXXXXXXXXXXXXXXXXXXXXXXXXXXXXXXXXXXXXXXXXXXXXXXXXXXXXXXXXXXXXXXXXXXXXXXXXXXXXXXXXXXXXXXXXXXXXXXXXXXXXXXXXXXXXXXXXXXXXXXXXXXXXXXXXXXXXXXXXXXXXXXXX

