--------------------------------------------------------------------------------------------------------------------------------------------------------------------------------------------------------
--------------------------------------------------------------------------------------------------------------------------------------------------------------------------------------------------------
--------------------------------------------------------------------------------------------------------------------------------------------------------------------------------------------------------
--------------------------------------------------------------------------------------------------------------------------------------------------------------------------------------------------------
--------------------------------------------------------------------------------------------------------------------------------------------------------------------------------------------------------
--------------------------------------------------------------------------------------------------------------------------------------------------------------------------------------------------------
--------------------------------------------------------------------------------------------------------------------------------------------------------------------------------------------------------
--------------------------------------------------------------------------------------------------------------------------------------------------------------------------------------------------------
--------------------------------------------------------------------------------------------------------------------------------------------------------------------------------------------------------
--------------------------------------------------------------------------------------------------------------------------------------------------------------------------------------------------------
--------------------------------------------------------------------------------------------------------------------------------------------------------------------------------------------------------
--------------------------------------------------------------------------------------------------------------------------------------------------------------------------------------------------------
------------------------------------------------------ooo-----------------------------------------------------------------------------------------------------------------------------------------------
------------------------------------------------------------ooooSoo---ooSSoo------------------------------------Sooo------------------------------------------------------------------------------------
-----------------------SSoS---------------------------oooo-----------------------ooooooSo-----------------------------------------------SSSoSoo---------oSSooooo-----------------------ooSo-------------
----------------------------------ooSo---Sooo---------------ooooo--------ooooo---------------------------------oooo--------------------------------------------------------ooo---ooo---------oSooSSo----
-------------XXXX---ooooooo--------------------------XXXXXX----r---g----k--------ooooo---------XX-----XXXXXX-------------oooo-----G---ooooooo-------------oooo--------------r----g-R--------------------
XXXXXXXXXXXXXXXXX----Y-yG-rr------oo-------ooo-XX----XXXXXXXXXXXXXXXXXXXXXXXXXX---K--K---------XX-----XXXXXXXXXXXXXXXX-R---G---XXXXXX-ykk--gr-k-XX-------gYyy--k---ooo---XXXXXXXXXXXX----------ooo----XX
XXXXXXXXXXXXXXXXX--XXXXXXXXXXX---yR------------XXXXXXXXXXXXXXXXXXXXXXXXXXXXXXXXXXXXXXXXXXXXXXXXXXXXXXXXXXXXXXXXXXXXXXXXXXXXXXXXXXXXXXXXXXXXXXXXXXXXXXXXXXXXXXXXXXX--R-ry-XXXXXXXXXXXXXXXXXXX--k--Y-K--XX
XXXXXXXXXXXXXXXXXXXXXXXXXXXXXXXXXXXXXXXXXXXXXXXXXXXXXXXXXXXXXXXXXXXXXXXXXXXXXXXXXXXXXXXXXXXXXXXXXXXXXXXXXXXXXXXXXXXXXXXXXXXXXXXXXXXXXXXXXXXXXXXXXXXXXXXXXXXXXXXXXXXXXXXXXXXXXXXXXXXXXXXXXXXXXXXXXXXXXXXX

