--------------------------------------------------------------------------------------------------------------------------------------------------------------------------------------------------------
--------------------------------------------------------------------------------------------------------------------------------------------------------------------------------------------------------
--------------------------------------------------------------------------------------------------------------------------------------------------------------------------------------------------------
--------------------------------------------------------------------------------------------------------------------------------------------------------------------------------------------------------
--------------------------------------------------------------------------------------------------------------------------------------------------------------------------------------------------------
--------------------------------------------------------------------------------------------------------------------------------------------------------------------------------------------------------
--------------------------------------------------------------------------------------------------------------------------------------------------------------------------------------------------------
--------------------------------------------------------------------------------------------------------------------------------------------------------------------------------------------------------
--------------------------------------------------------------------------------------------------------------------------------------------------------------------------------------------------------
--------------------------------------------------------------------------------------------------------------------------------------------------------------------------------------------------------
--------------------------------------------------------------------------------------------------------------------------------------------------------------------------------------------------------
--------------------------------------------------------------------------------------------------------------------------------------------------------------------------------------------------------
------------------------------------------------oSoooSo-------------------------------------------------------------------------------------------------------------------------------------------------
--------------------------------------ooooooo--------------------------------------------Soo--------------oooooSo----------------oSSoS------------------------------oSooo------ooSo---------------ooSo--
-----------oooSSooo----------------------------oooooo---------------------------oo-------------------------------------------------------oooSSSSS--------oo---------------------------------------------
----------------------------oo---------oooo----Yy--r---------R-----------------gy-----oooo-----oooo-----oooooo----------------oooooooo--------------------k----------oooooo------------------------ooo--
-----------oooooooo----------rr-XXXXX-G--gYy--XXXXXXXXXXXXXXXXX---------------XXXXXXX---y-gkg-------------r--y------------------K--Rk-y--ooooooooo----XXXXXXX----XX--R-r---r-----------XXXX--------Rg---
-----------rk-Yg--y-------XXXXXXXXXXXXXXXXXXXXXXXXXXXXXXXXXXXXX---oo----ooooo-XXXXXXXXXXXXXXXX-oooo----XXXXXXXXXXX--*----*---XXXXXXXXXXX--g--Y--------XXXXXXX----XXXXXXXXXXXXXXXXXXX---XXXX-----XXXXXXXX
XXXXXXXXXXXXXXXXXXXXXXXXXXXXXXXXXXXXXXXXXXXXXXXXXXXXXXXXXXXXXXX---------------XXXXXXXXXXXXXXXX----k----XXXXXXXXXXX--*----*---XXXXXXXXXXXXXXXXXXXXXXXXXXXXXXXX----XXXXXXXXXXXXXXXXXXXXXXXXXXXXXXXXXXXXXXX
XXXXXXXXXXXXXXXXXXXXXXXXXXXXXXXXXXXXXXXXXXXXXXXXXXXXXXXXXXXXXXXXXXXXXXXXXXXXXXXXXXXXXXXXXXXXXXXXXXXXXXXXXXXXXXXXXXXXXXXXXXXXXXXXXXXXXXXXXXXXXXXXXXXXXXXXXXXXXXXXXXXXXXXXXXXXXXXXXXXXXXXXXXXXXXXXXXXXXXXX

