--------------------------------------------------------------------------------------------------------------------------------------------------------------------------------------------------------
--------------------------------------------------------------------------------------------------------------------------------------------------------------------------------------------------------
--------------------------------------------------------------------------------------------------------------------------------------------------------------------------------------------------------
--------------------------------------------------------------------------------------------------------------------------------------------------------------------------------------------------------
--------------------------------------------------------------------------------------------------------------------------------------------------------------------------------------------------------
--------------------------------------------------------------------------------------------------------------------------------------------------------------------------------------------------------
--------------------------------------------------------------------------------------------------------------------------------------------------------------------------------------------------------
--------------------------------------------------------------------------------------------------------------------------------------------------------------------------------------------------------
--------------------------------------------------------------------------------------------------------------------------------------------------------------------------------------------------------
--------------------------------------------------------------------------------------------------------------------------------------------------------------------------------------------------------
--------------------------------------------------------------------------------------------------------------------------------------------------------------------------------------------------------
--------------------------------------------------------------------------------------------------------------------------------------------------------------------------------------------------------
-----------------------------oSoS----------------------------------------------------------------------------------------------------------------------------oSooSo-------------------------------------
---------------------ooSo-------------SoSo----------------ooooSoS---------------------------------------------------------------------------------------------------------------------------------------
------------------------------oooo--------------oSoSSooo--------------oo--------------------------------------------------------------------------------------ooooooo-----------------------------------
--------------ooooo-----ooo--y--Y-------ooooo--------------oooooo----k------oooSS------------SSoS---------oSoooooo--------------oSo-----oSooo----oSSo------------r---y---------------------ooo-----Y----
---------------------K-k----XXXXXXXX--r-g--y------ooooo----y-k-----XXXXXX---------------------------------------------XX-----XX-----------------------------XXXXXXXXXXXXXXXX--------XXX--------XXXXXXXXX
--------------ooo---XXXXXXXXXXXXXXXXXXXXXXXXXX-----k-----XXXXXXXXXXXXXXXX---ooooooo-----------oooo---------oooooo-----XX-----XX-ooo---------------ooo----XXXXXXXXXXXXXXXXXXX------XXXXX--ooooo-XXXXXXXXX
XXXXXXXXXXXX-----r--XXXXXXXXXXXXXXXXXXXXXXXXXXXXXXXXXXXXXXXXXXXXXXXXXXXXX-Y-kyK------------k---g-----------g--K-------XXXXXXXXX--r--------kyk------------XXXXXXXXXXXXXXXXXXX------XXXXX-r-rg---XXXXXXXXX
XXXXXXXXXXXXXXXXXXXXXXXXXXXXXXXXXXXXXXXXXXXXXXXXXXXXXXXXXXXXXXXXXXXXXXXXXXXXXXXXXXXXXXXXXXXXXXXXXXXXXXXXXXXXXXXXXXXXXXXXXXXXXXXXXXXXXXXXXXXXXXXXXXXXXXXXXXXXXXXXXXXXXXXXXXXXXXXXXXXXXXXXXXXXXXXXXXXXXXXX

