--------------------------------------------------------------------------------------------------------------------------------------------------------------------------------------------------------
--------------------------------------------------------------------------------------------------------------------------------------------------------------------------------------------------------
--------------------------------------------------------------------------------------------------------------------------------------------------------------------------------------------------------
--------------------------------------------------------------------------------------------------------------------------------------------------------------------------------------------------------
--------------------------------------------------------------------------------------------------------------------------------------------------------------------------------------------------------
--------------------------------------------------------------------------------------------------------------------------------------------------------------------------------------------------------
--------------------------------------------------------------------------------------------------------------------------------------------------------------------------------------------------------
--------------------------------------------------------------------------------------------------------------------------------------------------------------------------------------------------------
--------------------------------------------------------------------------------------------------------------------------------------------------------------------------------------------------------
--------------------------------------------------------------------------------------------------------------------------------------------------------------------------------------------------------
--------------------------------------------------------------------------------------------------------------------------------------------------------------------------------------------------------
--------------------------------------------------------------------------------------------------------------------------------------------------------------------------------------------------------
--------------------------------------------------SSoooo-------------------------------------------SSoS--------ooSoo------------------------------------------------------------------------------------
------------------------------------------------------------------------oooSo----------------------------------------------------------oSo-------------------------------------oooo---------------------
---------------------------------------ooooSoo--oooooo---------oSoo------------oooo----------ooo-----ooo-----ooooooo--------ooSoooSoo--------------------------------------------------------ooooo------
----------------oooo--------------------------------K-y------------------oooo----------------Krg--g-----k---g-----k---oooo-------------------------------------ooSooSo-----k----------------------------
------------------k-------------------ooooo----XXXXXXXXXX-------ooooo------yg-XXXXXXXXX---XXXXXXXXXXXXXXXXXXXXXXXXXXX-G-r-----oooooo---RG--------XXXXX---oooo-----------XXXXXX-g-K-----XXX--oooo------XX
XXXXXXXXXXXXXXXXXXXXXX-oooooo----------y-r-Y---XXXXXXXXXXXXXXX----g-g--XXXXXXXXXXXXXXXX---XXXXXXXXXXXXXXXXXXXXXXXXXXXXXXXXX--------y--XXXXXXX----XXXXX--r-g-y---ooooooo-XXXXXXXXXXXXXXXXXX----R----XXXXX
XXXXXXXXXXXXXXXXXXXXXX-y---------XXXXXXXXXXXXXXXXXXXXXXXXXXXXXXXXXXXXXXXXXXXXXXXXXXXXXX---XXXXXXXXXXXXXXXXXXXXXXXXXXXXXXXXXXXXXXXXXXXXXXXXXXXXXXXXXXXXXXXXXXXX-r--y-k---XXXXXXXXXXXXXXXXXXXXXXXXXXXXXXXX
XXXXXXXXXXXXXXXXXXXXXXXXXXXXXXXXXXXXXXXXXXXXXXXXXXXXXXXXXXXXXXXXXXXXXXXXXXXXXXXXXXXXXXXXXXXXXXXXXXXXXXXXXXXXXXXXXXXXXXXXXXXXXXXXXXXXXXXXXXXXXXXXXXXXXXXXXXXXXXXXXXXXXXXXXXXXXXXXXXXXXXXXXXXXXXXXXXXXXXXX

