--------------------------------------------------------------------------------------------------------------------------------------------------------------------------------------------------------
--------------------------------------------------------------------------------------------------------------------------------------------------------------------------------------------------------
--------------------------------------------------------------------------------------------------------------------------------------------------------------------------------------------------------
--------------------------------------------------------------------------------------------------------------------------------------------------------------------------------------------------------
--------------------------------------------------------------------------------------------------------------------------------------------------------------------------------------------------------
--------------------------------------------------------------------------------------------------------------------------------------------------------------------------------------------------------
--------------------------------------------------------------------------------------------------------------------------------------------------------------------------------------------------------
--------------------------------------------------------------------------------------------------------------------------------------------------------------------------------------------------------
--------------------------------------------------------------------------------------------------------------------------------------------------------------------------------------------------------
--------------------------------------------------------------------------------------------------------------------------------------------------------------------------------------------------------
--------------------------------------------------------------------------------------------------------------------------------------------------------------------------------------------------------
--------------------------------------------------------------------------------------------------------------------------------------------------------------------------------------------------------
--------------------------------------------------------------------------------------------------------------------------------------------------------------------------oooooo------------------------
------------ooSSo-----------------------------------oooS----------------------------------------------oSo--ooS------------------------------------------------------------------------------------------
-----------------------------------SSSSo---------------------------------Soo---------------------------------------------oSSoSo----------SSSo---oo-------oSooo--------------oooo------------------------
------------oooooo--------------------------------oooooo----------------------------------------------ooo----oooo--oooo-------------------------rR-----------------------krYYk-R------------------------
-----------r--R-ry------------------ooooo----------------k-----ooo----------------------------XXXXX----y----R--G------------oooo---------------XXXXXX--ooooo-------oooo-XXXXXXXXX-----------------XXXXX-
----------XXXXXXXXXXX---------k---r----k-----K---XXXXXXXXXX---kr-kY---k---K-----oooooo--------XXXXXXXXXXXXXXXXXXXX-------gk--Gg----XXXX-g--YR--XXXXXX-g--k----------Y---XXXXXXXXX-----------------XXXXX-
XXXXXXXXXXXXXXXXXXXXX-----XXXXXXXXXXXXXXXXXXXXXXXXXXXXXXXXX--XXXXXXXXXXXXXXXX---RR---k--------XXXXXXXXXXXXXXXXXXXX---K--XXXXXXXXXXXXXXXXXXXXXXXXXXXXXXXXXXXXXXXXXXXXXXXXXXXXXXXXX----XXXXXXXX-----XXXXXX
XXXXXXXXXXXXXXXXXXXXXXXXXXXXXXXXXXXXXXXXXXXXXXXXXXXXXXXXXXXXXXXXXXXXXXXXXXXXXXXXXXXXXXXXXXXXXXXXXXXXXXXXXXXXXXXXXXXXXXXXXXXXXXXXXXXXXXXXXXXXXXXXXXXXXXXXXXXXXXXXXXXXXXXXXXXXXXXXXXXXXXXXXXXXXXXXXXXXXXXX

