--------------------------------------------------------------------------------------------------------------------------------------------------------------------------------------------------------
--------------------------------------------------------------------------------------------------------------------------------------------------------------------------------------------------------
--------------------------------------------------------------------------------------------------------------------------------------------------------------------------------------------------------
--------------------------------------------------------------------------------------------------------------------------------------------------------------------------------------------------------
--------------------------------------------------------------------------------------------------------------------------------------------------------------------------------------------------------
--------------------------------------------------------------------------------------------------------------------------------------------------------------------------------------------------------
--------------------------------------------------------------------------------------------------------------------------------------------------------------------------------------------------------
--------------------------------------------------------------------------------------------------------------------------------------------------------------------------------------------------------
--------------------------------------------------------------------------------------------------------------------------------------------------------------------------------------------------------
--------------------------------------------------------------------------------------------------------------------------------------------------------------------------------------------------------
--------------------------------------------------------------------------------------------------------------------------------------------------------------------------------------------------------
--------------------------------------------------------------------------------------------------------------------------------------------------------------------------------------------------------
------------------ooooooo-------------------oooSooo-----------------------------------------------------------------------------------------------------------------------------------------------------
--------------------------------------------------------------------------ooS------------------Soo-------------------------------------------------------ooS---------ooo--------------------------------
--------------------ooo----------ooSSSSSS-----oooo-------------------------------------------------------ooo----------------------ooo---------------------------------------------oooSo-----------------
------------------yy-r--K-------------------yg----Y--------Y-------------ooooooo--oooooSo----oooooo---------------ooo---------------------------ooo--------------------oo-------------------------------
----------XXXX---XXXXXXXXXX--------oooooo--XXXXXXXXXXXXXXXXXXX--oo-------G--g-K--------------g----yKg--oooo-------------XXXX-------------------Rk-R-XXXX----gk--XXXX----------------ooo-----------------
----------XXXX---XXXXXXXXXX-------r--kY--g-XXXXXXXXXXXXXXXXXXX----------XXXXXXXXX-ooooooo---XXXXXXXXXX-gy-------XXXXXXXXXXXXXXXXX-----g------XXXXXXXXXXXXXXXXXXXXXXXXXXXXXXXXXXX-k------Y---------------
----------XXXX---XXXXXXXXXX-----XXXXXXXXXXXXXXXXXXXXXXXXXXXXXXXXXXXXXXXXXXXXXXXXX--yr-GG-g--XXXXXXXXXXXXXXXXXXXXXXXXXXXXXXXXXXXXXXXXXXXX-----XXXXXXXXXXXXXXXXXXXXXXXXXXXXXXXXXXXXXXXXXXXXXXXXXX---XXXX--
XXXXXXXXXXXXXXXXXXXXXXXXXXXXXXXXXXXXXXXXXXXXXXXXXXXXXXXXXXXXXXXXXXXXXXXXXXXXXXXXXXXXXXXXXXXXXXXXXXXXXXXXXXXXXXXXXXXXXXXXXXXXXXXXXXXXXXXXXXXXXXXXXXXXXXXXXXXXXXXXXXXXXXXXXXXXXXXXXXXXXXXXXXXXXXXXXXXXXXXX

