--------------------------------------------------------------------------------------------------------------------------------------------------------------------------------------------------------
--------------------------------------------------------------------------------------------------------------------------------------------------------------------------------------------------------
--------------------------------------------------------------------------------------------------------------------------------------------------------------------------------------------------------
--------------------------------------------------------------------------------------------------------------------------------------------------------------------------------------------------------
--------------------------------------------------------------------------------------------------------------------------------------------------------------------------------------------------------
--------------------------------------------------------------------------------------------------------------------------------------------------------------------------------------------------------
--------------------------------------------------------------------------------------------------------------------------------------------------------------------------------------------------------
--------------------------------------------------------------------------------------------------------------------------------------------------------------------------------------------------------
--------------------------------------------------------------------------------------------------------------------------------------------------------------------------------------------------------
--------------------------------------------------------------------------------------------------------------------------------------------------------------------------------------------------------
--------------------------------------------------------------------------------------------------------------------------------------------------------------------------------------------------------
--------------------------------------------------------------------------------------------------------------------------------------------------------------------------------------------------------
---------------------------------------------------SoSo-----------ooSoo--------------ooo----------------------------------------------------------------------------------------------------------------
---------------------------------------------------------------------------ooo-------------------------------------------------------SSo--------Sooo----------------------------------------------------
---------------------------------------------------oooo------------oooo--------------------Soo--oSSoo---------------------------------------------------------------------------------------------------
----------------k---------------oooSo------oo--------r-------------K-----oooo--------k-g---------------------------------------------ooo--------oo------r-G------------------------R--------oSoo--------
XXXXXXXXXXX--XXXXXX-----------------------GrG---XXXXXXXXX-rk-ky--XXXXXXX-rY--r-----XXXXXX--------oooo---XXXXX------g----------------gr-r-------K------XXXXXXXXX-G-----------XXXXXXXXXXX-----------------
XXXXXXXXXXXXXXXXXXX-----XXXXX---oooo---XXXXXXXXXXXXXXXXXXXXXXXXXXXXXXXXXXXXXXXXXXXXXXXXXX---yR--Y--g----XXXXXXXXXXXXXXXXXXX--Yr---XXXXXXXX----XXXXXXXXXXXXXXXXXXXXXXX--oooo-XXXXXXXXXXX---oooooooo------
XXXXXXXXXXXXXXXXXXX-----XXXXX--yk------XXXXXXXXXXXXXXXXXXXXXXXXXXXXXXXXXXXXXXXXXXXXXXXXXXXXXXXXXXXXXXXXXXXXXXXXXXXXXXXXXXXXXXXXXXXXXXXXXXXXXXXXXXXXXXXXXXXXXXXXXXXXXX-g--g--XXXXXXXXXXXXX-----------XXXX
XXXXXXXXXXXXXXXXXXXXXXXXXXXXXXXXXXXXXXXXXXXXXXXXXXXXXXXXXXXXXXXXXXXXXXXXXXXXXXXXXXXXXXXXXXXXXXXXXXXXXXXXXXXXXXXXXXXXXXXXXXXXXXXXXXXXXXXXXXXXXXXXXXXXXXXXXXXXXXXXXXXXXXXXXXXXXXXXXXXXXXXXXXXXXXXXXXXXXXXX

