--------------------------------------------------------------------------------------------------------------------------------------------------------------------------------------------------------
--------------------------------------------------------------------------------------------------------------------------------------------------------------------------------------------------------
--------------------------------------------------------------------------------------------------------------------------------------------------------------------------------------------------------
--------------------------------------------------------------------------------------------------------------------------------------------------------------------------------------------------------
--------------------------------------------------------------------------------------------------------------------------------------------------------------------------------------------------------
--------------------------------------------------------------------------------------------------------------------------------------------------------------------------------------------------------
--------------------------------------------------------------------------------------------------------------------------------------------------------------------------------------------------------
--------------------------------------------------------------------------------------------------------------------------------------------------------------------------------------------------------
--------------------------------------------------------------------------------------------------------------------------------------------------------------------------------------------------------
--------------------------------------------------------------------------------------------------------------------------------------------------------------------------------------------------------
--------------------------------------------------------------------------------------------------------------------------------------------------------------------------------------------------------
--------------------------------------------------------------------------------------------------------------------------------------------------------------------------------------------------------
-----------------------------------------------------------------------------oSoo-----------------------------------------------------------------------------------------------------------------------
---------------oooooo----------------------------------------------------------------------------------------------------oSoooo-----------------------------------------Sooooo------oSoSo---------------
---------------------------SooSoo---oooo-------oSSo----oooS----------ooSo--oooooo------oo-----------------------------------------Soooo---ooooo-------ooo-----------------------------------------------
----------------ooo----------------------------------------------------------Rk-r-r--r-------Kg-----------ooS--------------oo------------r---g---------------------------oooooo-----oo-------SoSo---ooo-
XXXXXXXXXXXXXX-----rg------oooooo----ooo--------ooo------ooo--------------XXXXXXXXXXXXXXXXXXXXXX----XXXX--------------------------------XXXXXXXXXXXX--oo------------XX-k--r--G----r-Rk----------------k-
XXXXXXXXXXXXXXXXXXXXXXX--gkr-gg----g---r-XXXX------Y-----G-y-K-XXXXX------XXXXXXXXXXXXXXXXXXXXXXXXXXXXXX----oo----ooooo-XXXXXXXX----r-r-XXXXXXXXXXXX--YGkg-------XXXXXXXXXXXXXXXXXXXXXXXXX---oooo-XXXXXX
XXXXXXXXXXXXXXXXXXXXXXXXXXXXXXXXXXXXXXXXXXXXXXXXXXXXXXXXXXXXXXXXXXXXXXXXXXXXXXXXXXXXXXXXXXXXXXXXXXXXXXXX--gG------R-K---XXXXXXXXXXXXXXXXXXXXXXXXXXXXXXXXXXXXXXXXXXXXXXXXXXXXXXXXXXXXXXXXXX---g--y-XXXXXX
XXXXXXXXXXXXXXXXXXXXXXXXXXXXXXXXXXXXXXXXXXXXXXXXXXXXXXXXXXXXXXXXXXXXXXXXXXXXXXXXXXXXXXXXXXXXXXXXXXXXXXXXXXXXXXXXXXXXXXXXXXXXXXXXXXXXXXXXXXXXXXXXXXXXXXXXXXXXXXXXXXXXXXXXXXXXXXXXXXXXXXXXXXXXXXXXXXXXXXXX

