--------------------------------------------------------------------------------------------------------------------------------------------------------------------------------------------------------
--------------------------------------------------------------------------------------------------------------------------------------------------------------------------------------------------------
--------------------------------------------------------------------------------------------------------------------------------------------------------------------------------------------------------
--------------------------------------------------------------------------------------------------------------------------------------------------------------------------------------------------------
--------------------------------------------------------------------------------------------------------------------------------------------------------------------------------------------------------
--------------------------------------------------------------------------------------------------------------------------------------------------------------------------------------------------------
--------------------------------------------------------------------------------------------------------------------------------------------------------------------------------------------------------
--------------------------------------------------------------------------------------------------------------------------------------------------------------------------------------------------------
--------------------------------------------------------------------------------------------------------------------------------------------------------------------------------------------------------
--------------------------------------------------------------------------------------------------------------------------------------------------------------------------------------------------------
--------------------------------------------------------------------------------------------------------------------------------------------------------------------------------------------------------
--------------------------------------------------------------------------------------------------------------------------------------------------------------------------------------------------------
-------------------------------------------------------------------------------------------------------------ooo-----------------------------oooS-------------------------------------------oSooSo------
----------------------Soo---------------oSSoooS-----------------------------------------ooSo-------------------------------------------------------------------SSSoo-------------oSoooooS---------------
--------------------------------oSSooo--------------ooooo----------------------------------------------------------------------oSo----------------------------------------------------------oooooo------
----------------------------------------ooooo------------------------ooooo------------------------------------r----oooSo-----------------------R-Y----------ooooo---------oSoo-----oooooo----r-----R----
XXXXXXXXXXXX---------R---rR--ooooooo----r-yy-------oooooo-XXXX----------------------XXX-R-g------------R----XXXXXX-------------ooooo-------XXXXXXXX--ooooo----g--r----------------k---yyy--XXXXXXXXXXX--
XXXXXXXXXXXX----ooo-XXXXXXXX-G-----G---XXXXXXXXXX--K---g--XXXXXXXXXXXXXXXXX---------XXXXXXXXX--------XXXXXXXXXXXXX-------XXXXX----y--------XXXXXXXX-y---g--XXXXXXXXXXXXX-oooo---XXXXXXXXXXXXXXXXXXXXXX--
XXXXXXXXXXXX---Rg-R-XXXXXXXXXXXXXXXXXXXXXXXXXXXXXXXXXXXXXXXXXXXXXXXXXXXXXXXXXXXX----XXXXXXXXX-ry--YR-XXXXXXXXXXXXX--yRk--XXXXXXXXXXXXX-----XXXXXXXXXXXXXXXXXXXXXXXXXXXXX--y--Rk-XXXXXXXXXXXXXXXXXXXXXX--
XXXXXXXXXXXXXXXXXXXXXXXXXXXXXXXXXXXXXXXXXXXXXXXXXXXXXXXXXXXXXXXXXXXXXXXXXXXXXXXXXXXXXXXXXXXXXXXXXXXXXXXXXXXXXXXXXXXXXXXXXXXXXXXXXXXXXXXXXXXXXXXXXXXXXXXXXXXXXXXXXXXXXXXXXXXXXXXXXXXXXXXXXXXXXXXXXXXXXXXX

