--------------------------------------------------------------------------------------------------------------------------------------------------------------------------------------------------------
--------------------------------------------------------------------------------------------------------------------------------------------------------------------------------------------------------
--------------------------------------------------------------------------------------------------------------------------------------------------------------------------------------------------------
--------------------------------------------------------------------------------------------------------------------------------------------------------------------------------------------------------
--------------------------------------------------------------------------------------------------------------------------------------------------------------------------------------------------------
--------------------------------------------------------------------------------------------------------------------------------------------------------------------------------------------------------
--------------------------------------------------------------------------------------------------------------------------------------------------------------------------------------------------------
--------------------------------------------------------------------------------------------------------------------------------------------------------------------------------------------------------
--------------------------------------------------------------------------------------------------------------------------------------------------------------------------------------------------------
--------------------------------------------------------------------------------------------------------------------------------------------------------------------------------------------------------
--------------------------------------------------------------------------------------------------------------------------------------------------------------------------------------------------------
--------------------------------------------------------------------------------------------------------------------------------------------------------------------------------------------------------
--------------oSSooo---------------------SSo------------------------------------------------------Soooo----ooSSoSo-----------------------------------SoSoo----------------------------------------------
----------------------------------------------------------ooSSoS-----------------------------------------------------------------------------------------------------SoSoo------------------------------
-----------------ooo----------------------------------------------------------------------------ooooooo----oooooo----------SoSS---------------------ooooo-----------------------------------------------
---------------rg------------------------------------------oooooo-------------------------------r--RR-Y------kK-R-----------------------------------kG---------------ooooooo----SoSo--------------------
-------------XXXXXXXXXXXX--------------XXXXXX--------XXX------R----------------k-y--------XXXXXXXXXXXXXXXXXXXXXXXXXXXXXXX----oo--------g---------XXXXXXXXXX--oo----k-g--y-rr---------XXXXXXX------------
-------------XXXXXXXXXXXX----XXXXXXXXXXXXXXXXXXXXXXXXXXXXXXXXXXXXX------------XXXXXX------XXXXXXXXXXXXXXXXXXXXXXXXXXXXXXX---Yg-----XXXXXXXXXX----XXXXXXXXXX----y--XXXXXXXXXXX--ooo---XXXXXXX-oooo--ooo--
-------------XXXXXXXXXXXXXXXXXXXXXXXXXXXXXXXXXXXXXXXXXXXXXXXXXXXXX----K--g----XXXXXX-kK---XXXXXXXXXXXXXXXXXXXXXXXXXXXXXXXXXXXXXXXXXXXXXXXXXXX----XXXXXXXXXXXXXXXXXXXXXXXXXXXX--gk-yK-XXXXXXX-k------Y---
XXXXXXXXXXXXXXXXXXXXXXXXXXXXXXXXXXXXXXXXXXXXXXXXXXXXXXXXXXXXXXXXXXXXXXXXXXXXXXXXXXXXXXXXXXXXXXXXXXXXXXXXXXXXXXXXXXXXXXXXXXXXXXXXXXXXXXXXXXXXXXXXXXXXXXXXXXXXXXXXXXXXXXXXXXXXXXXXXXXXXXXXXXXXXXXXXXXXXXXX

