--------------------------------------------------------------------------------------------------------------------------------------------------------------------------------------------------------
--------------------------------------------------------------------------------------------------------------------------------------------------------------------------------------------------------
--------------------------------------------------------------------------------------------------------------------------------------------------------------------------------------------------------
--------------------------------------------------------------------------------------------------------------------------------------------------------------------------------------------------------
--------------------------------------------------------------------------------------------------------------------------------------------------------------------------------------------------------
--------------------------------------------------------------------------------------------------------------------------------------------------------------------------------------------------------
--------------------------------------------------------------------------------------------------------------------------------------------------------------------------------------------------------
--------------------------------------------------------------------------------------------------------------------------------------------------------------------------------------------------------
--------------------------------------------------------------------------------------------------------------------------------------------------------------------------------------------------------
--------------------------------------------------------------------------------------------------------------------------------------------------------------------------------------------------------
--------------------------------------------------------------------------------------------------------------------------------------------------------------------------------------------------------
--------------------------------------------------------------------------------------------------------------------------------------------------------------------------------------------------------
-----------------------------------------------------------------------ooo--------------------------------------------------------------------------------------------------oSooooooo-------------------
--------------------------------------------------------------------------------------------------------------------------------------------------------------------------------------------------------
---------------------------------------------------------------------oo--------------------------------------------------Sooo--------------------------------------------------oooo---------------------
----------------------oSoSoooo--------------------ooooooooo---------Kg-K--------------ooS-----------------ooo----------------------ooSooooo--------------oSoS---------------R----r-k--------------------
--------------------------------------------XXXXX-----------XXX----XXXXXXXX------------------------XXXXX--y---y-XX--------ooo------------------------------------ooooo-----XXXXXXXXXXX------------------
------------------------ooooooo-------------XXXXX-ooooooo---XXX----XXXXXXXX----------ooooo---------XXXXXXXXXXXXXXXXXXX--gg-RkK------ooooooo-----XXXXX-oooooo------Rrg------XXXXXXXXXXX--------oooo------
XXXXXXXXXXXXXX-ry--------KK---g-XXXXXXXXXX--XXXXX-----k-----XXX----XXXXXXXX------------kk----Y-----XXXXXXXXXXXXXXXXXXXXXXXXXXXXXX-Y------Y--XXXXXXXXX--yy------XXXXXXXXXXXXXXXXXXXXXXXXXXXXXX--------XXX
XXXXXXXXXXXXXXXXXXXXXXXXXXXXXXXXXXXXXXXXXXXXXXXXXXXXXXXXXXXXXXXXXXXXXXXXXXXXXXXXXXXXXXXXXXXXXXXXXXXXXXXXXXXXXXXXXXXXXXXXXXXXXXXXXXXXXXXXXXXXXXXXXXXXXXXXXXXXXXXXXXXXXXXXXXXXXXXXXXXXXXXXXXXXXXXXXXXXXXXX

