--------------------------------------------------------------------------------------------------------------------------------------------------------------------------------------------------------
--------------------------------------------------------------------------------------------------------------------------------------------------------------------------------------------------------
--------------------------------------------------------------------------------------------------------------------------------------------------------------------------------------------------------
--------------------------------------------------------------------------------------------------------------------------------------------------------------------------------------------------------
--------------------------------------------------------------------------------------------------------------------------------------------------------------------------------------------------------
--------------------------------------------------------------------------------------------------------------------------------------------------------------------------------------------------------
--------------------------------------------------------------------------------------------------------------------------------------------------------------------------------------------------------
--------------------------------------------------------------------------------------------------------------------------------------------------------------------------------------------------------
--------------------------------------------------------------------------------------------------------------------------------------------------------------------------------------------------------
--------------------------------------------------------------------------------------------------------------------------------------------------------------------------------------------------------
--------------------------------------------------------------------------------------------------------------------------------------------------------------------------------------------------------
--------------------------------------------------------------------------------------------------------------------------------------------------------------------------------------------------------
-----------------ooSo---------------------------------------------------------------oSo--------oSoo----------------------------------ooooo--------------------------------------------oSSoSo------------
---------------------------------------ooo----------------------------------------------------------------ooSo------------------------------------------------------------------------------------------
----------------ooo----------------------------oSoSooo----------------------------------------oooo----------------ooo---------------oooooo-----------------------------------SoS-----ooooo--------------
--------------Y------------------------oooo------------------------------------------k---------r-g-G------oooo----yR-----------------r--y----------------------oSSSoo--------------------G--------------
-------------XXXXXXXXXX------------XX-------k--oooooo------ooo---XXXXXXX--------oo-XXXXXX----XXXXXXXXX--R-k--g-XXXXXXX--------XX---XXXXXXXXXXX-------------------------------ooo----XXXXXXXXXXXXXX------
-------------XXXXXXXXXX--oooooo-XXXXXXXXXXXXXX------g----------k-XXXXXXX-----K-----XXXXXX----XXXXXXXXXXXXXXXXXXXXXXXXX--XXXXXXXXXXXXXXXXXXXXXX--------------------ooo----------rk---XXXXXXXXXXXXXXXXXXXX
-------------XXXXXXXXXX-r--r----XXXXXXXXXXXXXXXXXXXXXXXXXXXXXXXXXXXXXXXXXXXXXXXXXXXXXXXXX----XXXXXXXXXXXXXXXXXXXXXXXXX--XXXXXXXXXXXXXXXXXXXXXX-------XXXXXXXXX--yk--Kk----XXXXXXXXXXXXXXXXXXXXXXXXXXXXXX
XXXXXXXXXXXXXXXXXXXXXXXXXXXXXXXXXXXXXXXXXXXXXXXXXXXXXXXXXXXXXXXXXXXXXXXXXXXXXXXXXXXXXXXXXXXXXXXXXXXXXXXXXXXXXXXXXXXXXXXXXXXXXXXXXXXXXXXXXXXXXXXXXXXXXXXXXXXXXXXXXXXXXXXXXXXXXXXXXXXXXXXXXXXXXXXXXXXXXXXX

