--------------------------------------------------------------------------------------------------------------------------------------------------------------------------------------------------------
--------------------------------------------------------------------------------------------------------------------------------------------------------------------------------------------------------
--------------------------------------------------------------------------------------------------------------------------------------------------------------------------------------------------------
--------------------------------------------------------------------------------------------------------------------------------------------------------------------------------------------------------
--------------------------------------------------------------------------------------------------------------------------------------------------------------------------------------------------------
--------------------------------------------------------------------------------------------------------------------------------------------------------------------------------------------------------
--------------------------------------------------------------------------------------------------------------------------------------------------------------------------------------------------------
--------------------------------------------------------------------------------------------------------------------------------------------------------------------------------------------------------
--------------------------------------------------------------------------------------------------------------------------------------------------------------------------------------------------------
--------------------------------------------------------------------------------------------------------------------------------------------------------------------------------------------------------
--------------------------------------------------------------------------------------------------------------------------------------------------------------------------------------------------------
--------------------------------------------------------------------------------------------------------------------------------------------------------------------------------------------------------
---------------------------------Soo---------------------------------------------------------------------------------------------------------------------------------------------------SoSo-------------
-------------------------------------------------------------------------------------------------------------------------------oSooS-----------------------oSo-------------SSSS-------------------------
-------------------------ooo---oooo----------------------ooSoS----------ooooS---------------------------------------------------------------------------------------------------------------------------
---------------------------------k-k--------------ooo--------------------------------------------ooo-------oSoo-----------------ooooooo-----------oo--------ooooo----------ooooo------r--Y--------------
------------------------------XXXXXXXXX----XXXXX-----------ooooo--------oooooo----------------------------------------Y--XXXXX-------Kg----------r---------GkK-Y-----------r-r---Y-XXXXXXXXX-r-y--------
XXXXXXXXXXXXXXX------------k--XXXXXXXXX----XXXXX-oooo-----------k-----R---yy-k----------oo------ooo------oooooo----XXXXXXXXXXXXXXXXXXXXXXX------XXXXXXXX--XXXXXXXX----XXXXXXXXXXXXXXXXXXXXXXXXXXXX--XXXX
XXXXXXXXXXXXXXXXXXXX----XXXXXXXXXXXXXXXXXXXXXXXX-Yr----XXXXXXXXXXX--XXXXXXXXXXXXXXX--------XXXX--y-ry-XX-----g-----XXXXXXXXXXXXXXXXXXXXXXX--Yk--XXXXXXXXXXXXXXXXXXXXXXXXXXXXXXXXXXXXXXXXXXXXXXXXXXXXXXXX
XXXXXXXXXXXXXXXXXXXXXXXXXXXXXXXXXXXXXXXXXXXXXXXXXXXXXXXXXXXXXXXXXXXXXXXXXXXXXXXXXXXXXXXXXXXXXXXXXXXXXXXXXXXXXXXXXXXXXXXXXXXXXXXXXXXXXXXXXXXXXXXXXXXXXXXXXXXXXXXXXXXXXXXXXXXXXXXXXXXXXXXXXXXXXXXXXXXXXXXX

