--------------------------------------------------------------------------------------------------------------------------------------------------------------------------------------------------------
--------------------------------------------------------------------------------------------------------------------------------------------------------------------------------------------------------
--------------------------------------------------------------------------------------------------------------------------------------------------------------------------------------------------------
--------------------------------------------------------------------------------------------------------------------------------------------------------------------------------------------------------
--------------------------------------------------------------------------------------------------------------------------------------------------------------------------------------------------------
--------------------------------------------------------------------------------------------------------------------------------------------------------------------------------------------------------
--------------------------------------------------------------------------------------------------------------------------------------------------------------------------------------------------------
--------------------------------------------------------------------------------------------------------------------------------------------------------------------------------------------------------
--------------------------------------------------------------------------------------------------------------------------------------------------------------------------------------------------------
--------------------------------------------------------------------------------------------------------------------------------------------------------------------------------------------------------
--------------------------------------------------------------------------------------------------------------------------------------------------------------------------------------------------------
--------------------------------------------------------------------------------------------------------------------------------------------------------------------------------------------------------
--------------------------------------------------------------------------------------------------oooo--------------------------------------------------------------------------------------------------
----------------------------------------------------------------------------------------ooo---------------------------oooSo-----------------------------------------------------------------------------
---------------------------------ooSS-----------------------------oooo---------------------------oooooooo-----------------------------------------------------------------------------------------------
-------------oSoo---------------------------------------------------------ooo------------oo------y----g----------oo------oo----------------------------ooS------------oSoSo------------ooooo------------
---------------------------XXXXX-----------oo-------oooo----XX-------ooo---y-r---------yK-R-XXXXXXXXXXXXXX----g----r--K-rgg----------------XXXX-----------------XX---------------------Gg--R-----------X
-------------ooooo--XXXX---XXXXX-k---r----R-grY----kR----XXXXX-----r-k---XXXXXXXXXXXXXXXXXXXXXXXXXXXXXXXXX---XXXXXXXXXXXXXXXXXX------ooooo-XXXXXXXX-ooooo----XXXXX---oooo--------XXXXXXXXXXXX--oooo----X
XXXXXXXXXXXX------r-XXXX---XXXXXXXXXXXXXXXXXXXXXXXXXXXXXXXXXXX---XXXXXXXXXXXXXXXXXXXXXXXXXXXXXXXXXXXXXXXXXXXXXXXXXXXXXXXXXXXXXX--------y---XXXXXXXX-k----R---XXXXX--K-r--Y-------XXXXXXXXXXXX--y-g-Y-K-X
XXXXXXXXXXXXXXXXXXXXXXXXXXXXXXXXXXXXXXXXXXXXXXXXXXXXXXXXXXXXXXXXXXXXXXXXXXXXXXXXXXXXXXXXXXXXXXXXXXXXXXXXXXXXXXXXXXXXXXXXXXXXXXXXXXXXXXXXXXXXXXXXXXXXXXXXXXXXXXXXXXXXXXXXXXXXXXXXXXXXXXXXXXXXXXXXXXXXXXXX

