--------------------------------------------------------------------------------------------------------------------------------------------------------------------------------------------------------
--------------------------------------------------------------------------------------------------------------------------------------------------------------------------------------------------------
--------------------------------------------------------------------------------------------------------------------------------------------------------------------------------------------------------
--------------------------------------------------------------------------------------------------------------------------------------------------------------------------------------------------------
--------------------------------------------------------------------------------------------------------------------------------------------------------------------------------------------------------
--------------------------------------------------------------------------------------------------------------------------------------------------------------------------------------------------------
--------------------------------------------------------------------------------------------------------------------------------------------------------------------------------------------------------
--------------------------------------------------------------------------------------------------------------------------------------------------------------------------------------------------------
--------------------------------------------------------------------------------------------------------------------------------------------------------------------------------------------------------
--------------------------------------------------------------------------------------------------------------------------------------------------------------------------------------------------------
--------------------------------------------------------------------------------------------------------------------------------------------------------------------------------------------------------
--------------------------------------------------------------------------------------------------------------------------------------------------------------------------------------------------------
--------------------------SSSS------------SooS----------------------------------------------------------------------------------------------------------------------------------------------------------
-----------------ooo--------------------------------SoooSo--------------------------------------------------------------------------------------------------------SSooo---SSSSSS------------------------
--------------------------ooo-------------ooo--------------------------------oooo-------------------------------------------------Sooo---------------------------------------------------------ooSo-----
-----------------------k---gYkY-----------G-kK-------ooooo---oooooSooo--------------------------------------------------oooo--------------------------oooS------oooooo---ooooooooo----------------------
----------------Kk----XXXXXXXXXX--oo---XXXXXXXXXX-----r---y-------------------ooo--------oooo----oo------------------------------oooooo------gR------------------k--------y---ykg--XX---------ooo-------
---------------XXXXXXXXXXXXXXXXX-----Y-XXXXXXXXXXXXXXXXXXXXX-ooooooooo--------R-----XXXX-r--Y-g---r-----------ooo---XX-ooooo------R--Gkkk-XXXXXXXXX----oooo---XXXXXXXXXXXXXXXXXXXXXXX--------y-g--k--XXX
XXXXXXXXXXXXXXXXXXXXXXXXXXXXXXXXXXXXXXXXXXXXXXXXXXXXXXXXXXXX----r--GYy------XXXXXXXXXXXXXXXXXXXXXXXXXXXXXX-------R--XX--ky-----XXXXXXXXXXXXXXXXXXXX-----k--r--XXXXXXXXXXXXXXXXXXXXXXX-k--y--XXXXXXXXXXXX
XXXXXXXXXXXXXXXXXXXXXXXXXXXXXXXXXXXXXXXXXXXXXXXXXXXXXXXXXXXXXXXXXXXXXXXXXXXXXXXXXXXXXXXXXXXXXXXXXXXXXXXXXXXXXXXXXXXXXXXXXXXXXXXXXXXXXXXXXXXXXXXXXXXXXXXXXXXXXXXXXXXXXXXXXXXXXXXXXXXXXXXXXXXXXXXXXXXXXXXX

