--------------------------------------------------------------------------------------------------------------------------------------------------------------------------------------------------------
--------------------------------------------------------------------------------------------------------------------------------------------------------------------------------------------------------
--------------------------------------------------------------------------------------------------------------------------------------------------------------------------------------------------------
--------------------------------------------------------------------------------------------------------------------------------------------------------------------------------------------------------
--------------------------------------------------------------------------------------------------------------------------------------------------------------------------------------------------------
--------------------------------------------------------------------------------------------------------------------------------------------------------------------------------------------------------
--------------------------------------------------------------------------------------------------------------------------------------------------------------------------------------------------------
--------------------------------------------------------------------------------------------------------------------------------------------------------------------------------------------------------
--------------------------------------------------------------------------------------------------------------------------------------------------------------------------------------------------------
--------------------------------------------------------------------------------------------------------------------------------------------------------------------------------------------------------
--------------------------------------------------------------------------------------------------------------------------------------------------------------------------------------------------------
--------------------------------------------------------------------------------------------------------------------------------------------------------------------------------------------------------
-----------------------------------------------------------------Soo------------------------------------------------------------------------------------------------------------------------------------
------------------------------------SoSo---------------------------------------------------------------oSo---ooSo-------------------------------------------------------------------------ooSSo---SSoS--
-----------------------------ooo--------------------------------ooooo-------------------------------------------------------------------------------------------------------------oooooo----------------
------------------------------------ooo-----------oooo----------k---r----------------------------------ooo------------------oSS-------------------Sooooo---------------k---------Y-grk-----------ooo----
-----------------------------ooo---------K---------------------XXXXXXX--------K--g-------------XXXX--k--yg--y--gK------------------XXXXX-----------------------------XXXXXX-----XXXXXXXXX---yK---rK-----
---------------ooooo--XXXXXX------XXXXXXXXX-----ooooooo---K--g-XXXXXXX-------XXXXXXXXXXXXXXXXXXXXXXXXXXXXXXXXXXXXX----------ooooo--XXXXX-----XXX-oooooooo------------XXXXXX-----XXXXXXXXXXXXXXXXXXXXXXXX
XXXXXXXXXXXX-y-----K--XXXXXXXXXXXXXXXXXXXXX-----y---y---XXXXXXXXXXXXXXXXXXXXXXXXXXXXXXXXXXXXXXXXXXXXXXXXXXXXXXXXXX---------------Y-XXXXX-----XXX-k----gyG--y-G---XXXXXXXXXX-----XXXXXXXXXXXXXXXXXXXXXXXX
XXXXXXXXXXXXXXXXXXXXXXXXXXXXXXXXXXXXXXXXXXXXXXXXXXXXXXXXXXXXXXXXXXXXXXXXXXXXXXXXXXXXXXXXXXXXXXXXXXXXXXXXXXXXXXXXXXXXXXXXXXXXXXXXXXXXXXXXXXXXXXXXXXXXXXXXXXXXXXXXXXXXXXXXXXXXXXXXXXXXXXXXXXXXXXXXXXXXXXXX

