--------------------------------------------------------------------------------------------------------------------------------------------------------------------------------------------------------
--------------------------------------------------------------------------------------------------------------------------------------------------------------------------------------------------------
--------------------------------------------------------------------------------------------------------------------------------------------------------------------------------------------------------
--------------------------------------------------------------------------------------------------------------------------------------------------------------------------------------------------------
--------------------------------------------------------------------------------------------------------------------------------------------------------------------------------------------------------
--------------------------------------------------------------------------------------------------------------------------------------------------------------------------------------------------------
--------------------------------------------------------------------------------------------------------------------------------------------------------------------------------------------------------
--------------------------------------------------------------------------------------------------------------------------------------------------------------------------------------------------------
--------------------------------------------------------------------------------------------------------------------------------------------------------------------------------------------------------
--------------------------------------------------------------------------------------------------------------------------------------------------------------------------------------------------------
--------------------------------------------------------------------------------------------------------------------------------------------------------------------------------------------------------
--------------------------------------------------------------------------------------------------------------------------------------------------------------------------------------------------------
-----------------------------------------------------------------------------------------------------------------------------------------------------SSSo-----------ooSooo------------------ooSo--------
----------------------------------------------------------------------------------ooSoooo--------------------------SoS----------------------------------------------------------------------------------
--------------oo-----------------------------------------------------------------------------------------------------------------------------------ooooooo-----------ooooooo----------------------------
--------------Kg-------------oooo--------ooS---------------ooooo------------------oooo-------------SoS-------------ooooo----------------oooo-------y----Y------------y-r---------ooo-------kR--g---Soo--
XXXXXXXXXXXXXXXXXXXX---------K-----------------------XXXXX-----------------------------r----------------------XXX-r---G-g----oooo----------------XXXXXXXXXXX-------XXXXXXXXXXX---g---XXXXXXXXXXXX-------
XXXXXXXXXXXXXXXXXXXX-------XXXXXXX------ooooo--------XXXXX--ooooooo-XXXXXX-ooo---XXXXXXXXX------oooooooo------XXXXXXXXXXXX--G----r-----oo--------XXXXXXXXXXXXX-----XXXXXXXXXXXXXXXXXXXXXXXXXXXXXX-------
XXXXXXXXXXXXXXXXXXXX---XXXXXXXXXXXXXXX-K--gk---------XXXXX--k---y-R-XXXXXX-------XXXXXXXXXXXXXX--yykKyy-------XXXXXXXXXXXXXXXXXXXXXX---R-----XXXXXXXXXXXXXXXXXXXXXXXXXXXXXXXXXXXXXXXXXXXXXXXXXXXX--K--G-
XXXXXXXXXXXXXXXXXXXXXXXXXXXXXXXXXXXXXXXXXXXXXXXXXXXXXXXXXXXXXXXXXXXXXXXXXXXXXXXXXXXXXXXXXXXXXXXXXXXXXXXXXXXXXXXXXXXXXXXXXXXXXXXXXXXXXXXXXXXXXXXXXXXXXXXXXXXXXXXXXXXXXXXXXXXXXXXXXXXXXXXXXXXXXXXXXXXXXXXX

