--------------------------------------------------------------------------------------------------------------------------------------------------------------------------------------------------------
--------------------------------------------------------------------------------------------------------------------------------------------------------------------------------------------------------
--------------------------------------------------------------------------------------------------------------------------------------------------------------------------------------------------------
--------------------------------------------------------------------------------------------------------------------------------------------------------------------------------------------------------
--------------------------------------------------------------------------------------------------------------------------------------------------------------------------------------------------------
--------------------------------------------------------------------------------------------------------------------------------------------------------------------------------------------------------
--------------------------------------------------------------------------------------------------------------------------------------------------------------------------------------------------------
--------------------------------------------------------------------------------------------------------------------------------------------------------------------------------------------------------
--------------------------------------------------------------------------------------------------------------------------------------------------------------------------------------------------------
--------------------------------------------------------------------------------------------------------------------------------------------------------------------------------------------------------
--------------------------------------------------------------------------------------------------------------------------------------------------------------------------------------------------------
--------------------------------------------------------------------------------------------------------------------------------------------------------------------------------------------------------
-------------------------------------------------------Soo-------------oooooo---------------------------------------------------------------------------------------------------------------------------
-----------oooo------------------------------------------------------------------ooSoSoS----------------------------------------------------------------------------------------------------------oooo--
---------------------------------ooooo--------ooSooo--oooo----------------oo------------------SSS-------ooSSo-------------------*-------------------------------oo-------------------SSSoSoS------------
-----------ooooo----------------k-k--G----------------Y---k------------g---K-y----ooooooo---------------------------------------*--------------------------------y--r----------------------------ooo----
XXXXXXXXXX---kG--g-------R-----XXXXXXXX-------oooo---XXXXXXXXXXX------XXXXXXXXX-Y---K-r-g--oooooo-------oooo------------------XXXXXX---XX-----------Tt--------XXXXXXXX------Tt-------ooooo--------k-y---
XXXXXXXXXXXXXXXXXXX----XXXXXXXXXXXXXXXX-----------k--XXXXXXXXXXX-ooo--XXXXXXXXXXXXXXXXXXXX--gK----g-----y--g------------------XXXXXXXXXXXXXX----Tt--Tt---XXXXXXXXXXXXX---Tt-Tt-Tt-----gk-Kr---XXXXXXXXX-
XXXXXXXXXXXXXXXXXXX----XXXXXXXXXXXXXXXXXXXXXXXXXXXXXXXXXXXXXXXXX----R-XXXXXXXXXXXXXXXXXXXXXXXXXXXXXX--XXXXXXXXXXXXXX-----g----XXXXXXXXXXXXXXXXX-Tt--Tt---XXXXXXXXXXXXX---Tt-Tt-Tt--XXXXXXXXXXXXXXXXXXXX-
XXXXXXXXXXXXXXXXXXXXXXXXXXXXXXXXXXXXXXXXXXXXXXXXXXXXXXXXXXXXXXXXXXXXXXXXXXXXXXXXXXXXXXXXXXXXXXXXXXXXXXXXXXXXXXXXXXXXXXXXXXXXXXXXXXXXXXXXXXXXXXXXXXXXXXXXXXXXXXXXXXXXXXXXXXXXXXXXXXXXXXXXXXXXXXXXXXXXXXXX

