--------------------------------------------------------------------------------------------------------------------------------------------------------------------------------------------------------
--------------------------------------------------------------------------------------------------------------------------------------------------------------------------------------------------------
--------------------------------------------------------------------------------------------------------------------------------------------------------------------------------------------------------
--------------------------------------------------------------------------------------------------------------------------------------------------------------------------------------------------------
--------------------------------------------------------------------------------------------------------------------------------------------------------------------------------------------------------
--------------------------------------------------------------------------------------------------------------------------------------------------------------------------------------------------------
--------------------------------------------------------------------------------------------------------------------------------------------------------------------------------------------------------
--------------------------------------------------------------------------------------------------------------------------------------------------------------------------------------------------------
--------------------------------------------------------------------------------------------------------------------------------------------------------------------------------------------------------
--------------------------------------------------------------------------------------------------------------------------------------------------------------------------------------------------------
--------------------------------------------------------------------------------------------------------------------------------------------------------------------------------------------------------
--------------------------------------------------------------------------------------------------------------------------------------------------------------------------------------------------------
-----------------------------------------------------------------------------------------------------------------------------------------------------------------------oooooSSo-------------------------
--------------------------------------------------------------------------------------------------------------------------------------------------------------------------------------------------------
--------------SoSo-----ooo-------------------------------------------------------ooSooo-----------------------------------------------------------------------------------oooooo------------------------
------------------------------oSooo----------ooo---oooS---oooooSoo---------------------------oSSSooo---oSS--------------oSoooS--------------------ooSS-----------------y---------------------ooSSoSoo---
------------ooo-------oo----------------------------------------------------------ooooooo-------------------XXXXXX------------------------oo------------XXXXX---------XXXXXXXXXXXXXXXXXXXXX-------------
XXXXXXXXXX---R--gy--k-----r--ooooooooo-----oooo---ooo-----ooooooo---------ooooo--r-k----g-----ooooo---------XXXXXX--------ooooo-----------g------oooooo-XXXXX---------XXXXXXXXXXXXXXXXXXXXX-ooooooooo---
XXXXXXXXXXXXXXXXXXXXXXXXXXXX-g---gK----XXX---k-k----------Y-r-yk----r--G------r-XXXXXXXXXX-K-YK---gk---yy---XXXXXXXXXXX----------XXXXX--XXXXXX--gyGk--r-XXXXX---------XXXXXXXXXXXXXXXXXXXXX-k--Kg-k-----
XXXXXXXXXXXXXXXXXXXXXXXXXXXXXXXXXXXXXXXXXXXXXXXXXXXXXXXXXXXXXXXXXXXXXXXXXXXXXXXXXXXXXXXXXXXXXXXXXXXXXXXXXXXXXXXXXXXXXXXXXXXXXXXXXXXXXXXXXXXXXXXXXXXXXXXXXXXXXXXXXXXXXXXXXXXXXXXXXXXXXXXXXXXXXXXXXXXXXXXX

