--------------------------------------------------------------------------------------------------------------------------------------------------------------------------------------------------------
--------------------------------------------------------------------------------------------------------------------------------------------------------------------------------------------------------
--------------------------------------------------------------------------------------------------------------------------------------------------------------------------------------------------------
--------------------------------------------------------------------------------------------------------------------------------------------------------------------------------------------------------
--------------------------------------------------------------------------------------------------------------------------------------------------------------------------------------------------------
--------------------------------------------------------------------------------------------------------------------------------------------------------------------------------------------------------
--------------------------------------------------------------------------------------------------------------------------------------------------------------------------------------------------------
--------------------------------------------------------------------------------------------------------------------------------------------------------------------------------------------------------
--------------------------------------------------------------------------------------------------------------------------------------------------------------------------------------------------------
--------------------------------------------------------------------------------------------------------------------------------------------------------------------------------------------------------
--------------------------------------------------------------------------------------------------------------------------------------------------------------------------------------------------------
--------------------------------------------------------------------------------------------------------------------------------------------------------------------------------------------------------
-------------------oSooSS-------------------------------------------------------------------------------ooSoooo-----------------------------------------------------------------SoSSSooo----------------
-------------------------------------------------------------ooSSSSSSo-----------------Soo----------------------------------------------------------------------------oooS------------------------------
------------------ooooooo---oSSoo------Soo------------------------------------------------------------oooooooo------------------------oooooo------------------------------------oooooooo--------oooS----
--------------------y---Y--------------------------------------oooo-------------ooo-----ooo-----------y-----r-g----------------------------------------oSo--------------oo-------y---K-----ooo----------
-----------------XXXXXXXXXX---oooo----oooo-----------XXX----------k--G----XXX---------r--------ooo---XXXXXXXXXXX------------------------ooo----ooo---------------------r-K----XXXXXXXXXXX--g----ooooooo-
XXXXXXXXXX---XXXXXXXXXXXXXX------r------r--k---------XXXXXXXXXXXXXXXXXX---XXXXXXXXXXXXXXXXXXX---yG---XXXXXXXXXXXXX---------------------y--k---yY-------oooooo--------XXXXXXX--XXXXXXXXXXXXXXXXX----K----
XXXXXXXXXX---XXXXXXXXXXXXXXXXXXXXXXXXXXXXXXXXXXXXXXXXXXXXXXXXXXXXXXXXXX---XXXXXXXXXXXXXXXXXXXXXXXXX--XXXXXXXXXXXXXXXXXX-----XXXX----XXXXXXXXXXXXXXX-rg-r-gK---XXXXXXXXXXXXXXXXXXXXXXXXXXXXXXXXXXXXXXXXXX
XXXXXXXXXXXXXXXXXXXXXXXXXXXXXXXXXXXXXXXXXXXXXXXXXXXXXXXXXXXXXXXXXXXXXXXXXXXXXXXXXXXXXXXXXXXXXXXXXXXXXXXXXXXXXXXXXXXXXXXXXXXXXXXXXXXXXXXXXXXXXXXXXXXXXXXXXXXXXXXXXXXXXXXXXXXXXXXXXXXXXXXXXXXXXXXXXXXXXXXX

