--------------------------------------------------------------------------------------------------------------------------------------------------------------------------------------------------------
--------------------------------------------------------------------------------------------------------------------------------------------------------------------------------------------------------
--------------------------------------------------------------------------------------------------------------------------------------------------------------------------------------------------------
--------------------------------------------------------------------------------------------------------------------------------------------------------------------------------------------------------
--------------------------------------------------------------------------------------------------------------------------------------------------------------------------------------------------------
--------------------------------------------------------------------------------------------------------------------------------------------------------------------------------------------------------
--------------------------------------------------------------------------------------------------------------------------------------------------------------------------------------------------------
--------------------------------------------------------------------------------------------------------------------------------------------------------------------------------------------------------
--------------------------------------------------------------------------------------------------------------------------------------------------------------------------------------------------------
--------------------------------------------------------------------------------------------------------------------------------------------------------------------------------------------------------
--------------------------------------------------------------------------------------------------------------------------------------------------------------------------------------------------------
--------------------------------------------------------------------------------------------------------------------------------------------------------------------------------------------------------
----------------------------------------------------------------SooSo----oSSoo-----------------------------------------------oooSS----------------------------------------------------------------------
-------------------------------------------------------------------------------------------------oooo-------------------------------------------------------------------------------oooSo---------------
------------------ooo------------------oooSoo---------oooo---oooooo-----oooo-------oSS------------------SoooS----------------oooooo---------------oSoSSo------------------oooSS--------------oSSo-------
--------------------Y---------------------------------k-R-----k---K-R---G---K-------------------------------------ooo--------kg-R----------oo------------------------------------------ooo--------------
----------------XXXXXXX---oooo-------oooooooo-XXXXXXXXXXXXXXXXXXXXXXXXXXXXXXXXXX---ooooo-----------------oo-----g----------XXXXXXXXX-----g--r-------ooooo---------oooo-----oooooo-----R---g---ooooo--XXX
----------------XXXXXXX-rR------------K-y---k-XXXXXXXXXXXXXXXXXXXXXXXXXXXXXXXXXX-YG----------oo-XXXXXX--k-k--r-XXXXXXX-----XXXXXXXXXXXXXXXXXXXXXX-y---y---XXXXXX---yk--------Ky----XXXXXXXXX----gG---XXX
XXXXXXXXXXXXX---XXXXXXXXXXXXXXX----XXXXXXXXXXXXXXXXXXXXXXXXXXXXXXXXXXXXXXXXXXXXXXXXXXXXXX--Y-r--XXXXXXXXXXXXXXXXXXXXXXXXXXXXXXXXXXXXXXXXXXXXXXXXXXXXXXXXXXXXXXXXXXXXXXXXXXXXXXXXXXXXXXXXXXXXXXXXXXXXXXXX
XXXXXXXXXXXXXXXXXXXXXXXXXXXXXXXXXXXXXXXXXXXXXXXXXXXXXXXXXXXXXXXXXXXXXXXXXXXXXXXXXXXXXXXXXXXXXXXXXXXXXXXXXXXXXXXXXXXXXXXXXXXXXXXXXXXXXXXXXXXXXXXXXXXXXXXXXXXXXXXXXXXXXXXXXXXXXXXXXXXXXXXXXXXXXXXXXXXXXXXX

