--------------------------------------------------------------------------------------------------------------------------------------------------------------------------------------------------------
--------------------------------------------------------------------------------------------------------------------------------------------------------------------------------------------------------
--------------------------------------------------------------------------------------------------------------------------------------------------------------------------------------------------------
--------------------------------------------------------------------------------------------------------------------------------------------------------------------------------------------------------
--------------------------------------------------------------------------------------------------------------------------------------------------------------------------------------------------------
--------------------------------------------------------------------------------------------------------------------------------------------------------------------------------------------------------
--------------------------------------------------------------------------------------------------------------------------------------------------------------------------------------------------------
--------------------------------------------------------------------------------------------------------------------------------------------------------------------------------------------------------
--------------------------------------------------------------------------------------------------------------------------------------------------------------------------------------------------------
--------------------------------------------------------------------------------------------------------------------------------------------------------------------------------------------------------
--------------------------------------------------------------------------------------------------------------------------------------------------------------------------------------------------------
--------------------------------------------------------------------------------------------------------------------------------------------------------------------------------------------------------
----------------------------------------------------------------------------------------------------------------------------------------------------------------------oooooSoo--------------------------
---------------------Soo-------ooooS-------------------------------ooo-------------------------------------------------ooo-------oooooSSo---------oooSoo---SSoo-----------------------------------------
-----------------------------------------ooSoSo------------------------------ooo----------------oooo-----------ooo----------------------------------------------------ooooo------oooo-------------------
--------------------------------ooooo---------------------SSoSooo-----------------------ooSSoo-------------------------ooooo------oooooooo-------oooo------ooo--------G-----y-----r---------------------
----------------------Gy----------k-----ooooooo---XXXXXX-------------y-r------------oo-----------oooooo-XXX----oo-----r--------------------XXX---rKy---R----G---R-XXXXXXXXXXXXXXXXXXXX-----XXXXX-oooooo-
XXXXXXXXXXX--------XXXXXX---XXXXXXXXXXX-----K---y-XXXXXX--ooooooo-XXXXXXX-----y---kryg----------------y-XXX-y---y-r-XXXXXXXXX---XXXXXXXXXXXXXXXXXXXXXXXXXXXXXXXXXXXXXXXXXXXXXXXXXXXXXX-----XXXXX--y--yk-
XXXXXXXXXXX----XXXXXXXXXX---XXXXXXXXXXXXXXXXXXXXXXXXXXXX-----g----XXXXXXXXXXXXXXXXXXXXX-----g--XXXXXXXXXXXXXXXXXXXXXXXXXXXXXXXXXXXXXXXXXXXXXXXXXXXXXXXXXXXXXXXXXXXXXXXXXXXXXXXXXXXXXXXXXXXXXXXXXXXXXXXXX
XXXXXXXXXXXXXXXXXXXXXXXXXXXXXXXXXXXXXXXXXXXXXXXXXXXXXXXXXXXXXXXXXXXXXXXXXXXXXXXXXXXXXXXXXXXXXXXXXXXXXXXXXXXXXXXXXXXXXXXXXXXXXXXXXXXXXXXXXXXXXXXXXXXXXXXXXXXXXXXXXXXXXXXXXXXXXXXXXXXXXXXXXXXXXXXXXXXXXXXX

