--------------------------------------------------------------------------------------------------------------------------------------------------------------------------------------------------------
--------------------------------------------------------------------------------------------------------------------------------------------------------------------------------------------------------
--------------------------------------------------------------------------------------------------------------------------------------------------------------------------------------------------------
--------------------------------------------------------------------------------------------------------------------------------------------------------------------------------------------------------
--------------------------------------------------------------------------------------------------------------------------------------------------------------------------------------------------------
--------------------------------------------------------------------------------------------------------------------------------------------------------------------------------------------------------
--------------------------------------------------------------------------------------------------------------------------------------------------------------------------------------------------------
--------------------------------------------------------------------------------------------------------------------------------------------------------------------------------------------------------
--------------------------------------------------------------------------------------------------------------------------------------------------------------------------------------------------------
--------------------------------------------------------------------------------------------------------------------------------------------------------------------------------------------------------
--------------------------------------------------------------------------------------------------------------------------------------------------------------------------------------------------------
--------------------------------------------------------------------------------------------------------------------------------------------------------------------------------------------------------
-----------------------------------------------------------------------------------------------------------ooSooSoS-------------------------------------------------------------------------------------
-------------------------------------------SSoSo--------------------------------------------------------------------------------------------------------------------------------------------------------
-------------------------oooooS---------------------------------------------------------SSoSo--------------oooooo------------------------Sooo---------------------oSSSoSooo----------oooS---------------
----------------------------------ooooo------ooo----------oo--------------ooooSo-----------------------------k--Rkkg--ooS------oSoooo-------------------------------------------------------------------
-----------------------ooooooooo---g-y-------------------yy-g-k---oooooo---------------oooo------------XXXXXXXXXXXXXX------------------ooooooooo------------------ooooooo------------oooo---------------
XXXXXXXXXXXXX-----------k---R--g-XXXXXXXXXXXXXXXX--Y---XXXXXXXXX-------------ooo-----Yy---rrG-----ooo--XXXXXXXXXXXXXX-----------oooo----g----g-------k------k--g--RYg--r--y-XXXX------r-----------------
XXXXXXXXXXXXX---------XXXXXXXXXXXXXXXXXXXXXXXXXXXXXXXXXXXXXXXXXXXXXXXXXXX---Y-------XXXXXXXXXX----y--k-XXXXXXXXXXXXXX-----k-------r---XXXXXXXXXXXXXXXXXX---XXXXXXXXXXXXXXXXXXXXX--XXXXXXXXXXX-r-R--XXXXX
XXXXXXXXXXXXXXXXXXXXXXXXXXXXXXXXXXXXXXXXXXXXXXXXXXXXXXXXXXXXXXXXXXXXXXXXXXXXXXXXXXXXXXXXXXXXXXXXXXXXXXXXXXXXXXXXXXXXXXXXXXXXXXXXXXXXXXXXXXXXXXXXXXXXXXXXXXXXXXXXXXXXXXXXXXXXXXXXXXXXXXXXXXXXXXXXXXXXXXXX

