--------------------------------------------------------------------------------------------------------------------------------------------------------------------------------------------------------
--------------------------------------------------------------------------------------------------------------------------------------------------------------------------------------------------------
--------------------------------------------------------------------------------------------------------------------------------------------------------------------------------------------------------
--------------------------------------------------------------------------------------------------------------------------------------------------------------------------------------------------------
--------------------------------------------------------------------------------------------------------------------------------------------------------------------------------------------------------
--------------------------------------------------------------------------------------------------------------------------------------------------------------------------------------------------------
--------------------------------------------------------------------------------------------------------------------------------------------------------------------------------------------------------
--------------------------------------------------------------------------------------------------------------------------------------------------------------------------------------------------------
--------------------------------------------------------------------------------------------------------------------------------------------------------------------------------------------------------
--------------------------------------------------------------------------------------------------------------------------------------------------------------------------------------------------------
--------------------------------------------------------------------------------------------------------------------------------------------------------------------------------------------------------
--------------------------------------------------------------------------------------------------------------------------------------------------------------------------------------------------------
--------------------------------------------------------------------------------------------------------------------------------------------------------------------------------------------------------
-----------------ooS----------------------------------------------oSSS----------------------------------------------------------------SoS--------------------------------------------------ooo----------
-------------------------------------------------------------------------ooooo-----------SoS--------------oSSo---------------oooo-------------------ooooSSo------------------ooo------------------------
----------------ooo--------------Soo-------oo---------------------oooo---Gr-k----------------------ooS-------------------------------oooooo--------------------oo--------------------------oooo---------
-----------------rgy----oo------------------------------------------Yyg-XXXXXXX--------------------------oooooo-------------XXXXXXXX----k--y--------ooooooo----gk--y---oo----------------y-k------------
XXXXXXXXXXXXXXXXXXXXXX---------ooo------XXXXXX--XXX-oooo-----r---XXXXXXXXXXXXXX-ooo-----Ggr---------ooo----yG-y-Y-XXXXX-----XXXXXXXXXXXXXXXXX--oo-----G---y---XXXXXXX---G---------------XXXXXXXXXX----XX
XXXXXXXXXXXXXXXXXXXXXXXXXXXXX--G-----XXXXXXXXXXXXXX---k----XXXXXXXXXXXXXXXXXXXX-rGg---XXXXXXXXXX-g-g--g-XXXXXXXXXXXXXXX--XXXXXXXXXXXXXXXXXXXX-R----XXXXXXXXXXXXXXXXXXXXXXXXXXXXXX--g----XXXXXXXXXXXXXXXX
XXXXXXXXXXXXXXXXXXXXXXXXXXXXXXXXXXXXXXXXXXXXXXXXXXXXXXXXXXXXXXXXXXXXXXXXXXXXXXXXXXXXXXXXXXXXXXXXXXXXXXXXXXXXXXXXXXXXXXXXXXXXXXXXXXXXXXXXXXXXXXXXXXXXXXXXXXXXXXXXXXXXXXXXXXXXXXXXXXXXXXXXXXXXXXXXXXXXXXXX

