--------------------------------------------------------------------------------------------------------------------------------------------------------------------------------------------------------
--------------------------------------------------------------------------------------------------------------------------------------------------------------------------------------------------------
--------------------------------------------------------------------------------------------------------------------------------------------------------------------------------------------------------
--------------------------------------------------------------------------------------------------------------------------------------------------------------------------------------------------------
--------------------------------------------------------------------------------------------------------------------------------------------------------------------------------------------------------
--------------------------------------------------------------------------------------------------------------------------------------------------------------------------------------------------------
--------------------------------------------------------------------------------------------------------------------------------------------------------------------------------------------------------
--------------------------------------------------------------------------------------------------------------------------------------------------------------------------------------------------------
--------------------------------------------------------------------------------------------------------------------------------------------------------------------------------------------------------
--------------------------------------------------------------------------------------------------------------------------------------------------------------------------------------------------------
--------------------------------------------------------------------------------------------------------------------------------------------------------------------------------------------------------
--------------------------------------------------------------------------------------------------------------------------------------------------------------------------------------------------------
----------------------------ooo--------------------------------------------------------ooo--------------------------------------------------------------------------------------------------------------
---------------oooo-----------------------------------------------------------------------------------------------------------------------------------oooSS---------------------------------------------
------------------------------------------------------------------------------------------------------------------------------------------------------------------oSoooooSo----ooSo-----SSo-------------
----------------oooooo-------r----------------Soooo--------------ooo-----------------k--r-----------------ooooo----------ooSoo-------------------oo------oo---------------------------------------------
----------XX-----g-g-------XXXXXX--XXXXXXXX------------------------------XXXXX------XXXXXXX---XXXX-----------------XXXX--------------------XXX--r--y---r-----g----ooooooo---------------oo------oooo----
----------XXXXXXXXXXXXX----XXXXXX--XXXXXXXX---oooo--XX-------------oo----XXXXX------XXXXXXX---XXXX---------oooo-XXXXXXX--oooooo------XXX---XXXXXXXXXXXXXXXXXXXXXX-----g--ry--y--y-----kkky-------y--g---
XXXXXXXXXXXXXXXXXXXXXXX----XXXXXX--XXXXXXXX--K--r---XX---XXXXXX----------XXXXXXXXXXXXXXXXXX---XXXX--------------XXXXXXX-----K--k-XXXXXXX---XXXXXXXXXXXXXXXXXXXXXXXXXXXXXXXXXXXXXXXXXXXXXXXXX---XXXXXXXXX
XXXXXXXXXXXXXXXXXXXXXXXXXXXXXXXXXXXXXXXXXXXXXXXXXXXXXXXXXXXXXXXXXXXXXXXXXXXXXXXXXXXXXXXXXXXXXXXXXXXXXXXXXXXXXXXXXXXXXXXXXXXXXXXXXXXXXXXXXXXXXXXXXXXXXXXXXXXXXXXXXXXXXXXXXXXXXXXXXXXXXXXXXXXXXXXXXXXXXXXX

