--------------------------------------------------------------------------------------------------------------------------------------------------------------------------------------------------------
--------------------------------------------------------------------------------------------------------------------------------------------------------------------------------------------------------
--------------------------------------------------------------------------------------------------------------------------------------------------------------------------------------------------------
--------------------------------------------------------------------------------------------------------------------------------------------------------------------------------------------------------
--------------------------------------------------------------------------------------------------------------------------------------------------------------------------------------------------------
--------------------------------------------------------------------------------------------------------------------------------------------------------------------------------------------------------
--------------------------------------------------------------------------------------------------------------------------------------------------------------------------------------------------------
--------------------------------------------------------------------------------------------------------------------------------------------------------------------------------------------------------
--------------------------------------------------------------------------------------------------------------------------------------------------------------------------------------------------------
--------------------------------------------------------------------------------------------------------------------------------------------------------------------------------------------------------
--------------------------------------------------------------------------------------------------------------------------------------------------------------------------------------------------------
--------------------------------------------------------------------------------------------------------------------------------------------------------------------------------------------------------
--------------oooSo--------------------------------------------------------------------------oooSo---------------SSSoSoo----------------------------------------SoS-------------------------------------
--------------------------------------------------oSSooo----------------------------------------------SooSo-------------------------------------------------------------------------------------oSo-----
--------------ooooooo--ooSoSS---------oSoo---------------------------------------------------oooo----------------oooooo----------------------------------------ooooo---------------------Soo------------
------------y--y----y----------------------------ooooo--------------------------ooo----------K-Y------ooooo-------Y---------ooo------------------ooSo----------KG---------ooo------------------oooo-----
-----------XXXXXXXXXXX--oooo----------oooo--------R-----g-XXXXX---------------------------XXXXXXXXXX-r---k-----XXXXXXXXXX-------------------XX---------------XXXXXXXXXX-K-----r---XXXXX--oo----gkg-y----
-----------XXXXXXXXXXX--y-k-gy-----------K-----XXXXXXXXXXXXXXXX----------------------XXXXXXXXXXXXXXXXXXXXXXXXXXXXXXXXXXXX-oooooo----ooooooo-XX--ooo-----yKK--XXXXXXXXXXXXXXXXXXXXXXXXXX---g---XXXXXXXXX-
XXXXXXXXXXXXXXXXXXXXXXXXXXXXXXXXXXXXXXXXXXX----XXXXXXXXXXXXXXXXXXXXX--XXXXXXXX----Ky-XXXXXXXXXXXXXXXXXXXXXXXXXXXXXXXXXXXX--------k--rg---gy-XX--Gk-rK--XXXXXXXXXXXXXXXXXXXXXXXXXXXXXXXXXXXXXXXXXXXXXXXXX
XXXXXXXXXXXXXXXXXXXXXXXXXXXXXXXXXXXXXXXXXXXXXXXXXXXXXXXXXXXXXXXXXXXXXXXXXXXXXXXXXXXXXXXXXXXXXXXXXXXXXXXXXXXXXXXXXXXXXXXXXXXXXXXXXXXXXXXXXXXXXXXXXXXXXXXXXXXXXXXXXXXXXXXXXXXXXXXXXXXXXXXXXXXXXXXXXXXXXXXX

