--------------------------------------------------------------------------------------------------------------------------------------------------------------------------------------------------------
--------------------------------------------------------------------------------------------------------------------------------------------------------------------------------------------------------
--------------------------------------------------------------------------------------------------------------------------------------------------------------------------------------------------------
--------------------------------------------------------------------------------------------------------------------------------------------------------------------------------------------------------
--------------------------------------------------------------------------------------------------------------------------------------------------------------------------------------------------------
--------------------------------------------------------------------------------------------------------------------------------------------------------------------------------------------------------
--------------------------------------------------------------------------------------------------------------------------------------------------------------------------------------------------------
--------------------------------------------------------------------------------------------------------------------------------------------------------------------------------------------------------
--------------------------------------------------------------------------------------------------------------------------------------------------------------------------------------------------------
--------------------------------------------------------------------------------------------------------------------------------------------------------------------------------------------------------
--------------------------------------------------------------------------------------------------------------------------------------------------------------------------------------------------------
--------------------------------------------------------------------------------------------------------------------------------------------------------------------------------------------------------
--------------------------------ooSo-------------------------------------------oooo------------------------------------------------------------------Soooo----------------------------------------------
-------------oSoSo--------------------------------------------------------------------------------------------------------------------------------------------oSSoooSoo----------------ooS--------------
-----------------------oSooSS---oo----oooo-------------------------------------oooooo---oSooooS------------oooSo--------------------------------------oooo----------------------------------------------
-----------ooooo-------------------G---g------oooooo---------------------ooSo--k-R------------------------------------------------SSoSS----------------g---------oooooo---------------oooooo------------
--------------GRKR-----ooooo---XXXXXXXXXXXX-------------XXXXX-----------------XXXXXXXXX-ooooooooo-XXXXX-ooooooo-------XXXXX------------------------XXXXXXXXXX--gy--yR----------------------g-------XXXXX
XXXXXXXXXXXXXXXXXXXX--y---Y--k-XXXXXXXXXXXX---ooo-------XXXXX---ooooo---------XXXXXXXXX----R--r-y-XXXXX---r-y--g------XXXXX--------oooo--XXXXX-----XXXXXXXXXXXXXXXXXXXXX------y---g--XXXXXXXXX-----XXXXX
XXXXXXXXXXXXXXXXXXXXXXXXXXXXXXXXXXXXXXXXXXX-------------XXXXX-rk----k---y--g--XXXXXXXXXXXXXXXXXXXXXXXXXXXXXXXXXXX-----XXXXX-----g--g-----XXXXXXXXXXXXXXXXXXXXXXXXXXXXXXXXXXXXXXXXXXXXXXXXXXXXX-----XXXXX
XXXXXXXXXXXXXXXXXXXXXXXXXXXXXXXXXXXXXXXXXXXXXXXXXXXXXXXXXXXXXXXXXXXXXXXXXXXXXXXXXXXXXXXXXXXXXXXXXXXXXXXXXXXXXXXXXXXXXXXXXXXXXXXXXXXXXXXXXXXXXXXXXXXXXXXXXXXXXXXXXXXXXXXXXXXXXXXXXXXXXXXXXXXXXXXXXXXXXXXX

