--------------------------------------------------------------------------------------------------------------------------------------------------------------------------------------------------------
--------------------------------------------------------------------------------------------------------------------------------------------------------------------------------------------------------
--------------------------------------------------------------------------------------------------------------------------------------------------------------------------------------------------------
--------------------------------------------------------------------------------------------------------------------------------------------------------------------------------------------------------
--------------------------------------------------------------------------------------------------------------------------------------------------------------------------------------------------------
--------------------------------------------------------------------------------------------------------------------------------------------------------------------------------------------------------
--------------------------------------------------------------------------------------------------------------------------------------------------------------------------------------------------------
--------------------------------------------------------------------------------------------------------------------------------------------------------------------------------------------------------
--------------------------------------------------------------------------------------------------------------------------------------------------------------------------------------------------------
--------------------------------------------------------------------------------------------------------------------------------------------------------------------------------------------------------
--------------------------------------------------------------------------------------------------------------------------------------------------------------------------------------------------------
--------------------------------------------------------------------------------------------------------------------------------------------------------------------------------------------------------
--------------------------ooSS----------------------------------------SSS---------------ooSoooo---------------------------------------------------------------------------------------oSooooS-----------
----------------------------------------------------------------------------------------------------ooo-----------------------------------oSooo---------------------------------------------------------
-------------------------oooooo--------------------------------------ooo------------------oooooo-----------------------------------------------------------------------------------------oooo-----------
--------------------oo----kg-------------------oSooooo--------------g----kg---SooSo--------G---G---oooo-----------------------------------ooooo----------------ooooo-------------------R----y-----------
------------------------XXXXXXXX----oo-----XX---------------------XXXXXXXXXX--------XXXXXXXXXXXXX-r-kyR-XX--------XXXXX-------------------G-g-------XXX--Y-Y--------------k------Yg--XXXXXXXXXX---------
XXXXXXXXXXXXXX----XXXXXXXXXXXXXXXX--kr---XXXX-ooooooooo------XXXXXXXXXXXXXXX---ooo--XXXXXXXXXXXXXXXXXXXXXXXX----K-XXXXX-oooo----XXX----XXXXXXXXXXX--XXXXXXXXX----oo----XXXXXXXXXXXXXXXXXXXXXXXX-ooo-----
XXXXXXXXXXXXXXXXXXXXXXXXXXXXXXXXXXXXXXXXXXXXX-----yyY---XXXXXXXXXXXXXXXXXXXX--KY----XXXXXXXXXXXXXXXXXXXXXXXXXXXXXXXXXXX------gr-XXXXXXXXXXXXXXXXXX--XXXXXXXXX-g--yygg--XXXXXXXXXXXXXXXXXXXXXXXX--K-r-XXX
XXXXXXXXXXXXXXXXXXXXXXXXXXXXXXXXXXXXXXXXXXXXXXXXXXXXXXXXXXXXXXXXXXXXXXXXXXXXXXXXXXXXXXXXXXXXXXXXXXXXXXXXXXXXXXXXXXXXXXXXXXXXXXXXXXXXXXXXXXXXXXXXXXXXXXXXXXXXXXXXXXXXXXXXXXXXXXXXXXXXXXXXXXXXXXXXXXXXXXXX

