--------------------------------------------------------------------------------------------------------------------------------------------------------------------------------------------------------
--------------------------------------------------------------------------------------------------------------------------------------------------------------------------------------------------------
--------------------------------------------------------------------------------------------------------------------------------------------------------------------------------------------------------
--------------------------------------------------------------------------------------------------------------------------------------------------------------------------------------------------------
--------------------------------------------------------------------------------------------------------------------------------------------------------------------------------------------------------
--------------------------------------------------------------------------------------------------------------------------------------------------------------------------------------------------------
--------------------------------------------------------------------------------------------------------------------------------------------------------------------------------------------------------
--------------------------------------------------------------------------------------------------------------------------------------------------------------------------------------------------------
--------------------------------------------------------------------------------------------------------------------------------------------------------------------------------------------------------
--------------------------------------------------------------------------------------------------------------------------------------------------------------------------------------------------------
--------------------------------------------------------------------------------------------------------------------------------------------------------------------------------------------------------
--------------------------------------------------------------------------------------------------------------------------------------------------------------------------------------------------------
--------------------------------------------------------------------------------------------------------------------------------------------------------------------------------------------------------
---------------------------------------------ooSSo----------------------------------------------oSo---------------------ooSoo---------------------------------------------------------------------------
-----------------------ooooo--------ooSo-----------------------------------------------ooooo-------------ooo----------------------------------------------------------------ooo---oo----------oooSSSo---
-----------------------k----r-y-------------ooooo----------oooo---------------------------------ooooo-----k---ooSSSoS---oooooooo--ooSoS------------------R-k-y-----------------------y------------------
XXXXXXXXXXXXXX--------XXXXXXXXXX---oooooo------y-r-----XX--yR-K------------XXXX-------ooooo------r--k--XXXXXX-----------KG-Gg-yg------------------------XXXXXXX---------XXXXXXXXXXXXXXXX-------ooooooo--
XXXXXXXXXXXXXX----XXXXXXXXXXXXXX--G-------XXXXXXXXXXXXXXXXXXXXXX-----------XXXX-ooo---r-r--k---XXXXXXXXXXXXXX---oooo---XXXXXXXXXX-ooo----XXXX--------XXXXXXXXXXXXXXXXXXXXXXXXXXXXXXXXXXX--------r--rR---
XXXXXXXXXXXXXXXX--XXXXXXXXXXXXXXXXXXXXXXXXXXXXXXXXXXXXXXXXXXXXXX----K--g-XXXXXX-R-yk-XXXXXXXXXXXXXXXXXXXXXXXX--y--r----XXXXXXXXXX-----gg-XXXX---kKrr-XXXXXXXXXXXXXXXXXXXXXXXXXXXXXXXXXXXXXXXXXXXXXXXXXXX
XXXXXXXXXXXXXXXXXXXXXXXXXXXXXXXXXXXXXXXXXXXXXXXXXXXXXXXXXXXXXXXXXXXXXXXXXXXXXXXXXXXXXXXXXXXXXXXXXXXXXXXXXXXXXXXXXXXXXXXXXXXXXXXXXXXXXXXXXXXXXXXXXXXXXXXXXXXXXXXXXXXXXXXXXXXXXXXXXXXXXXXXXXXXXXXXXXXXXXXX

