--------------------------------------------------------------------------------------------------------------------------------------------------------------------------------------------------------
--------------------------------------------------------------------------------------------------------------------------------------------------------------------------------------------------------
--------------------------------------------------------------------------------------------------------------------------------------------------------------------------------------------------------
--------------------------------------------------------------------------------------------------------------------------------------------------------------------------------------------------------
--------------------------------------------------------------------------------------------------------------------------------------------------------------------------------------------------------
--------------------------------------------------------------------------------------------------------------------------------------------------------------------------------------------------------
--------------------------------------------------------------------------------------------------------------------------------------------------------------------------------------------------------
--------------------------------------------------------------------------------------------------------------------------------------------------------------------------------------------------------
--------------------------------------------------------------------------------------------------------------------------------------------------------------------------------------------------------
--------------------------------------------------------------------------------------------------------------------------------------------------------------------------------------------------------
--------------------------------------------------------------------------------------------------------------------------------------------------------------------------------------------------------
--------------------------------------------------------------------------------------------------------------------------------------------------------------------------------------------------------
-------------------------------------------------------SoSooo-----------------------------------------------------oooS-------------------------------------------------------------ooo------------------
--------------------------------------------------------------------------------------------ooo------------------------------------------------------------ooo------------------------------------------
-----------------------------------------------------ooooooooo-----------------------------------------------------oooooo-----------------------------------------------------------oo------SSoSo-------
--------------------rGrr------------r-k-----oSoSoS---------g-y---ooo--ooSoSo----------------ooo---------------------r--Y---------------oSoo---------------ooooooo-------------------g-g-----------------
-----------XX------XXXXXXXX--------XXXXXX-----------XXXXXXXXXXX-----------------------------Y-------------------XXXXXXXXXX----K---------------------------------------------------XXXXXXX---oooooo------
-----------XX---rR-XXXXXXXX--------XXXXXX---oooo----XXXXXXXXXXXXXXXXX-ooooo----XXXXX-----XXXXXXXX-----ooo-XXXXXXXXXXXXXXXXXXXXXX--------oo---XXXXX---XXXXXXXXXXXXX-oo-------ooo---XXXXXXX----r-KR--XXXXX
-----------XXXXXXXXXXXXXXXX-r-K--XXXXXXXX-r---K---R-XXXXXXXXXXXXXXXXX--g---Gk--XXXXXXXXXXXXXXXXXXXX---r-y-XXXXXXXXXXXXXXXXXXXXXXXXXX---y-----XXXXX---XXXXXXXXXXXXX----------------XXXXXXXXXXXXXXXXXXXXXX
XXXXXXXXXXXXXXXXXXXXXXXXXXXXXXXXXXXXXXXXXXXXXXXXXXXXXXXXXXXXXXXXXXXXXXXXXXXXXXXXXXXXXXXXXXXXXXXXXXXXXXXXXXXXXXXXXXXXXXXXXXXXXXXXXXXXXXXXXXXXXXXXXXXXXXXXXXXXXXXXXXXXXXXXXXXXXXXXXXXXXXXXXXXXXXXXXXXXXXXX

