--------------------------------------------------------------------------------------------------------------------------------------------------------------------------------------------------------
--------------------------------------------------------------------------------------------------------------------------------------------------------------------------------------------------------
--------------------------------------------------------------------------------------------------------------------------------------------------------------------------------------------------------
--------------------------------------------------------------------------------------------------------------------------------------------------------------------------------------------------------
--------------------------------------------------------------------------------------------------------------------------------------------------------------------------------------------------------
--------------------------------------------------------------------------------------------------------------------------------------------------------------------------------------------------------
--------------------------------------------------------------------------------------------------------------------------------------------------------------------------------------------------------
--------------------------------------------------------------------------------------------------------------------------------------------------------------------------------------------------------
--------------------------------------------------------------------------------------------------------------------------------------------------------------------------------------------------------
--------------------------------------------------------------------------------------------------------------------------------------------------------------------------------------------------------
--------------------------------------------------------------------------------------------------------------------------------------------------------------------------------------------------------
--------------------------------------------------------------------------------------------------------------------------------------------------------------------------------------------------------
---------------------------------------------------------SoSo-----------------------------------------------------------------ooo------------------------------------------------------------oSooo------
-------------------------------------------------------------------------------------oSoo---------ooSoSSSS-----------------------------------SooSSoo----------------------------------------------------
-------------Soo---------oo-----------------------------oooo---------oooo-----------------------------------------------------oooo-------------------------------------ooooSoooo----oo------ooooo-------
--------------------------------ooooSo---oooooo---------K---R------------gr---------oo--------------oooooo-------------------ry--g----------oooooo---------ooo---------------------G---k-------k--------
------------------------XXXXXX---------------k--XXX--XXXXXXXXX------XXXXXXXXXXXXXX----y------XXXX---Rkyyg-k----yk------XXXXXXXXXXXX---XXXXX---y-YR---XXXXX--R----oo-----oooooo---XXXXXXXXXXXXXXXXXXX----
XXXXXXXXXXX--g----------XXXXXX--oooo---XXXXXXXXXXXXXXXXXXXXXXXXXXXXXXXXXXXXXXXXXXXXXXXXXXX---XXXXXXXXXXXXXXXXXXXXXX----XXXXXXXXXXXXXXXXXXXXXXXXXXXXXXXXXXXXXXXXX-kK------------r-XXXXXXXXXXXXXXXXXXX----
XXXXXXXXXXXXXXXXXXXXXX--XXXXXX---yGRk--XXXXXXXXXXXXXXXXXXXXXXXXXXXXXXXXXXXXXXXXXXXXXXXXXXX---XXXXXXXXXXXXXXXXXXXXXX----XXXXXXXXXXXXXXXXXXXXXXXXXXXXXXXXXXXXXXXXXXXXXXXXXXXXXXXXXXXXXXXXXXXXXXXXXXXXXXXXX
XXXXXXXXXXXXXXXXXXXXXXXXXXXXXXXXXXXXXXXXXXXXXXXXXXXXXXXXXXXXXXXXXXXXXXXXXXXXXXXXXXXXXXXXXXXXXXXXXXXXXXXXXXXXXXXXXXXXXXXXXXXXXXXXXXXXXXXXXXXXXXXXXXXXXXXXXXXXXXXXXXXXXXXXXXXXXXXXXXXXXXXXXXXXXXXXXXXXXXXX

