--------------------------------------------------------------------------------------------------------------------------------------------------------------------------------------------------------
--------------------------------------------------------------------------------------------------------------------------------------------------------------------------------------------------------
--------------------------------------------------------------------------------------------------------------------------------------------------------------------------------------------------------
--------------------------------------------------------------------------------------------------------------------------------------------------------------------------------------------------------
--------------------------------------------------------------------------------------------------------------------------------------------------------------------------------------------------------
--------------------------------------------------------------------------------------------------------------------------------------------------------------------------------------------------------
--------------------------------------------------------------------------------------------------------------------------------------------------------------------------------------------------------
--------------------------------------------------------------------------------------------------------------------------------------------------------------------------------------------------------
--------------------------------------------------------------------------------------------------------------------------------------------------------------------------------------------------------
--------------------------------------------------------------------------------------------------------------------------------------------------------------------------------------------------------
--------------------------------------------------------------------------------------------------------------------------------------------------------------------------------------------------------
--------------------------------------------------------------------------------------------------------------------------------------------------------------------------------------------------------
---------------------------------------------------------------------------------oSooS--------------------------------------------------------------------------------------------------------oSoS------
-----------------------------------------------------------oSoo------------------------------------ooS----------------oSoSo------------------------------------------------------------oSoo-------------
--------------ooSS---------------------SSooS-----------------------------------oooooooo-----------------------ooSSSo----------------------oooSooo---------------------------------------------ooo-------
----------------------oooSo-----------------------------oooo-------------------r-------r---k-r------------------------oooo-------ooooSo------------------oo------------ooo--------------------r-G-g-----
------------ooooo-------------XXX------oooooo--------XX-----k--------------XXXXXXXXXXXXXXXXXXXX----r---------oooo------y-----------------ooooo---------------ooo--XXX---y---XXXXXXXXX---R---XXXXXXXXX---
XXXXXXXXXX-------g-------oooo-XXXXX-K-kr----r--------XXXXXXXXXXX------k-r--XXXXXXXXXXXXXXXXXXXXXXXXXXXXX----G--y--R--XXXXXXXXX---ooooo----------r-----XXXXXX---g--XXXXXXXXXXXXXXXXXXXXXXXXXXXXXXXXXXX---
XXXXXXXXXXXXXXXXXXXXX----kyr--XXXXXXXXXXXXXXXX--XXXXXXXXXXXXXXXX-----XXXXXXXXXXXXXXXXXXXXXXXXXXXXXXXXXXXXXXXXXXXXXXXXXXXXXXXXX----------XXXXXXXXXX----XXXXXXXXXXXXXXXXXXXXXXXXXXXXXXXXXXXXXXXXXXXXXXXXXX
XXXXXXXXXXXXXXXXXXXXXXXXXXXXXXXXXXXXXXXXXXXXXXXXXXXXXXXXXXXXXXXXXXXXXXXXXXXXXXXXXXXXXXXXXXXXXXXXXXXXXXXXXXXXXXXXXXXXXXXXXXXXXXXXXXXXXXXXXXXXXXXXXXXXXXXXXXXXXXXXXXXXXXXXXXXXXXXXXXXXXXXXXXXXXXXXXXXXXXXX

