--------------------------------------------------------------------------------------------------------------------------------------------------------------------------------------------------------
--------------------------------------------------------------------------------------------------------------------------------------------------------------------------------------------------------
--------------------------------------------------------------------------------------------------------------------------------------------------------------------------------------------------------
--------------------------------------------------------------------------------------------------------------------------------------------------------------------------------------------------------
--------------------------------------------------------------------------------------------------------------------------------------------------------------------------------------------------------
--------------------------------------------------------------------------------------------------------------------------------------------------------------------------------------------------------
--------------------------------------------------------------------------------------------------------------------------------------------------------------------------------------------------------
--------------------------------------------------------------------------------------------------------------------------------------------------------------------------------------------------------
--------------------------------------------------------------------------------------------------------------------------------------------------------------------------------------------------------
--------------------------------------------------------------------------------------------------------------------------------------------------------------------------------------------------------
--------------------------------------------------------------------------------------------------------------------------------------------------------------------------------------------------------
--------------------------------------------------------------------------------------------------------------------------------------------------------------------------------------------------------
-----------------------------------------------------------------------------------------------oSoSo----------------------------------------SoSSoooo----------------------------------------------------
---------------------------------------------------------------------------------------------------------------------------------------------------------------SSS----------------------ooo-------------
-------------------------Soo------------------------------------------ooo----------------------ooo-----------------------ooooo-----ooSo----oooooo-------------------------------------------------------
---------------------------------------oSooSoo-------------oSSS--------------------------------k--Rkg-------------*---------k-----------------r-----------------oo------oSooooo--------oooo--------oSoo-
XXXXXXXXXX-------------ooooo--XXXXX-----------------------------------ooo-------XXXXX----oo---XXXXXXXX----XXX---*-*---*-XXXXXXXXXX--------XXXXXXXXXXX----------Rrrr------------------------K-k----------
XXXXXXXXXXXXX----------yk-R---XXXXXXXX--ooooooo--XXXXXXX----ooo--XXXX-r-y-------XXXXX-------K-XXXXXXXX----XXXXXXXXXXXXXXXXXXXXXXXX-gg-----XXXXXXXXXXX-------XXXXXXXXXXX-oooooo---XXXXXXXXXXXXXX---ooo---
XXXXXXXXXXXXXXXXXXXXXXXXXXXXXXXXXXXXXX---G-------XXXXXXX-R-g--k--XXXXXXXXXXX----XXXXXXXXXXXXXXXXXXXXXX----XXXXXXXXXXXXXXXXXXXXXXXXXXXXXXXXXXXXXXXXXXXXX---XXXXXXXXXXXXX-y-Kr--gY-XXXXXXXXXXXXXX---y-----
XXXXXXXXXXXXXXXXXXXXXXXXXXXXXXXXXXXXXXXXXXXXXXXXXXXXXXXXXXXXXXXXXXXXXXXXXXXXXXXXXXXXXXXXXXXXXXXXXXXXXXXXXXXXXXXXXXXXXXXXXXXXXXXXXXXXXXXXXXXXXXXXXXXXXXXXXXXXXXXXXXXXXXXXXXXXXXXXXXXXXXXXXXXXXXXXXXXXXXXX

