--------------------------------------------------------------------------------------------------------------------------------------------------------------------------------------------------------
--------------------------------------------------------------------------------------------------------------------------------------------------------------------------------------------------------
--------------------------------------------------------------------------------------------------------------------------------------------------------------------------------------------------------
--------------------------------------------------------------------------------------------------------------------------------------------------------------------------------------------------------
--------------------------------------------------------------------------------------------------------------------------------------------------------------------------------------------------------
--------------------------------------------------------------------------------------------------------------------------------------------------------------------------------------------------------
--------------------------------------------------------------------------------------------------------------------------------------------------------------------------------------------------------
--------------------------------------------------------------------------------------------------------------------------------------------------------------------------------------------------------
--------------------------------------------------------------------------------------------------------------------------------------------------------------------------------------------------------
--------------------------------------------------------------------------------------------------------------------------------------------------------------------------------------------------------
--------------------------------------------------------------------------------------------------------------------------------------------------------------------------------------------------------
--------------------------------------------------------------------------------------------------------------------------------------------------------------------------------------------------------
----------------------------------------------oSSS-------------------------------------------------------------------------------oSo----oSo---------------SoSo------------------------------------------
----------------------------------------------------------------oooSo-----ooSSooo--------------------------------------------------------------------------------------------SSoo----oSSo---------------
-------------------SoS--------------ooSo-----oooooo--------------------------------ooSoSo----------------ooooo-------------------oo-------oo--ooooS---------oo------Soo---------------------------------
--------------------------------------------g---Y--K---------ooooooo-----oooooo-----------------------------------------------K------y---y---------------g-Grg----------------------oooooo--------------
------------XXXX--------------------oo---XXXXXXXXXXXX----------------------k-R-----oooooo---XXXX-----------oooo---------r----XXXXXXXXXXXXXXXX--ooooo-XXXXXXXXXXXX-oooooooo--k----------R--G-------------
------------XXXX----rgY-------XXXX-G-k---XXXXXXXXXXXX-------XXXXXXXXXXXXXXXXXXXXXX---y-yY---XXXX--------k----g-y-----XXXXXXXXXXXXXXXXXXXXXXXX---Y----XXXXXXXXXXXX--gr-r-y--XXXXXXXXXXXXXXXXXX--oo-------
------------XXXXXXXXXXXX--XXXXXXXXXXXXXXXXXXXXXXXXXXXXXXXXXXXXXXXXXXXXXXXXXXXXXXXXXXXXXXXXXXXXXX-y--r--XXXXXXXXXXXXXXXXXXXXXXXXXXXXXXXXXXXXXXXXXXXXXXXXXXXXXXXXXXXXXXXXXXXXXXXXXXXXXXXXXXXXXX----k------
XXXXXXXXXXXXXXXXXXXXXXXXXXXXXXXXXXXXXXXXXXXXXXXXXXXXXXXXXXXXXXXXXXXXXXXXXXXXXXXXXXXXXXXXXXXXXXXXXXXXXXXXXXXXXXXXXXXXXXXXXXXXXXXXXXXXXXXXXXXXXXXXXXXXXXXXXXXXXXXXXXXXXXXXXXXXXXXXXXXXXXXXXXXXXXXXXXXXXXXX

