--------------------------------------------------------------------------------------------------------------------------------------------------------------------------------------------------------
--------------------------------------------------------------------------------------------------------------------------------------------------------------------------------------------------------
--------------------------------------------------------------------------------------------------------------------------------------------------------------------------------------------------------
--------------------------------------------------------------------------------------------------------------------------------------------------------------------------------------------------------
--------------------------------------------------------------------------------------------------------------------------------------------------------------------------------------------------------
--------------------------------------------------------------------------------------------------------------------------------------------------------------------------------------------------------
--------------------------------------------------------------------------------------------------------------------------------------------------------------------------------------------------------
--------------------------------------------------------------------------------------------------------------------------------------------------------------------------------------------------------
--------------------------------------------------------------------------------------------------------------------------------------------------------------------------------------------------------
--------------------------------------------------------------------------------------------------------------------------------------------------------------------------------------------------------
--------------------------------------------------------------------------------------------------------------------------------------------------------------------------------------------------------
--------------------------------------------------------------------------------------------------------------------------------------------------------------------------------------------------------
-------------------------------------------------------------------------------oSoo------------------------ooS-------------------------------------------------oSo-------------------------------oSo----
---------------Sooo-------------------------------------------------------------------ooSSSo----------------------------SooS-----------------------oSSS-------------------------------------------------
----------------------ooo--------------------------------------------SooSo--oooooo-------------------------ooo-----------------------------------------------oooo--------------------Soo----oo----oo----
----------------oooo-----------------oSSooSSo-----------ooooSo---------------k--------oooooooo-----------k-------------oooo-------------------------oooooo-----------oooo-----oo-----------rk---gK------
---------------RKy-------------XXXX----------------XXXX-----------oooooooo-XXXXXXXXX---g-k--------------XXXXXXXX-------Kg---K--------oo----XXXX----k-gG-g--XXXXXXXXX---------yg----------XXXXXXXXXXXXXX-
-------------XXXXXXXX---k------XXXX-ooooooo--------XXXX--ooooo-------------XXXXXXXXXXXXXXXXXXXX---------XXXXXXXX-----XXXXXXXXXXXXXXX-------XXXXXXXXXXXXXXXXXXXXXXXXX-oooo---XXXXXX--r----XXXXXXXXXXXXXX-
XXXXXXXXXXXXXXXXXXXXXXXXXXXXXXXXXXX----Gk-----XXXXXXXXX--k-------XXXXXXXXXXXXXXXXXXXXXXXXXXXXXX-----XXXXXXXXXXXXXXXXXXXXXXXXXXXXXXXXXXXXXXXXXXXXXXXXXXXXXXXXXXXXXXXX--------XXXXXXXXXXXXXXXXXXXXXXXXXXXX
XXXXXXXXXXXXXXXXXXXXXXXXXXXXXXXXXXXXXXXXXXXXXXXXXXXXXXXXXXXXXXXXXXXXXXXXXXXXXXXXXXXXXXXXXXXXXXXXXXXXXXXXXXXXXXXXXXXXXXXXXXXXXXXXXXXXXXXXXXXXXXXXXXXXXXXXXXXXXXXXXXXXXXXXXXXXXXXXXXXXXXXXXXXXXXXXXXXXXXXX

