--------------------------------------------------------------------------------------------------------------------------------------------------------------------------------------------------------
--------------------------------------------------------------------------------------------------------------------------------------------------------------------------------------------------------
--------------------------------------------------------------------------------------------------------------------------------------------------------------------------------------------------------
--------------------------------------------------------------------------------------------------------------------------------------------------------------------------------------------------------
--------------------------------------------------------------------------------------------------------------------------------------------------------------------------------------------------------
--------------------------------------------------------------------------------------------------------------------------------------------------------------------------------------------------------
--------------------------------------------------------------------------------------------------------------------------------------------------------------------------------------------------------
--------------------------------------------------------------------------------------------------------------------------------------------------------------------------------------------------------
--------------------------------------------------------------------------------------------------------------------------------------------------------------------------------------------------------
--------------------------------------------------------------------------------------------------------------------------------------------------------------------------------------------------------
--------------------------------------------------------------------------------------------------------------------------------------------------------------------------------------------------------
--------------------------------------------------------------------------------------------------------------------------------------------------------------------------------------------------------
-------------------ooSooo-----ooo-----oooS--------------------------------------------------------------oSoS------------------------oSS-----------------------------------oooSo-------------------------
--------------------------------------------------------------------------------------ooS-----ooooS-----------------------------------------------------------------------------------------------------
-------------oSS----oooo------oooo-----oooo----------------------------------------------------------------oo------------------------ooo------------------SoS-------------oooooo------------------------
---------------------ry-k-----rGYyr----r--r------------------------------oSooo-----oooooo----ooooooooo---k--Gy-----------------------ryG---------------------------------y--Ry-Rg--oSSooo---------------
XXXXXXXXXXXX--oo--XXXXXXXXXXXXXXXXXXXXXXXXXXXX-----g-XX------------XXXX---------------k-y----kg-Gy-rk--XXXXXXXXX-------------------XXXXXXXXXX-----XXXX--oooo------------XXXXXXXXXX------------------ooo-
XXXXXXXXXXXX------XXXXXXXXXXXXXXXXXXXXXXXXXXXXXXXXXXXXXXXXXXXX-----XXXX---oooooo--XXXXXXXXXXXXXXXXXXXXXXXXXXXXXX------oooooooo-----XXXXXXXXXXXXXXXXXXX-k-r----------XXXXXXXXXXXXXX--oooo--XXXXX-------y-
XXXXXXXXXXXXXXXXXXXXXXXXXXXXXXXXXXXXXXXXXXXXXXXXXXXXXXXXXXXXXXXXXXXXXXX-g-G-Y---k-XXXXXXXXXXXXXXXXXXXXXXXXXXXXXXXXXXX----------XXXXXXXXXXXXXXXXXXXXXXXXXXXXXXXXXXXXXXXXXXXXXXXXXXX-k------XXXXX---XXXXXX
XXXXXXXXXXXXXXXXXXXXXXXXXXXXXXXXXXXXXXXXXXXXXXXXXXXXXXXXXXXXXXXXXXXXXXXXXXXXXXXXXXXXXXXXXXXXXXXXXXXXXXXXXXXXXXXXXXXXXXXXXXXXXXXXXXXXXXXXXXXXXXXXXXXXXXXXXXXXXXXXXXXXXXXXXXXXXXXXXXXXXXXXXXXXXXXXXXXXXXXX

