--------------------------------------------------------------------------------------------------------------------------------------------------------------------------------------------------------
--------------------------------------------------------------------------------------------------------------------------------------------------------------------------------------------------------
--------------------------------------------------------------------------------------------------------------------------------------------------------------------------------------------------------
--------------------------------------------------------------------------------------------------------------------------------------------------------------------------------------------------------
--------------------------------------------------------------------------------------------------------------------------------------------------------------------------------------------------------
--------------------------------------------------------------------------------------------------------------------------------------------------------------------------------------------------------
--------------------------------------------------------------------------------------------------------------------------------------------------------------------------------------------------------
--------------------------------------------------------------------------------------------------------------------------------------------------------------------------------------------------------
--------------------------------------------------------------------------------------------------------------------------------------------------------------------------------------------------------
--------------------------------------------------------------------------------------------------------------------------------------------------------------------------------------------------------
--------------------------------------------------------------------------------------------------------------------------------------------------------------------------------------------------------
--------------------------------------------------------------------------------------------------------------------------------------------------------------------------------------------------------
-------------------------------------------------------------------------------------------------------------------oSSooo--------------ooSooSoo------------------Sooo------------oooooo-----------------
---------------------------------------ooooo--------oSo--------------------------------------------------------------------------------------------ooo--------------------------------------------------
------------------------------ooo----------------------------------------------------------------------------------oooo----------------ooooooo-------------------ooo-----SoSoo---ooooo------------------
-----------------------R-----g--------ooooo--------oo---------oSo--------------------oSoSooo--oooo------------------yrKK-----------------r---yK---ooooo-------y--G--r------------k---g------------SoS---
-------------------XXXXXX--XXXXXXX---r---r-k-XXXX-----y-----------------------XXXX-------------g-k--K-----XX--XXXXXXXXXXXXX--XXXXX----XXXXXXXXXX-Rr----------XXXXXXXXXX--ooo---XXXXXXXXXX---------------
----------------XXXXXXXXXXXXXXXXXX--XXXXXXXXXXXXXXXXXXXX-------------------Y--XXXX-oooooooo--XXXXXXXXXXXXXXX--XXXXXXXXXXXXXXXXXXXX----XXXXXXXXXXXXXXXXXX-----XXXXXXXXXX--kG----XXXXXXXXXX---oo---ooo----
XXXXXXXXXXXXXX--XXXXXXXXXXXXXXXXXX--XXXXXXXXXXXXXXXXXXXXXXX------------XXXXXXXXXXX-r--k----G-XXXXXXXXXXXXXXX--XXXXXXXXXXXXXXXXXXXXXXXXXXXXXXXXXXXXXXXXXX-----XXXXXXXXXXXXXXXXXXXXXXXXXXXX----R---g-R--R-
XXXXXXXXXXXXXXXXXXXXXXXXXXXXXXXXXXXXXXXXXXXXXXXXXXXXXXXXXXXXXXXXXXXXXXXXXXXXXXXXXXXXXXXXXXXXXXXXXXXXXXXXXXXXXXXXXXXXXXXXXXXXXXXXXXXXXXXXXXXXXXXXXXXXXXXXXXXXXXXXXXXXXXXXXXXXXXXXXXXXXXXXXXXXXXXXXXXXXXXX

