--------------------------------------------------------------------------------------------------------------------------------------------------------------------------------------------------------
--------------------------------------------------------------------------------------------------------------------------------------------------------------------------------------------------------
--------------------------------------------------------------------------------------------------------------------------------------------------------------------------------------------------------
--------------------------------------------------------------------------------------------------------------------------------------------------------------------------------------------------------
--------------------------------------------------------------------------------------------------------------------------------------------------------------------------------------------------------
--------------------------------------------------------------------------------------------------------------------------------------------------------------------------------------------------------
--------------------------------------------------------------------------------------------------------------------------------------------------------------------------------------------------------
--------------------------------------------------------------------------------------------------------------------------------------------------------------------------------------------------------
--------------------------------------------------------------------------------------------------------------------------------------------------------------------------------------------------------
--------------------------------------------------------------------------------------------------------------------------------------------------------------------------------------------------------
--------------------------------------------------------------------------------------------------------------------------------------------------------------------------------------------------------
--------------------------------------------------------------------------------------------------------------------------------------------------------------------------------------------------------
-----------------------------------------------------------------------------------------------------------------------------------------------------------------------------------ooSooS---------------
---------------------------ooooSo--oSoSSoo--------------------------------------------------------------------------------------------------------------------------oSSo--------------------------------
-----------------------------------------------------ooo----------------Soooo---------------------------------------Soo--------------------------------------------------------------ooooooo------------
------------ooooo------------------ooooooo----ooooo--gyr-----SSo-------------------SoSo-----------------ooo----------------------------oSoo---------------------------oo-------------Y----------oSoo----
XXXXXXXXXX----------------------------K--------gk---XXXXXX-------------oooo-----------------------------r------XX-ooooo-----------------------XX----XXXXXXXX----------rY----------XXXXXXXXXXX---------XX
XXXXXXXXXX-oooooooo---R-r-XXXXXXXXXXXXXXXXXXXXXXXXXXXXXXXX---ooooo--XX-k-Y------oooooo---------XX------XXXXXXXXXX-------XX------XXXX-oooooo---XX----XXXXXXXX------XXXXXXX---------XXXXXXXXXXX-oooooo--XX
XXXXXXXXXX--r---Rr--XXXXXXXXXXXXXXXXXXXXXXXXXXXXXXXXXXXXXX-r--K-y---XXXXXXXXXXX---k----r--XXXXXXX----y-XXXXXXXXXXXXXXXXXXX---gR-XXXX-r--k---g-XX----XXXXXXXX--yY--XXXXXXX--Gg-----XXXXXXXXXXX-gk-g----XX
XXXXXXXXXXXXXXXXXXXXXXXXXXXXXXXXXXXXXXXXXXXXXXXXXXXXXXXXXXXXXXXXXXXXXXXXXXXXXXXXXXXXXXXXXXXXXXXXXXXXXXXXXXXXXXXXXXXXXXXXXXXXXXXXXXXXXXXXXXXXXXXXXXXXXXXXXXXXXXXXXXXXXXXXXXXXXXXXXXXXXXXXXXXXXXXXXXXXXXXX

