--------------------------------------------------------------------------------------------------------------------------------------------------------------------------------------------------------
--------------------------------------------------------------------------------------------------------------------------------------------------------------------------------------------------------
--------------------------------------------------------------------------------------------------------------------------------------------------------------------------------------------------------
--------------------------------------------------------------------------------------------------------------------------------------------------------------------------------------------------------
--------------------------------------------------------------------------------------------------------------------------------------------------------------------------------------------------------
--------------------------------------------------------------------------------------------------------------------------------------------------------------------------------------------------------
--------------------------------------------------------------------------------------------------------------------------------------------------------------------------------------------------------
--------------------------------------------------------------------------------------------------------------------------------------------------------------------------------------------------------
--------------------------------------------------------------------------------------------------------------------------------------------------------------------------------------------------------
--------------------------------------------------------------------------------------------------------------------------------------------------------------------------------------------------------
--------------------------------------------------------------------------------------------------------------------------------------------------------------------------------------------------------
--------------------------------------------------------------------------------------------------------------------------------------------------------------------------------------------------------
------------------------------------ooooo------------------------------------------------------------------------------------------------------------oSSS-------SSoooo----------------------------------
-------------ooSooo------------------------------ooo--------------------------------------------oooo-------------------------ooSoo------------------------------------------Soo------ooS----------------
---------------------------------------ooooo----------------ooSoo---------------ooSSoSo--ooo----------oSo---------------------------oSoS----------------oo------oooooo----------------------------------
------------ooooo------ooooo--------RK-rrr-r-----oo---------------------------------------------oooo------------------------oooooo------------SoSoo-----r-R---------------ooooo-------ooo---------------
----------------Kg-----------------XXXXXXXXXX-G-Y--g--------------XXXXXX------oooooooo----oo------gR--------XXXXX--------------Y----oooo------------XXXXXXXX--XXXXXXXXXX-------R----------------XXXXXXXX
XXXXXXXXXXXXXXXXXXXX---oooooo--XXXXXXXXXXXXXXXXXXXXXXXXXXX--kY-g--XXXXXXXXXXX------r-KK--g-K--XXXXXXX----Y--XXXXX---------XXXXXXXXX-yk--------------XXXXXXXXXXXXXXXXXXXXXXXXXXXXXXXXXXXXXXXXXXXXXXXXXXXX
XXXXXXXXXXXXXXXXXXXX-------y-r-XXXXXXXXXXXXXXXXXXXXXXXXXXXXXXXXXXXXXXXXXXXXXXXXXXXXXXXXXXXXXXXXXXXXXXXXXXXXXXXXXXXXXXXXXXXXXXXXXXXXXXXXXXXX--k------XXXXXXXXXXXXXXXXXXXXXXXXXXXXXXXXXXXXXXXXXXXXXXXXXXXX
XXXXXXXXXXXXXXXXXXXXXXXXXXXXXXXXXXXXXXXXXXXXXXXXXXXXXXXXXXXXXXXXXXXXXXXXXXXXXXXXXXXXXXXXXXXXXXXXXXXXXXXXXXXXXXXXXXXXXXXXXXXXXXXXXXXXXXXXXXXXXXXXXXXXXXXXXXXXXXXXXXXXXXXXXXXXXXXXXXXXXXXXXXXXXXXXXXXXXXXX

