--------------------------------------------------------------------------------------------------------------------------------------------------------------------------------------------------------
--------------------------------------------------------------------------------------------------------------------------------------------------------------------------------------------------------
--------------------------------------------------------------------------------------------------------------------------------------------------------------------------------------------------------
--------------------------------------------------------------------------------------------------------------------------------------------------------------------------------------------------------
--------------------------------------------------------------------------------------------------------------------------------------------------------------------------------------------------------
--------------------------------------------------------------------------------------------------------------------------------------------------------------------------------------------------------
--------------------------------------------------------------------------------------------------------------------------------------------------------------------------------------------------------
--------------------------------------------------------------------------------------------------------------------------------------------------------------------------------------------------------
--------------------------------------------------------------------------------------------------------------------------------------------------------------------------------------------------------
--------------------------------------------------------------------------------------------------------------------------------------------------------------------------------------------------------
--------------------------------------------------------------------------------------------------------------------------------------------------------------------------------------------------------
--------------------------------------------------------------------------------------------------------------------------------------------------------------------------------------------------------
----------------------------------ooSSoooS-------------------------------------oooo---------------ooo----------oooooo--------------------------------ooS------------------------------------------------
-----------ooSoo-----------------------------------------------------oSoo------------------------------------------------------oooo--------Soooooo-----------------------ooS----------------------------
-----------------------------------oooooooo--oSoSoooS-------------------------ooo--------oooo-----ooooo--------oooooooo------------------------------ooo-------------------------------------------oooo-
--------------oo----------SooS------r-----k----------------------------ooo-----r-----------R----Gy--k-g-------------kr---------ooooo-------ooooooo--G--------------------oooooo---------------------y---
------------Y-k----r-------------XXXXXXXXXXX-oooooo-----Y-----XXXXX-----g--XXXXXXXXXX---XXXXXXXXXXXXXXXXX----XXXXXXXXXXX----rRrKyy----XXX-g--g-----XXXXXXX------------------------------oo-XX----XXXXXXX
----------XXXXXXXXXXXXXX-oooooo--XXXXXXXXXXX----yYk----XXXXXXXXXXXXXXXXXXXXXXXXXXXXXX---XXXXXXXXXXXXXXXXX----XXXXXXXXXXX---XXXXXXXXXXXXXXXXXXXXXXXXXXXXXXXXXXX-----XXXXXXXXXXXXX-------Yrk-XX----XXXXXXX
XXXXXXXXXXXXXXXXXXXXXXXX---r-----XXXXXXXXXXXXXXXXXXXXXXXXXXXXXXXXXXXXXXXXXXXXXXXXXXXXXXXXXXXXXXXXXXXXXXXX----XXXXXXXXXXX---XXXXXXXXXXXXXXXXXXXXXXXXXXXXXXXXXXX-----XXXXXXXXXXXXXXXXXXXXXXXXXX----XXXXXXX
XXXXXXXXXXXXXXXXXXXXXXXXXXXXXXXXXXXXXXXXXXXXXXXXXXXXXXXXXXXXXXXXXXXXXXXXXXXXXXXXXXXXXXXXXXXXXXXXXXXXXXXXXXXXXXXXXXXXXXXXXXXXXXXXXXXXXXXXXXXXXXXXXXXXXXXXXXXXXXXXXXXXXXXXXXXXXXXXXXXXXXXXXXXXXXXXXXXXXXXX

