--------------------------------------------------------------------------------------------------------------------------------------------------------------------------------------------------------
--------------------------------------------------------------------------------------------------------------------------------------------------------------------------------------------------------
--------------------------------------------------------------------------------------------------------------------------------------------------------------------------------------------------------
--------------------------------------------------------------------------------------------------------------------------------------------------------------------------------------------------------
--------------------------------------------------------------------------------------------------------------------------------------------------------------------------------------------------------
--------------------------------------------------------------------------------------------------------------------------------------------------------------------------------------------------------
--------------------------------------------------------------------------------------------------------------------------------------------------------------------------------------------------------
--------------------------------------------------------------------------------------------------------------------------------------------------------------------------------------------------------
--------------------------------------------------------------------------------------------------------------------------------------------------------------------------------------------------------
--------------------------------------------------------------------------------------------------------------------------------------------------------------------------------------------------------
--------------------------------------------------------------------------------------------------------------------------------------------------------------------------------------------------------
--------------------------------------------------------------------------------------------------------------------------------------------------------------------------------------------------------
----------------------------------------oooooooo--------------------------------oooo---------------oooSSo-------oooSo------------------------ooooS-----oSSoS--------------------------------------------
--------------------------------------------------------------------------------------------------------------------------------------------------------------------------------------------------------
----------------------------------oo----oooooo------SoSoo-----------------------oooo-----------------ooo-----------oo-----------------------oooooooo---oooooo-----------------------------------ooooo---
------------------oSSooSo-------G---g----rk---ry----------------SoSSo-----------k--------------------G--r-------yk----------oSoo-------------yY-----g----R-------------------------SoS---------kRkK-----
-------------------------------XXXXXXXXXXXXXXXXXX---ooo---------------------XXXXXXXXX-----------K-XXXXXXXXX----XXXXXXX---------------------XXXXXXXXXXXXXXXXXXX------XXX-----------------------XXXXXXXX--
XXXXXXXXXXXXXX------oooooo-----XXXXXXXXXXXXXXXXXX-----r--------ooooooo------XXXXXXXXX-------XXXXXXXXXXXXXXX----XXXXXXX-----oo------oooo-XXXXXXXXXXXXXXXXXXXXXX------XXX-------------oooo------XXXXXXXX--
XXXXXXXXXXXXXXXXX--rg-g--g-XXXXXXXXXXXXXXXXXXXXXXXXXXXXXXX-----gk-R--rg-XXXXXXXXXXXXX-------XXXXXXXXXXXXXXXXXXXXXXXXXX-----K--------y-g-XXXXXXXXXXXXXXXXXXXXXXXXXXXXXXX----XXXXX--k--rK-------XXXXXXXXXX
XXXXXXXXXXXXXXXXXXXXXXXXXXXXXXXXXXXXXXXXXXXXXXXXXXXXXXXXXXXXXXXXXXXXXXXXXXXXXXXXXXXXXXXXXXXXXXXXXXXXXXXXXXXXXXXXXXXXXXXXXXXXXXXXXXXXXXXXXXXXXXXXXXXXXXXXXXXXXXXXXXXXXXXXXXXXXXXXXXXXXXXXXXXXXXXXXXXXXXXX

