--------------------------------------------------------------------------------------------------------------------------------------------------------------------------------------------------------
--------------------------------------------------------------------------------------------------------------------------------------------------------------------------------------------------------
--------------------------------------------------------------------------------------------------------------------------------------------------------------------------------------------------------
--------------------------------------------------------------------------------------------------------------------------------------------------------------------------------------------------------
--------------------------------------------------------------------------------------------------------------------------------------------------------------------------------------------------------
--------------------------------------------------------------------------------------------------------------------------------------------------------------------------------------------------------
--------------------------------------------------------------------------------------------------------------------------------------------------------------------------------------------------------
--------------------------------------------------------------------------------------------------------------------------------------------------------------------------------------------------------
--------------------------------------------------------------------------------------------------------------------------------------------------------------------------------------------------------
--------------------------------------------------------------------------------------------------------------------------------------------------------------------------------------------------------
--------------------------------------------------------------------------------------------------------------------------------------------------------------------------------------------------------
--------------------------------------------------------------------------------------------------------------------------------------------------------------------------------------------------------
---------------------------------------ooSoo----------------------------------------------------------------------oooo-----------------------ooooSo-----------------------------------------------------
-----------------------------------------------------------------------------------------------------------------------------------------------------------ooS------------------------------------------
-----------------------------ooSoo---oooooo------------------------------------------------------------------------oooo----------------------ooooooo--------------------------------------------SSS-----
-------------------rk----------------y-rG-R-r---------ooS-----oooo--------------------------ooS-------ooooo---------k-g----ooo----------------Yg--r------ooooo------------------ooo----gG-g-------------
-----------------XXXXXXXXX----ooo---XXXXXXXXXXXXXXX----------r----------------------XXXX-----------------------XXXXXXXXX------------------r-XXXXXXXXXXX-r-g-g--------G---------y----y-XXXXXXX-ooooo--XXX
XXXXXXXXXXXXXXXXXXXXXXXXXX-----r-g--XXXXXXXXXXXXXXX-oooo---XXXXXXXXX-------gy-------XXXX-oooooooo-----ooo------XXXXXXXXX-ooo---------XXXXXXXXXXXXXXXXXXXXXXXXXXXXXXXXXX-R--r-XXXXXXXXXXXXXXXX-g-y----XXX
XXXXXXXXXXXXXXXXXXXXXXXXXXXXXXXXXXXXXXXXXXXXXXXXXXX-----Gg-XXXXXXXXX-----XXXXXXXXXXXXXXX-g-K----------------XXXXXXXXXXXX--gkk----g---XXXXXXXXXXXXXXXXXXXXXXXXXXXXXXXXXXXXXXXXXXXXXXXXXXXXXXXXXXXXXXXXXXX
XXXXXXXXXXXXXXXXXXXXXXXXXXXXXXXXXXXXXXXXXXXXXXXXXXXXXXXXXXXXXXXXXXXXXXXXXXXXXXXXXXXXXXXXXXXXXXXXXXXXXXXXXXXXXXXXXXXXXXXXXXXXXXXXXXXXXXXXXXXXXXXXXXXXXXXXXXXXXXXXXXXXXXXXXXXXXXXXXXXXXXXXXXXXXXXXXXXXXXXX

