--------------------------------------------------------------------------------------------------------------------------------------------------------------------------------------------------------
--------------------------------------------------------------------------------------------------------------------------------------------------------------------------------------------------------
--------------------------------------------------------------------------------------------------------------------------------------------------------------------------------------------------------
--------------------------------------------------------------------------------------------------------------------------------------------------------------------------------------------------------
--------------------------------------------------------------------------------------------------------------------------------------------------------------------------------------------------------
--------------------------------------------------------------------------------------------------------------------------------------------------------------------------------------------------------
--------------------------------------------------------------------------------------------------------------------------------------------------------------------------------------------------------
--------------------------------------------------------------------------------------------------------------------------------------------------------------------------------------------------------
--------------------------------------------------------------------------------------------------------------------------------------------------------------------------------------------------------
--------------------------------------------------------------------------------------------------------------------------------------------------------------------------------------------------------
--------------------------------------------------------------------------------------------------------------------------------------------------------------------------------------------------------
--------------------------------------------------------------------------------------------------------------------------------------------------------------------------------------------------------
--------------------------------------------------------ooSooS----oooo-----------------oooS--------------oooSS----oSoo---------------------------------oSoo--------------ooSo---------------------------
-----------------------------------------------ooS------------------------------------------------------------------------------------------------------------------------------------------------------
---------------------------------------ooo-------------oooooo-------------------------oooooo----ooooo---oooo-----ooooooo---ooooSSoo---------------------ooooo---------oooooo------Soo-----ooSoo---------
---------------------------oo----------g-g-------------r-y---------Yk---------------------g-------k-R------------R-r--ky---------------oo--------------k--------------g---r-----------------------------
XXXXXXXXXXXXXXXXX--------k-gKgr------XXXXXXXXX-----yR-XXXXXXXXXXXXXXXXXX-rgkr--------XXXXXXXXXXXXXXXXXXXXXXXXXXXXXXXXXXXXX---ooooo-------------------XXXXXXXXX-ooooo-XXXXXXXXXX----ooo-------ooo--XXXXXX
XXXXXXXXXXXXXXXXX-------XXXXXXXXXXXXXXXXXXXXXXXXXXXXXXXXXXXXXXXXXXXXXXXXXXXXXXX------XXXXXXXXXXXXXXXXXXXXXXXXXXXXXXXXXXXXX-y--gR-rgR-XXXXXXXXXXXX----XXXXXXXXX-------XXXXXXXXXX------------Gr-----XXXXXX
XXXXXXXXXXXXXXXXXXX-----XXXXXXXXXXXXXXXXXXXXXXXXXXXXXXXXXXXXXXXXXXXXXXXXXXXXXXXXX----XXXXXXXXXXXXXXXXXXXXXXXXXXXXXXXXXXXXXXXXXXXXXXXXXXXXXXXXXXXXXXXXXXXXXXXXXXXXXXXXXXXXXXXXXXXXXXXXXXXXXXXXXXXXXXXXXXX
XXXXXXXXXXXXXXXXXXXXXXXXXXXXXXXXXXXXXXXXXXXXXXXXXXXXXXXXXXXXXXXXXXXXXXXXXXXXXXXXXXXXXXXXXXXXXXXXXXXXXXXXXXXXXXXXXXXXXXXXXXXXXXXXXXXXXXXXXXXXXXXXXXXXXXXXXXXXXXXXXXXXXXXXXXXXXXXXXXXXXXXXXXXXXXXXXXXXXXXX

