--------------------------------------------------------------------------------------------------------------------------------------------------------------------------------------------------------
--------------------------------------------------------------------------------------------------------------------------------------------------------------------------------------------------------
--------------------------------------------------------------------------------------------------------------------------------------------------------------------------------------------------------
--------------------------------------------------------------------------------------------------------------------------------------------------------------------------------------------------------
--------------------------------------------------------------------------------------------------------------------------------------------------------------------------------------------------------
--------------------------------------------------------------------------------------------------------------------------------------------------------------------------------------------------------
--------------------------------------------------------------------------------------------------------------------------------------------------------------------------------------------------------
--------------------------------------------------------------------------------------------------------------------------------------------------------------------------------------------------------
--------------------------------------------------------------------------------------------------------------------------------------------------------------------------------------------------------
--------------------------------------------------------------------------------------------------------------------------------------------------------------------------------------------------------
--------------------------------------------------------------------------------------------------------------------------------------------------------------------------------------------------------
--------------------------------------------------------------------------------------------------------------------------------------------------------------------------------------------------------
-----------------------------------------------------------------------------------------------------------------oSSoS-------------oSoSo----------------------------------------------------------------
------------------------------------------oooSo-----------------------------------------------------------------------------------------------------------------Soooo----ooo-------------------ooS------
-----------------------------------------------------------------------------------------oooS--------------------oooooo---------------------------------------------------------------------------------
----------------Sooo----------------------oooooo-----------oooo----oooo----------------------------------------kk---rG------ooS----k------------------ooSSSo---ooooooo-----ooo---ooSoS---------ooo------
-------------------------------XX-------g--yRr---XXX--------------RRgy-----XXXX------------------XXXX---------XXXXXXXXXX----------XXXXXXX-----------------------y--kr-----yrg---------------------g-----
XXXXXXXXXXXX---oooo---------XXXXX------XXXXXXXXXXXXXXXX--oooooo--XXXXXXXX--XXXX--------------GYr-XXXX----XXXXXXXXXXXXXXX--ooooooo-XXXXXXX-----------ooooooo---XXXXXXXXXXXXXXXXXX--------------XXXXXX----
XXXXXXXXXXXX---Y--kG---XXXXXXXXXXXXXXXXXXXXXXXXXXXXXXXX--------y-XXXXXXXX--XXXX-kk--r---XXXXXXXXXXXXX----XXXXXXXXXXXXXXX-kY----k--XXXXXXX------------g----y---XXXXXXXXXXXXXXXXXX-R------XXXXXXXXXXXXXXXX
XXXXXXXXXXXXXXXXXXXXXXXXXXXXXXXXXXXXXXXXXXXXXXXXXXXXXXXXXXXXXXXXXXXXXXXXXXXXXXXXXXXXXXXXXXXXXXXXXXXXXXXXXXXXXXXXXXXXXXXXXXXXXXXXXXXXXXXXXXXXXXXXXXXXXXXXXXXXXXXXXXXXXXXXXXXXXXXXXXXXXXXXXXXXXXXXXXXXXXXX

