--------------------------------------------------------------------------------------------------------------------------------------------------------------------------------------------------------
--------------------------------------------------------------------------------------------------------------------------------------------------------------------------------------------------------
--------------------------------------------------------------------------------------------------------------------------------------------------------------------------------------------------------
--------------------------------------------------------------------------------------------------------------------------------------------------------------------------------------------------------
--------------------------------------------------------------------------------------------------------------------------------------------------------------------------------------------------------
--------------------------------------------------------------------------------------------------------------------------------------------------------------------------------------------------------
--------------------------------------------------------------------------------------------------------------------------------------------------------------------------------------------------------
--------------------------------------------------------------------------------------------------------------------------------------------------------------------------------------------------------
--------------------------------------------------------------------------------------------------------------------------------------------------------------------------------------------------------
--------------------------------------------------------------------------------------------------------------------------------------------------------------------------------------------------------
--------------------------------------------------------------------------------------------------------------------------------------------------------------------------------------------------------
--------------------------------------------------------------------------------------------------------------------------------------------------------------------------------------------------------
-----------------------oSS---------oSoo-----------------------------------------------------------------------------------------------------------------------------------------------oooSSS------------
---------------Soo-------------------------------------------------SoSoSoo----------------------------------------------------------ooo-----oSSoS-------------------------------------------------------
----------------------ooooo--------ooo------Sooooo---oSoSS--------------------------------------------------------oooSoSo---------------------------------------------oooo---ooooSo-----ooo-------------
-------------ooooo--g-yR-k---------y--r---------------------------ooooo----------------------oooo------oSSoooo------------------------ooo-----ooo---oSooooo----gy--k-----k-----------y------------------
--------------y-gk-XXXXXXXXXXX---XXXXXXXXX-oooooo-----oo----XX---g-----k-----------XXXXX-----kgK-------------------oooooo------------k----------------------XXXXXXXXXXXXXXX---oo----XXXXXXXXXXXXX-------
------------XXXXXXXXXXXXXXXXXX---XXXXXXXXX-g---r------yg--G-XX--XXXXXXXXXXX--------XXXXX----XXXXXXXX---ooooooooo-----r---y-XXXXXXXXXXXXXXXXXXXXXXXX--oooo---XXXXXXXXXXXXXXX---------XXXXXXXXXXXXX-------
------------XXXXXXXXXXXXXXXXXXXXXXXXXXXXXXXXXXXXXXXXXXXXXXXXXXXXXXXXXXXXXXX------K-XXXXX----XXXXXXXX-------Y-----XXXXXXXXXXXXXXXXXXXXXXXXXXXXXXXXXX--g----g-XXXXXXXXXXXXXXXXXXXXXXXXXXXXXXXXXXXXX--XXXXX
XXXXXXXXXXXXXXXXXXXXXXXXXXXXXXXXXXXXXXXXXXXXXXXXXXXXXXXXXXXXXXXXXXXXXXXXXXXXXXXXXXXXXXXXXXXXXXXXXXXXXXXXXXXXXXXXXXXXXXXXXXXXXXXXXXXXXXXXXXXXXXXXXXXXXXXXXXXXXXXXXXXXXXXXXXXXXXXXXXXXXXXXXXXXXXXXXXXXXXXX

