--------------------------------------------------------------------------------------------------------------------------------------------------------------------------------------------------------
--------------------------------------------------------------------------------------------------------------------------------------------------------------------------------------------------------
--------------------------------------------------------------------------------------------------------------------------------------------------------------------------------------------------------
--------------------------------------------------------------------------------------------------------------------------------------------------------------------------------------------------------
--------------------------------------------------------------------------------------------------------------------------------------------------------------------------------------------------------
--------------------------------------------------------------------------------------------------------------------------------------------------------------------------------------------------------
--------------------------------------------------------------------------------------------------------------------------------------------------------------------------------------------------------
--------------------------------------------------------------------------------------------------------------------------------------------------------------------------------------------------------
--------------------------------------------------------------------------------------------------------------------------------------------------------------------------------------------------------
--------------------------------------------------------------------------------------------------------------------------------------------------------------------------------------------------------
--------------------------------------------------------------------------------------------------------------------------------------------------------------------------------------------------------
--------------------------------------------------------------------------------------------------------------------------------------------------------------------------------------------------------
----------------------------------------oSSSoSoSo------------Soooo--ooSooo-------------------------------------oooSoo------------------oSoSoo-------------ooooSo----------------------------------------
------------------------------ooSooSo---------------------------------------------oooS--------------oooo-------------------------------------------------------------------------------------oSo--------
-----------------------------------------ooooooo-------------ooo-------ooo----------------oSooSo-----------------ooo-----ooSoSo--------ooooooo-----SSoSo-----ooooo-------oooo-------SooSo---------------
--------------------------------ooooo-----y--g--y---------------------y---G--------oo----------------oo---------R-y--gy-----------------y------k--------------------------------------------oooooo------
------------------------XXXXX-k---g----XXXXXXXXXXX---------XXXXXXXXXXXXXXXXXXXXX--y--k------oooo--r-----Y----XXXXXXXXXXX-oooooo-------XXXXXXXXXXX----oo--XXXXXXXXXXX---oooo--------oooooo----Y-RkY------
XXXXXXXXXXXX-gGk---XXXXXXXXXXXXXXXXXXXXXXXXXXXXXXX-ooo-----XXXXXXXXXXXXXXXXXXXXXXXXXXXXXX--Y-k-g-XXXXXXXXXX--XXXXXXXXXXX----r-rg------XXXXXXXXXXX--------XXXXXXXXXXX---y--k---XX------G---XXXXXXXXX-----
XXXXXXXXXXXXXXXXXXXXXXXXXXXXXXXXXXXXXXXXXXXXXXXXXX----G-XXXXXXXXXXXXXXXXXXXXXXXXXXXXXXXXXXXXXXXXXXXXXXXXXXX--XXXXXXXXXXXXXXXXXXXXXXXXXXXXXXXXXXXXXXXXXXXXXXXXXXXXXXX--XXXXXXXXXXXXXXXXXXXXXXXXXXXXX-----
XXXXXXXXXXXXXXXXXXXXXXXXXXXXXXXXXXXXXXXXXXXXXXXXXXXXXXXXXXXXXXXXXXXXXXXXXXXXXXXXXXXXXXXXXXXXXXXXXXXXXXXXXXXXXXXXXXXXXXXXXXXXXXXXXXXXXXXXXXXXXXXXXXXXXXXXXXXXXXXXXXXXXXXXXXXXXXXXXXXXXXXXXXXXXXXXXXXXXXXX

