--------------------------------------------------------------------------------------------------------------------------------------------------------------------------------------------------------
--------------------------------------------------------------------------------------------------------------------------------------------------------------------------------------------------------
--------------------------------------------------------------------------------------------------------------------------------------------------------------------------------------------------------
--------------------------------------------------------------------------------------------------------------------------------------------------------------------------------------------------------
--------------------------------------------------------------------------------------------------------------------------------------------------------------------------------------------------------
--------------------------------------------------------------------------------------------------------------------------------------------------------------------------------------------------------
--------------------------------------------------------------------------------------------------------------------------------------------------------------------------------------------------------
--------------------------------------------------------------------------------------------------------------------------------------------------------------------------------------------------------
--------------------------------------------------------------------------------------------------------------------------------------------------------------------------------------------------------
--------------------------------------------------------------------------------------------------------------------------------------------------------------------------------------------------------
--------------------------------------------------------------------------------------------------------------------------------------------------------------------------------------------------------
--------------------------------------------------------------------------------------------------------------------------------------------------------------------------------------------------------
------------------Soo------------------------------------------------------------------------oooo-------------------------------------------------------------------------------------------------------
-----------------------------------ooo--------------------------------------------------------------------------------------------SSooooo----------------oooo--------------------oooS-------------------
-----------------ooooo-----------------------------------------------oo---oSooooSS----------oooo--------------------------------------------------------------------------------------------------------
-----------------r---r---ooo------------------------------oooo-------Ky---------------------k--k---oooo-------------------------oooooooo----oooS---------oooo-----oooo--------------oooo-----------ooS--
--------------XXXXXXXXX-r---Y-XXXX----k----------------------y-k-XXXXXXXX-ooooooo---XXXXXXXXXXXXXX--g--r--XXXXX-------XXXXXXXXX------y------------------------------rr-----------G-Gk----XX-------------
--------------XXXXXXXXXXXXXXXXXXXXXXXXXX---XXXXXX--------XXXXXXXXXXXXXXXX---------g-XXXXXXXXXXXXXXXXXXXXXXXXXXX-------XXXXXXXXXXXXXXXXXXXX-oooooo----XXXXXXXXXX--XXXXXXXX-------XXXXXXXXXXXXXX------oo--
--------------XXXXXXXXXXXXXXXXXXXXXXXXXX---XXXXXXXXXX----XXXXXXXXXXXXXXXXXXXXXXXXXXXXXXXXXXXXXXXXXXXXXXXXXXXXXX--r--k-XXXXXXXXXXXXXXXXXXXX-------g---XXXXXXXXXX--XXXXXXXX-------XXXXXXXXXXXXXXXXXX-r----
XXXXXXXXXXXXXXXXXXXXXXXXXXXXXXXXXXXXXXXXXXXXXXXXXXXXXXXXXXXXXXXXXXXXXXXXXXXXXXXXXXXXXXXXXXXXXXXXXXXXXXXXXXXXXXXXXXXXXXXXXXXXXXXXXXXXXXXXXXXXXXXXXXXXXXXXXXXXXXXXXXXXXXXXXXXXXXXXXXXXXXXXXXXXXXXXXXXXXXXX

