--------------------------------------------------------------------------------------------------------------------------------------------------------------------------------------------------------
--------------------------------------------------------------------------------------------------------------------------------------------------------------------------------------------------------
--------------------------------------------------------------------------------------------------------------------------------------------------------------------------------------------------------
--------------------------------------------------------------------------------------------------------------------------------------------------------------------------------------------------------
--------------------------------------------------------------------------------------------------------------------------------------------------------------------------------------------------------
--------------------------------------------------------------------------------------------------------------------------------------------------------------------------------------------------------
--------------------------------------------------------------------------------------------------------------------------------------------------------------------------------------------------------
--------------------------------------------------------------------------------------------------------------------------------------------------------------------------------------------------------
--------------------------------------------------------------------------------------------------------------------------------------------------------------------------------------------------------
--------------------------------------------------------------------------------------------------------------------------------------------------------------------------------------------------------
--------------------------------------------------------------------------------------------------------------------------------------------------------------------------------------------------------
--------------------------------------------------------------------------------------------------------------------------------------------------------------------------------------------------------
---------------------------------------------------ooSSS------------------------------------------------ooSo--------------------------------------------------------------------------------------------
---------------------------------------------------------------------------SSS--------------------------------------------------------------------------oooSo-------------------------------------------
-----------------------------------ooooo-------------ooooo---------------------------------------------ooooooo----------oo-------------------------------------------------oSo-------------SoSooo-------
--------------------oooSo----------Y--yG------------R-r-y-------------------ooo-------------------------------k------g--r----------------oooo-----------oooo--------------------------------------------
---------------------------XXX----XXXXXXXX--------XXXXXXXXX---oo-----XXXX-g-rr--y--------------------XXXXXXXXXXX----XXXXXXX----------------------XXX-kg----YKr--oooo------oo-------------ooooooo--------
-----------ooo----ooooo----XXX----XXXXXXXXXXXXXXXXXXXXXXXXX-k--------XXXXXXXXXXXXX---ooo-------------XXXXXXXXXXX----XXXXXXX------XXXXX----oooo---XXXXXXXXXXXXXX-----------r--g-----yyy----krykYr-r-XXXXX
-------------------g--r----XXXXXXXXXXXXXXXXXXXXXXXXXXXXXXXXXXXXXXXXXXXXXXXXXXXXXXX-RGr------G-r-XXXXXXXXXXXXXXXXXXXXXXXXXXX-g----XXXXX--r-----kK-XXXXXXXXXXXXXXXXXXXXXXXXXXXXXXXXXXXXXXXXXXXXXXXXXXXXXXX
XXXXXXXXXXXXXXXXXXXXXXXXXXXXXXXXXXXXXXXXXXXXXXXXXXXXXXXXXXXXXXXXXXXXXXXXXXXXXXXXXXXXXXXXXXXXXXXXXXXXXXXXXXXXXXXXXXXXXXXXXXXXXXXXXXXXXXXXXXXXXXXXXXXXXXXXXXXXXXXXXXXXXXXXXXXXXXXXXXXXXXXXXXXXXXXXXXXXXXXX

