--------------------------------------------------------------------------------------------------------------------------------------------------------------------------------------------------------
--------------------------------------------------------------------------------------------------------------------------------------------------------------------------------------------------------
--------------------------------------------------------------------------------------------------------------------------------------------------------------------------------------------------------
--------------------------------------------------------------------------------------------------------------------------------------------------------------------------------------------------------
--------------------------------------------------------------------------------------------------------------------------------------------------------------------------------------------------------
--------------------------------------------------------------------------------------------------------------------------------------------------------------------------------------------------------
--------------------------------------------------------------------------------------------------------------------------------------------------------------------------------------------------------
--------------------------------------------------------------------------------------------------------------------------------------------------------------------------------------------------------
--------------------------------------------------------------------------------------------------------------------------------------------------------------------------------------------------------
--------------------------------------------------------------------------------------------------------------------------------------------------------------------------------------------------------
--------------------------------------------------------------------------------------------------------------------------------------------------------------------------------------------------------
--------------------------------------------------------------------------------------------------------------------------------------------------------------------------------------------------------
-----------------------------------------------------------------oSoSoS------------------------------------oooSoS---------------------------------------------------------------------------------------
--------------ooS------------------SoSSo-----------------------------------------------------------------------------------------------------------oSSo-------------------------------oooooS------------
------------------------------------------------------------------ooooooo----------------------------------oooo-----------------------------------------------------------------------------------------
-----------ooooooo--ooSooSSS---------oooo----oooo---------------------K----------------------------------R-kK-R-----------oooo-----------ooooo--ooooo------------oSSooooo------ooo------ooooo-----------
---------------r-r-----------------------k------------oo--------XXXXXXXXXX-------------------------XX---XXXXXXXXXXX---------y---XXXXXXXX-----k--yRrg-----------------------XX-------------y-------------
XXXXXXXXXXXXXXXXXXX--ooooooo-----XXXXXXXXXXX-ooooo------Y-K-XXXXXXXXXXXXXX---ooo----oo----XXXX---XXXX---XXXXXXXXXXXXXXXXXXXXXXXXXXXXXXXXXXXXXXXXXXXXXXXXX--ooo---ooooooo---XX---oo--XXXXXXXXXX-------oo-
XXXXXXXXXXXXXXXXXXX--y-----R-----XXXXXXXXXXX---Y-----XXXXXXXXXXXXXXXXXXXXXXX----------g---XXXX---XXXX---XXXXXXXXXXXXXXXXXXXXXXXXXXXXXXXXXXXXXXXXXXXXXXXXX--r--K--k---k-----XX----y--XXXXXXXXXX--------K-
XXXXXXXXXXXXXXXXXXXXXXXXXXXXXXXXXXXXXXXXXXXXXXXXXXXXXXXXXXXXXXXXXXXXXXXXXXXXXXXXXXXXXXXXXXXXXXXXXXXXXXXXXXXXXXXXXXXXXXXXXXXXXXXXXXXXXXXXXXXXXXXXXXXXXXXXXXXXXXXXXXXXXXXXXXXXXXXXXXXXXXXXXXXXXXXXXXXXXXXX

