--------------------------------------------------------------------------------------------------------------------------------------------------------------------------------------------------------
--------------------------------------------------------------------------------------------------------------------------------------------------------------------------------------------------------
--------------------------------------------------------------------------------------------------------------------------------------------------------------------------------------------------------
--------------------------------------------------------------------------------------------------------------------------------------------------------------------------------------------------------
--------------------------------------------------------------------------------------------------------------------------------------------------------------------------------------------------------
--------------------------------------------------------------------------------------------------------------------------------------------------------------------------------------------------------
--------------------------------------------------------------------------------------------------------------------------------------------------------------------------------------------------------
--------------------------------------------------------------------------------------------------------------------------------------------------------------------------------------------------------
--------------------------------------------------------------------------------------------------------------------------------------------------------------------------------------------------------
--------------------------------------------------------------------------------------------------------------------------------------------------------------------------------------------------------
--------------------------------------------------------------------------------------------------------------------------------------------------------------------------------------------------------
--------------------------------------------------------------------------------------------------------------------------------------------------------------------------------------------------------
----------------------------------------------------------------------------------------------------------------------------------------------oooo------------------------------------------------------
-------------ooooooo------ooSo------------------------------------------------SSSoS-------------------------------------------------SooSoooo----------------------------------------SoooS---------------
-----------------------------------------------------------------------oooo---------------oo----------------------ooSo----------------------------------ooooo--oSoSoooo-----------------------ooo-------
--------------ooooo-----oooo-------ooSoo-----------Soo-------------------kg--ooooo------------r--------ooSSSo----------------oSo-----ooooooo---k--Yy----------------------oSoSSo-----ooooo----Y---y-----
---------------g-------yR--krGg-------------------------------------XXXXXXXX--kK--ry--XXXXXXXXXX---------------ooooooooo-----------R-k--Gk-k-XXXXXXXX---ooo-------ooo-------------g---R---r-XXXXXXXX----
-----------XXXXXXXXXXXXXXXXXXXXX---oooo----------ooooo--------XXX---XXXXXXXXXXXXXXXXXXXXXXXXXXXX------oooooo----g-yG-RY-----oooo--XXXXXXXXXXXXXXXXXXX-r--Rr-r--g--yy------oooooo-XXXXXXXXXXXXXXXXXXX----
-----------XXXXXXXXXXXXXXXXXXXXX---r-y-y---------k---Yry-XX---XXX---XXXXXXXXXXXXXXXXXXXXXXXXXXXXXXXX-----k----XXXXXXXXXXX--y---y--XXXXXXXXXXXXXXXXXXXXXXXXXXXXXXXXXXXXXXX------k-XXXXXXXXXXXXXXXXXXX----
XXXXXXXXXXXXXXXXXXXXXXXXXXXXXXXXXXXXXXXXXXXXXXXXXXXXXXXXXXXXXXXXXXXXXXXXXXXXXXXXXXXXXXXXXXXXXXXXXXXXXXXXXXXXXXXXXXXXXXXXXXXXXXXXXXXXXXXXXXXXXXXXXXXXXXXXXXXXXXXXXXXXXXXXXXXXXXXXXXXXXXXXXXXXXXXXXXXXXXXX

