--------------------------------------------------------------------------------------------------------------------------------------------------------------------------------------------------------
--------------------------------------------------------------------------------------------------------------------------------------------------------------------------------------------------------
--------------------------------------------------------------------------------------------------------------------------------------------------------------------------------------------------------
--------------------------------------------------------------------------------------------------------------------------------------------------------------------------------------------------------
--------------------------------------------------------------------------------------------------------------------------------------------------------------------------------------------------------
--------------------------------------------------------------------------------------------------------------------------------------------------------------------------------------------------------
--------------------------------------------------------------------------------------------------------------------------------------------------------------------------------------------------------
--------------------------------------------------------------------------------------------------------------------------------------------------------------------------------------------------------
--------------------------------------------------------------------------------------------------------------------------------------------------------------------------------------------------------
--------------------------------------------------------------------------------------------------------------------------------------------------------------------------------------------------------
--------------------------------------------------------------------------------------------------------------------------------------------------------------------------------------------------------
--------------------------------------------------------------------------------------------------------------------------------------------------------------------------------------------------------
-----------------------------------------------------------------------------------------------------------SoSS-------------------------------------------------------------ooSSo-----------------------
--------------------------------------------------------------------------oSS-------SSSo----------------------------------------------------------------------------------------------ooo--------ooo----
--------------------ooo-----------------------------------------oSooo-----------------------------------oooooooo----------------ooSo---oSoooS----ooooSoo-------------------ooooooooo--------------------
--------------------K--r---ooS------ooSo-----------------------------------oooo-----oooo---SooS---------GG-rK----------oo-------------------------------------------Soo---------------oooooo---oo-------
------------XXXXXXXXXXXXXX--------------------r-G-------y--------oo-----r-k----------g-----------------XXXXXXXXXX-------k--------ooo--ooooooooo-----ooooo-----------------XXXXXXXXXXX--R---y-----g------
------------XXXXXXXXXXXXXX--------ooo--------XXXXXXXXXXXXXXXX--k---k-g-XXXXXXXXXXXXXXXXXX--oooo--XXXXXXXXXXXXXXXXXXXXXXXXXXXX------g---kY---y----k---K-----------ooooo----XXXXXXXXXXXXXXXXXXXXXXXXXXXXXX
XXXXXXXXXXXXXXXXXXXXXXXXXX-g-yy---r-r-Gk-XXXXXXXXXXXXXXXXXXXXXXXXXXXXXXXXXXXXXXXXXXXXXXXX---g-k--XXXXXXXXXXXXXXXXXXXXXXXXXXXXXXXXXXXXXXXXXXXXXXXXXXXXXXXXX---y-----r------XXXXXXXXXXXXXXXXXXXXXXXXXXXXXX
XXXXXXXXXXXXXXXXXXXXXXXXXXXXXXXXXXXXXXXXXXXXXXXXXXXXXXXXXXXXXXXXXXXXXXXXXXXXXXXXXXXXXXXXXXXXXXXXXXXXXXXXXXXXXXXXXXXXXXXXXXXXXXXXXXXXXXXXXXXXXXXXXXXXXXXXXXXXXXXXXXXXXXXXXXXXXXXXXXXXXXXXXXXXXXXXXXXXXXXX

