--------------------------------------------------------------------------------------------------------------------------------------------------------------------------------------------------------
--------------------------------------------------------------------------------------------------------------------------------------------------------------------------------------------------------
--------------------------------------------------------------------------------------------------------------------------------------------------------------------------------------------------------
--------------------------------------------------------------------------------------------------------------------------------------------------------------------------------------------------------
--------------------------------------------------------------------------------------------------------------------------------------------------------------------------------------------------------
--------------------------------------------------------------------------------------------------------------------------------------------------------------------------------------------------------
--------------------------------------------------------------------------------------------------------------------------------------------------------------------------------------------------------
--------------------------------------------------------------------------------------------------------------------------------------------------------------------------------------------------------
--------------------------------------------------------------------------------------------------------------------------------------------------------------------------------------------------------
--------------------------------------------------------------------------------------------------------------------------------------------------------------------------------------------------------
--------------------------------------------------------------------------------------------------------------------------------------------------------------------------------------------------------
--------------------------------------------------------------------------------------------------------------------------------------------------------------------------------------------------------
--------------------------------------------------------------------------------------------------------------------------------------------------------------------------------------------------------
------------------------------------------------------------------------------ooSo------------------------------------------------ooSo---------------oooS-----------------------------------------------
-------------------------------ooo----oooS-------------------------------oo-----------------------------------------------------------------------------------SSSSoo-------------------------oooo-------
----------------kk----------------------------oooSoo-------------oooo---y----oooo-----oooooSo--------------------------ooooo----ooooo------------------oo-------------------------oooo-------yg---------
XXXXXXXXXXXXXXXXXXXX-----------ooooo----oo-----------------------g----XXXXXX-k--Grk------------------------------------------------g---XXXXX---gy-----r-Gg---ooooooo-----XXXXX-----------XXXXXXXXXXXXXX-
XXXXXXXXXXXXXXXXXXXX------------------y--------oooo-----------XXXXXXXXXXXXXXXXXXXXXX--oooooo--------XXXXX---ooooo-XX---oooo---XXXXXXXXXXXXXXXXXXXXXXXXXXXXX---r----G-----XXXXX----oooo---XXXXXXXXXXXXXX-
XXXXXXXXXXXXXXXXXXXX-----XXXXXXXXXXXXXXXXXXXX-r-yR-y---r------XXXXXXXXXXXXXXXXXXXXXX--yr-g---K------XXXXX-k---rr--XX--gY------XXXXXXXXXXXXXXXXXXXXXXXXXXXXXXXXXXXXXXXXXXXXXXXX-gr--yg--y-XXXXXXXXXXXXXX-
XXXXXXXXXXXXXXXXXXXXXXXXXXXXXXXXXXXXXXXXXXXXXXXXXXXXXXXXXXXXXXXXXXXXXXXXXXXXXXXXXXXXXXXXXXXXXXXXXXXXXXXXXXXXXXXXXXXXXXXXXXXXXXXXXXXXXXXXXXXXXXXXXXXXXXXXXXXXXXXXXXXXXXXXXXXXXXXXXXXXXXXXXXXXXXXXXXXXXXXX

