--------------------------------------------------------------------------------------------------------------------------------------------------------------------------------------------------------
--------------------------------------------------------------------------------------------------------------------------------------------------------------------------------------------------------
--------------------------------------------------------------------------------------------------------------------------------------------------------------------------------------------------------
--------------------------------------------------------------------------------------------------------------------------------------------------------------------------------------------------------
--------------------------------------------------------------------------------------------------------------------------------------------------------------------------------------------------------
--------------------------------------------------------------------------------------------------------------------------------------------------------------------------------------------------------
--------------------------------------------------------------------------------------------------------------------------------------------------------------------------------------------------------
--------------------------------------------------------------------------------------------------------------------------------------------------------------------------------------------------------
--------------------------------------------------------------------------------------------------------------------------------------------------------------------------------------------------------
--------------------------------------------------------------------------------------------------------------------------------------------------------------------------------------------------------
--------------------------------------------------------------------------------------------------------------------------------------------------------------------------------------------------------
--------------------------------------------------------------------------------------------------------------------------------------------------------------------------------------------------------
---------------------oSo----------------------------------ooo----------------------------------------------------------------------------------------------ooooo---------------oSo----------------------
------------------------------------------------------------------------------------------------oSS-----------------------------------------------------------------------------------------------------
----------------------oooo-------------------------------oooo---oooo--------------oSooo-------------------SoooSo---oSoooo-----ooS---------------------------oooooo----oooo------oo------ooo-------------
--------------------rR-----------------------ooSSSooo--r-----k-----y------------------------------------------------------------------SooS--------K--------k-gRrk-R----------------G-------r------------
---------------r-r-XXXXXXXX------XXXXX----------------XXXXXXXXXXXXXXX-----------oooooo--XXXXXX--r-Y-----ooooo-------ooooo-------oo-----------XXXXXXX-----XXXXXXXXXXX---oooo-XXXXXXXXXXXXXXXXXX----XXXX--
-------------XXXXXXXXXXXXXX------XXXXXXXXXX-oooooo----XXXXXXXXXXXXXXX--------------kr---XXXXXXXXXXXXXX-y--KYk---------r--Y-------------ooo---XXXXXXX-----XXXXXXXXXXX-k-rRYK-XXXXXXXXXXXXXXXXXX----XXXXXX
XXXXXXXXXXXXXXXXXXXXXXXXXXX-ky-K-XXXXXXXXXX----y----k-XXXXXXXXXXXXXXXXXXXX-----XXXXXXXXXXXXXXXXXXXXXXXXXXXXXXXXXXXXXXXXXXXXXXXXXXXX-G--g--rR-XXXXXXX-----XXXXXXXXXXXXXXXXXXXXXXXXXXXXXXXXXXXXXXXXXXXXXXX
XXXXXXXXXXXXXXXXXXXXXXXXXXXXXXXXXXXXXXXXXXXXXXXXXXXXXXXXXXXXXXXXXXXXXXXXXXXXXXXXXXXXXXXXXXXXXXXXXXXXXXXXXXXXXXXXXXXXXXXXXXXXXXXXXXXXXXXXXXXXXXXXXXXXXXXXXXXXXXXXXXXXXXXXXXXXXXXXXXXXXXXXXXXXXXXXXXXXXXXX

