--------------------------------------------------------------------------------------------------------------------------------------------------------------------------------------------------------
--------------------------------------------------------------------------------------------------------------------------------------------------------------------------------------------------------
--------------------------------------------------------------------------------------------------------------------------------------------------------------------------------------------------------
--------------------------------------------------------------------------------------------------------------------------------------------------------------------------------------------------------
--------------------------------------------------------------------------------------------------------------------------------------------------------------------------------------------------------
--------------------------------------------------------------------------------------------------------------------------------------------------------------------------------------------------------
--------------------------------------------------------------------------------------------------------------------------------------------------------------------------------------------------------
--------------------------------------------------------------------------------------------------------------------------------------------------------------------------------------------------------
--------------------------------------------------------------------------------------------------------------------------------------------------------------------------------------------------------
--------------------------------------------------------------------------------------------------------------------------------------------------------------------------------------------------------
--------------------------------------------------------------------------------------------------------------------------------------------------------------------------------------------------------
--------------------------------------------------------------------------------------------------------------------------------------------------------------------------------------------------------
---------------oSooSS----------------ooo---------------------Sooooo---------------------------------------ooo-----------------------ooo----------------------------------------------------Soo----------
------------------------------------------------------------------------------------------oSoo-----oooSo------------------------------------------------------------------------------------------------
--------------oooooooo--------------oo--------------------oooooo--------------ooooo-----------------------oooo---------------------oooooo------SooSo--------SSoSoo-------------------------oooo---------
--------------g----k-----ooSSoooo----------oooooooo-------KgGrk--------------kk-y--------oooooo-----oo----k-------------------------------------------------------------------------------G--r----------
------------XXXXXXXXXXX-----------XXXXXXXX---------------XXXXXXXXXXX------XXXXXXXXXX-----K--------kr--y--XXXXXX----oooo-XXXXX-----XXXXXXXXX----ooooo-------oooo----XXXXX------XXXXXXXXXXXXXXXXXX-oooo---
------------XXXXXXXXXXX--ooooooo--XXXXXXXX--ooooo----XXXXXXXXXXXXXXX------XXXXXXXXXXXXXXXXXXXXXXXXXXXXXXXXXXXXX-----rr--XXXXX-----XXXXXXXXX-----r-----------y--R-R-XXXXX---oo-XXXXXXXXXXXXXXXXXX--------
XXXXXXXXXXXXXXXXXXXXXXX--r--KRk-k-XXXXXXXX-k---k-----XXXXXXXXXXXXXXX------XXXXXXXXXXXXXXXXXXXXXXXXXXXXXXXXXXXXXXXXXXXXXXXXXXXXXXXXXXXXXXXXXXXXXXXXXXXXXXXXXXXXXXXXXXXXXX-r--k-XXXXXXXXXXXXXXXXXXXXXXXXXX
XXXXXXXXXXXXXXXXXXXXXXXXXXXXXXXXXXXXXXXXXXXXXXXXXXXXXXXXXXXXXXXXXXXXXXXXXXXXXXXXXXXXXXXXXXXXXXXXXXXXXXXXXXXXXXXXXXXXXXXXXXXXXXXXXXXXXXXXXXXXXXXXXXXXXXXXXXXXXXXXXXXXXXXXXXXXXXXXXXXXXXXXXXXXXXXXXXXXXXXX

