--------------------------------------------------------------------------------------------------------------------------------------------------------------------------------------------------------
--------------------------------------------------------------------------------------------------------------------------------------------------------------------------------------------------------
--------------------------------------------------------------------------------------------------------------------------------------------------------------------------------------------------------
--------------------------------------------------------------------------------------------------------------------------------------------------------------------------------------------------------
--------------------------------------------------------------------------------------------------------------------------------------------------------------------------------------------------------
--------------------------------------------------------------------------------------------------------------------------------------------------------------------------------------------------------
--------------------------------------------------------------------------------------------------------------------------------------------------------------------------------------------------------
--------------------------------------------------------------------------------------------------------------------------------------------------------------------------------------------------------
--------------------------------------------------------------------------------------------------------------------------------------------------------------------------------------------------------
--------------------------------------------------------------------------------------------------------------------------------------------------------------------------------------------------------
--------------------------------------------------------------------------------------------------------------------------------------------------------------------------------------------------------
--------------------------------------------------------------------------------------------------------------------------------------------------------------------------------------------------------
--------------------------------------------------------------------------------------------Soo---------------------------------------------------------------------------------------------------------
-------------------SSoooooo-------------------------------------------------------------------------------------------------------------------------ooSo------------------------------------------------
--------------------------------------------------oSSo---------------------------------------oooo----------------------------------------------------------ooo------------------------------------------
------------------oooooooo------------------------------ooS----oooooSo---------------------g--------------*----*---oooo--------------oooooo---------ooooo-----------oSSoo----SoSo-----------------------
-------------------y-k-kgr---------------oo------oo-------------------------------oooo--XXXXXXXXXXXXXXX---*----*------------oo----------------oooo----yk---oooo----------------------------------ooo-XXX
-----------------XXXXXXXXXXXXXXXX------------------y----oooo---ooooooooo----------ry--y-XXXXXXXXXXXXXXXXXXXXXXXXX----oooo---K-rr---oooooooo---Yyg--XXXXXXX-r--k---oooooooo----oo----------------yg-r-XXX
XXXXXXXXXXXXXX---XXXXXXXXXXXXXXXXXXXX---XXXXXXXXXXXXXXX-r--kG--k-r----y--XXX----XXXXXXXXXXXXXXXXXXXXXXXXXXXXXXXXX----ry----XXXXXX--RG---Kr--XXXXXXXXXXXXXXXXXXXXX-RRy-y------g--R-----rk----XXXXXXXXXXXX
XXXXXXXXXXXXXXXXXXXXXXXXXXXXXXXXXXXXXXXXXXXXXXXXXXXXXXXXXXXXXXXXXXXXXXXXXXXXXXXXXXXXXXXXXXXXXXXXXXXXXXXXXXXXXXXXXXXXXXXXXXXXXXXXXXXXXXXXXXXXXXXXXXXXXXXXXXXXXXXXXXXXXXXXXXXXXXXXXXXXXXXXXXXXXXXXXXXXXXXX

