--------------------------------------------------------------------------------------------------------------------------------------------------------------------------------------------------------
--------------------------------------------------------------------------------------------------------------------------------------------------------------------------------------------------------
--------------------------------------------------------------------------------------------------------------------------------------------------------------------------------------------------------
--------------------------------------------------------------------------------------------------------------------------------------------------------------------------------------------------------
--------------------------------------------------------------------------------------------------------------------------------------------------------------------------------------------------------
--------------------------------------------------------------------------------------------------------------------------------------------------------------------------------------------------------
--------------------------------------------------------------------------------------------------------------------------------------------------------------------------------------------------------
--------------------------------------------------------------------------------------------------------------------------------------------------------------------------------------------------------
--------------------------------------------------------------------------------------------------------------------------------------------------------------------------------------------------------
--------------------------------------------------------------------------------------------------------------------------------------------------------------------------------------------------------
--------------------------------------------------------------------------------------------------------------------------------------------------------------------------------------------------------
--------------------------------------------------------------------------------------------------------------------------------------------------------------------------------------------------------
--------------------------------------------------------------------------------------------------------------------------------------------ooS-----oooo---------------------------------Soo------------
----------------------------------------------------------------------------------------------------ooo-------------------------------------------------------------------------------------------------
------------------oooo------------------------------------------------------------------oSSSoS-------------------------------------------------------oooooo-----------------------------oooo----ooo-----
---------------r-K---------------------------------------oSoo-----oSoSoSoo-----------------------------------------ooSooo-------oSooo--------g-y---y-y-kr-------------------------------G----G----------
XXXXXXXXXXXXXXXXXXXXXXX---ooo------------oo---------------------------------XX--ooooo---ooooooo-----k-G-------------------------------XXXXXXXXXXXXXXXXXXXXXX----XXXX---------XXXX----XXXXXXXXXX--ooooo--
XXXXXXXXXXXXXXXXXXXXXXX-y--------ooo----yyg---ooooo------ooooo------oooooo--XX------K-------y---XXXXXXXX---XXXXXX-oooooo-------oooooo-XXXXXXXXXXXXXXXXXXXXXXXXXXXXXX---ooooo-XXXX----XXXXXXXXXX----ry---
XXXXXXXXXXXXXXXXXXXXXXXXXXXXXX---rk--XXXXXXXX-----K----k-----k-XX-----K--Y--XXXXXXXXXXXXXXXXXXXXXXXXXXXX---XXXXXX--KY---krK--y--------XXXXXXXXXXXXXXXXXXXXXXXXXXXXXX-----r-G-XXXX----XXXXXXXXXXXXXXXXXXX
XXXXXXXXXXXXXXXXXXXXXXXXXXXXXXXXXXXXXXXXXXXXXXXXXXXXXXXXXXXXXXXXXXXXXXXXXXXXXXXXXXXXXXXXXXXXXXXXXXXXXXXXXXXXXXXXXXXXXXXXXXXXXXXXXXXXXXXXXXXXXXXXXXXXXXXXXXXXXXXXXXXXXXXXXXXXXXXXXXXXXXXXXXXXXXXXXXXXXXXX

