--------------------------------------------------------------------------------------------------------------------------------------------------------------------------------------------------------
--------------------------------------------------------------------------------------------------------------------------------------------------------------------------------------------------------
--------------------------------------------------------------------------------------------------------------------------------------------------------------------------------------------------------
--------------------------------------------------------------------------------------------------------------------------------------------------------------------------------------------------------
--------------------------------------------------------------------------------------------------------------------------------------------------------------------------------------------------------
--------------------------------------------------------------------------------------------------------------------------------------------------------------------------------------------------------
--------------------------------------------------------------------------------------------------------------------------------------------------------------------------------------------------------
--------------------------------------------------------------------------------------------------------------------------------------------------------------------------------------------------------
--------------------------------------------------------------------------------------------------------------------------------------------------------------------------------------------------------
--------------------------------------------------------------------------------------------------------------------------------------------------------------------------------------------------------
--------------------------------------------------------------------------------------------------------------------------------------------------------------------------------------------------------
--------------------------------------------------------------------------------------------------------------------------------------------------------------------------------------------------------
---------------------------------------------------------------------------------------------SSoooo------------------------------------------------------------------------------------------------ooo--
--------------------------------------------------ooooo--------------------------oSo--ooSo--------------------oSo---------ooooooo-----------------------------------------------------------------------
---------------------------oSS-----------------------------------------ooooo-----------------ooooo--------------------------------------------------------------ooo--------oooooooSo-------------ooo----
------------------------------------------------ooooooooo-----------------------ooo----------g---Y-------------oo-----------oooo------------------------------------------------------ooooSoSo-------Y--
--------------------XXX---ooooo-XX----------------r-Gg--g-XX----------oooooo----r-G----R---XXXXXXXXXX--------G-----------ky----rY---K-y------------------------------------ooooooo--------------XXXXXXXX
XXXXXXXXXXXXX---oo--XXX----k-k--XX-------g-KrY-XXXXXXXXXXXXXXX--R------r-gRyG-XXXXXXXXXXXXXXXXXXXXXXX------XXXXXXXXXXXXXXXXXXXXXXXXXXXXX-------r--------ooo-----rg--XXX----k--r--R----ooooooooo-XXXXXXXX
XXXXXXXXXXXXX--r----XXXXXXXXXXXXXXXXX---XXXXXXXXXXXXXXXXXXXXXXXXXXXXXXXXXXXXXXXXXXXXXXXXXXXXXXXXXXXXX--g---XXXXXXXXXXXXXXXXXXXXXXXXXXXXX---y--XXXXXXXX------XXXXXXXXXXX---XXXXXXXXXXX-ry-g----g-XXXXXXXX
XXXXXXXXXXXXXXXXXXXXXXXXXXXXXXXXXXXXXXXXXXXXXXXXXXXXXXXXXXXXXXXXXXXXXXXXXXXXXXXXXXXXXXXXXXXXXXXXXXXXXXXXXXXXXXXXXXXXXXXXXXXXXXXXXXXXXXXXXXXXXXXXXXXXXXXXXXXXXXXXXXXXXXXXXXXXXXXXXXXXXXXXXXXXXXXXXXXXXXXX

