--------------------------------------------------------------------------------------------------------------------------------------------------------------------------------------------------------
--------------------------------------------------------------------------------------------------------------------------------------------------------------------------------------------------------
--------------------------------------------------------------------------------------------------------------------------------------------------------------------------------------------------------
--------------------------------------------------------------------------------------------------------------------------------------------------------------------------------------------------------
--------------------------------------------------------------------------------------------------------------------------------------------------------------------------------------------------------
--------------------------------------------------------------------------------------------------------------------------------------------------------------------------------------------------------
--------------------------------------------------------------------------------------------------------------------------------------------------------------------------------------------------------
--------------------------------------------------------------------------------------------------------------------------------------------------------------------------------------------------------
--------------------------------------------------------------------------------------------------------------------------------------------------------------------------------------------------------
--------------------------------------------------------------------------------------------------------------------------------------------------------------------------------------------------------
--------------------------------------------------------------------------------------------------------------------------------------------------------------------------------------------------------
--------------------------------------------------------------------------------------------------------------------------------------------------------------------------------------------------------
----------------------------------------------SSoo------------------------------------------------------------------------------------------------------------------------------------------------------
---------------------------------------------------------------------------------------SSoS-----------SSooooSo-----------------------------------------------------------------------ooSSo--------------
----------------------------oSoooo--------------oooo---------------------------------------------------------------------------Sooo--------oSooooo---------oSSoSS---------------------------------------
--------------------ooo------------------------R---g----------ooSoooSo---------------oooooo-------------oooo-------oSSSoS--------------------------------------------SoooS-----ooo-----oooo-------------
-------------------------ooooooo---XXX------XXXXXXXXXX----------------------------XX--r---yy-XX------Gk---g------------------ooooooo-------ooooo----Gk--k----ooo----------------------------------------
XXXXXXXXXXXXXX---------------y-Y---XXX------XXXXXXXXXX---ooo-----ooo-----------XXXXXXXXXXXXXXXX-----XXXXXXXXXXX------ooo---------rG----------k-k---XXXXXXX---y---k-----oo---XXXXXXXXXXXXXXXX-ooo---XXXXX
XXXXXXXXXXXXXXXXXX-g----XXXXXXXXXXXXXX------XXXXXXXXXX-k---k--yG-g--rg----XXX--XXXXXXXXXXXXXXXX-----XXXXXXXXXXXXXX--G--g----XXXXXXXXXXXXXXXXXXXXXXXXXXXXXXXXXXXXXXX-------r-XXXXXXXXXXXXXXXX--y--y-XXXXX
XXXXXXXXXXXXXXXXXXXXXXXXXXXXXXXXXXXXXXXXXXXXXXXXXXXXXXXXXXXXXXXXXXXXXXXXXXXXXXXXXXXXXXXXXXXXXXXXXXXXXXXXXXXXXXXXXXXXXXXXXXXXXXXXXXXXXXXXXXXXXXXXXXXXXXXXXXXXXXXXXXXXXXXXXXXXXXXXXXXXXXXXXXXXXXXXXXXXXXXX

