--------------------------------------------------------------------------------------------------------------------------------------------------------------------------------------------------------
--------------------------------------------------------------------------------------------------------------------------------------------------------------------------------------------------------
--------------------------------------------------------------------------------------------------------------------------------------------------------------------------------------------------------
--------------------------------------------------------------------------------------------------------------------------------------------------------------------------------------------------------
--------------------------------------------------------------------------------------------------------------------------------------------------------------------------------------------------------
--------------------------------------------------------------------------------------------------------------------------------------------------------------------------------------------------------
--------------------------------------------------------------------------------------------------------------------------------------------------------------------------------------------------------
--------------------------------------------------------------------------------------------------------------------------------------------------------------------------------------------------------
--------------------------------------------------------------------------------------------------------------------------------------------------------------------------------------------------------
--------------------------------------------------------------------------------------------------------------------------------------------------------------------------------------------------------
--------------------------------------------------------------------------------------------------------------------------------------------------------------------------------------------------------
--------------------------------------------------------------------------------------------------------------------------------------------------------------------------------------------------------
-------------------------------------------------------------------------------------------SSSooo---------------------------------oSoS------------------------------------------------------------------
------------------------------------------------------------------------------ooSooo-----------------------------------------------------------Soo------------------------------------------------------
-------------------------oSo------------------------ooo------------------------------------ooooooo--------------oSoS-----------ooooooooo--------------------------oo------------------------------------
--------------oSSSoSS-----------------oSoooSooo----R--g------------------------ooooo-----y-g-grK-------ooSoo-------------------r-r-K-k--------------------------rg--------------------ooSSo-------------
--------------------------ooo-------------------XXXXXXXXXXXX-------------------y--------XXXXXXXXXXX--------------ooooo---y-K--XXXXXXXXXXX-----g-Y----------gg-XXXXXXX------------------------------XXXXX
XXXXXXXXXXXXX---oooooo----yk-------------ooooo--XXXXXXXXXXXX-------XXXX------XXXXXXXXXXXXXXXXXXXXXX----oo-----R---Gk----XXXXXXXXXXXXXXXXX----XXXXXX-----XXXXXXXXXXXXXXX----XXXX---XXX---ooo--ooooo-XXXXX
XXXXXXXXXXXXX-y-----r---XXXXXXX-----------kY--k-XXXXXXXXXXXXXXXXXXXXXXX-ry---XXXXXXXXXXXXXXXXXXXXXX------k---XXXXXXXXXXXXXXXXXXXXXXXXXXXX----XXXXXX-----XXXXXXXXXXXXXXXXXXXXXXX---XXX---rg----KR-Y-XXXXX
XXXXXXXXXXXXXXXXXXXXXXXXXXXXXXXXXXXXXXXXXXXXXXXXXXXXXXXXXXXXXXXXXXXXXXXXXXXXXXXXXXXXXXXXXXXXXXXXXXXXXXXXXXXXXXXXXXXXXXXXXXXXXXXXXXXXXXXXXXXXXXXXXXXXXXXXXXXXXXXXXXXXXXXXXXXXXXXXXXXXXXXXXXXXXXXXXXXXXXXX

