--------------------------------------------------------------------------------------------------------------------------------------------------------------------------------------------------------
--------------------------------------------------------------------------------------------------------------------------------------------------------------------------------------------------------
--------------------------------------------------------------------------------------------------------------------------------------------------------------------------------------------------------
--------------------------------------------------------------------------------------------------------------------------------------------------------------------------------------------------------
--------------------------------------------------------------------------------------------------------------------------------------------------------------------------------------------------------
--------------------------------------------------------------------------------------------------------------------------------------------------------------------------------------------------------
--------------------------------------------------------------------------------------------------------------------------------------------------------------------------------------------------------
--------------------------------------------------------------------------------------------------------------------------------------------------------------------------------------------------------
--------------------------------------------------------------------------------------------------------------------------------------------------------------------------------------------------------
--------------------------------------------------------------------------------------------------------------------------------------------------------------------------------------------------------
--------------------------------------------------------------------------------------------------------------------------------------------------------------------------------------------------------
--------------------------------------------------------------------------------------------------------------------------------------------------------------------------------------------------------
------------------------------------------------oooS----------------------------SSSS------------ooo------------------------------------oooSoS-----------------------------------------------------------
---------------------------------------Sooo--------------------ooooSo---------------------------------oSooo--------oooSSo-------------------------------------------------------------------------------
---------------------------------------------oooooooo----------------------------ooooo--------oooooo-------------------------oo----------oo------------------SoSS-----------------oooSo-----------------
-------------------------------ooooo----------ry--ygR---------oooooooo------------GyY--------g-yyg-Y----ooooo------oooooo----Ryk--------y---------ooooooo-----------------------------------------g-----
--------------------------------------r-----XXXXXXXXXX---------gGg--kK----XXXXXXXXXXXXXXXXXXXXXXXXXXX-----gR-----rk-------XXXXXXXXXXXXXXXXXXXXX-------------oooooo---XXXXX-------ooooo---------XXXXXXX--
------------------oo-------XXX---ooo-XXXXXXXXXXXXXXXXX----XXXXXXXXXXXXX---XXXXXXXXXXXXXXXXXXXXXXXXXXXXXXXXXXXXXXXXXXXXXXXXXXXXXXXXXXXXXXXXXXXXX---ooooooo---R----y---XXXXX--------kgk----------XXXXXXXXX
XXXXXXXXXXXXXX--rg---------XXX----k--XXXXXXXXXXXXXXXXXXXXXXXXXXXXXXXXXXXXXXXXXXXXXXXXXXXXXXXXXXXXXXXXXXXXXXXXXXXXXXXXXXXXXXXXXXXXXXXXXXXXXXXXXX--------R--XXXXXXXXXXXXXXXX-----XXXXXXXXXXXXXX--XXXXXXXXX
XXXXXXXXXXXXXXXXXXXXXXXXXXXXXXXXXXXXXXXXXXXXXXXXXXXXXXXXXXXXXXXXXXXXXXXXXXXXXXXXXXXXXXXXXXXXXXXXXXXXXXXXXXXXXXXXXXXXXXXXXXXXXXXXXXXXXXXXXXXXXXXXXXXXXXXXXXXXXXXXXXXXXXXXXXXXXXXXXXXXXXXXXXXXXXXXXXXXXXXX

