--------------------------------------------------------------------------------------------------------------------------------------------------------------------------------------------------------
--------------------------------------------------------------------------------------------------------------------------------------------------------------------------------------------------------
--------------------------------------------------------------------------------------------------------------------------------------------------------------------------------------------------------
--------------------------------------------------------------------------------------------------------------------------------------------------------------------------------------------------------
--------------------------------------------------------------------------------------------------------------------------------------------------------------------------------------------------------
--------------------------------------------------------------------------------------------------------------------------------------------------------------------------------------------------------
--------------------------------------------------------------------------------------------------------------------------------------------------------------------------------------------------------
--------------------------------------------------------------------------------------------------------------------------------------------------------------------------------------------------------
--------------------------------------------------------------------------------------------------------------------------------------------------------------------------------------------------------
--------------------------------------------------------------------------------------------------------------------------------------------------------------------------------------------------------
--------------------------------------------------------------------------------------------------------------------------------------------------------------------------------------------------------
--------------------------------------------------------------------------------------------------------------------------------------------------------------------------------------------------------
------------------------------------------------------------------------------------------------------------------oSSSSSo-------ooo---------------------------------------------------------------------
------------------------------------------------------------------------ooSoSoo----------------------------------------------------------------------------------------------------ooooSSoo-------------
---------------------------------------------------------oSSSoo----oo---------------------------------------------oooooo-------oo-------------------------------------------------------------ooo-------
--------------------------------------------------ooooo-------------------ooooo---------ooSSo----------------Gy---y----------k----g---------------------------------------oo--------ooooo-----kR--------
--------------------------------------------------ygk-----oo----XXXXXXX---y----K--XX----------------------XXXXXXXXXXXXXXXXXXXXXXXXXX-------------------------------------y--yR-XXX-----gy----XXXXXX-----
XXXXXXXXXX---------------------------------XXXXXXXXXXXXX--YG--k-XXXXXXXXXXXXXXXXXXXX-oooooo---------------XXXXXXXXXXXXXXXXXXXXXXXXXX-----------XXXXX----------XXXX----XXXXXXXXXXXXXXXXXXXXXXXXXXXXX-----
XXXXXXXXXXXXXXXXX----r--------XX----XXXXXXXXXXXXXXXXXXXXXXXXXXXXXXXXXXXXXXXXXXXXXXXX-K-Gr--y---XXXXXX-----XXXXXXXXXXXXXXXXXXXXXXXXXXXXXX--g--y-XXXXXXXX----XXXXXXX----XXXXXXXXXXXXXXXXXXXXXXXXXXXXXXXXXX
XXXXXXXXXXXXXXXXXXXXXXXXXXXXXXXXXXXXXXXXXXXXXXXXXXXXXXXXXXXXXXXXXXXXXXXXXXXXXXXXXXXXXXXXXXXXXXXXXXXXXXXXXXXXXXXXXXXXXXXXXXXXXXXXXXXXXXXXXXXXXXXXXXXXXXXXXXXXXXXXXXXXXXXXXXXXXXXXXXXXXXXXXXXXXXXXXXXXXXXX

