--------------------------------------------------------------------------------------------------------------------------------------------------------------------------------------------------------
--------------------------------------------------------------------------------------------------------------------------------------------------------------------------------------------------------
--------------------------------------------------------------------------------------------------------------------------------------------------------------------------------------------------------
--------------------------------------------------------------------------------------------------------------------------------------------------------------------------------------------------------
--------------------------------------------------------------------------------------------------------------------------------------------------------------------------------------------------------
--------------------------------------------------------------------------------------------------------------------------------------------------------------------------------------------------------
--------------------------------------------------------------------------------------------------------------------------------------------------------------------------------------------------------
--------------------------------------------------------------------------------------------------------------------------------------------------------------------------------------------------------
--------------------------------------------------------------------------------------------------------------------------------------------------------------------------------------------------------
--------------------------------------------------------------------------------------------------------------------------------------------------------------------------------------------------------
--------------------------------------------------------------------------------------------------------------------------------------------------------------------------------------------------------
--------------------------------------------------------------------------------------------------------------------------------------------------------------------------------------------------------
--------------------------------------------------------------------------------------------------------------------------------------------------------------------------------------------------------
---------------------------------------------------------------------ooooSoo----SooSoo------------Soooo----------------oSoo-----------------------------------------------------------------------------
------------------------------------------------------------------------------------------------------------------------------------------------------------------------ooooo---------------------------
--------------------------------------Sooo---------------oo-----------ooooo----ooooo-------------ooooooo-----oo-----------------------------ooo----SSSoS------------------YG---ooooSo-------------------
----------------XX--------------------------------oo---y-------------------G----g-gk---------------r-k-------Ry-g------y---k------------------------------------------XXXXXXXX---------XXXXXX-----oo--XX
-----------XXXXXXX------------oooo----oooooo---y-gYY--XXXXXXXXXX--XXXXXXXXXXXXXXXXXXXXX---------XXXXXXXXXX--XXXXXXX---XXXXXXX-------------ooo----ooooooooo--gk------XXXXXXXXXX---------XXXXXX------R--XX
XXXXXXXXXXXXXXXXXX-----XXXX--K--------yG-k--Y-XXXXXXXXXXXXXXXXXX--XXXXXXXXXXXXXXXXXXXXX-K-K-y---XXXXXXXXXX--XXXXXXXXXXXXXXXXX--------XXXX----------g-k--gG-XXXXXXXXXXXXXXXXXXX--k-y--y-XXXXXXXXXXXXXXXXX
XXXXXXXXXXXXXXXXXXXXXXXXXXXXXXXXXXXXXXXXXXXXXXXXXXXXXXXXXXXXXXXXXXXXXXXXXXXXXXXXXXXXXXXXXXXXXXXXXXXXXXXXXXXXXXXXXXXXXXXXXXXXXXXXXXXXXXXXXXXXXXXXXXXXXXXXXXXXXXXXXXXXXXXXXXXXXXXXXXXXXXXXXXXXXXXXXXXXXXXX

