--------------------------------------------------------------------------------------------------------------------------------------------------------------------------------------------------------
--------------------------------------------------------------------------------------------------------------------------------------------------------------------------------------------------------
--------------------------------------------------------------------------------------------------------------------------------------------------------------------------------------------------------
--------------------------------------------------------------------------------------------------------------------------------------------------------------------------------------------------------
--------------------------------------------------------------------------------------------------------------------------------------------------------------------------------------------------------
--------------------------------------------------------------------------------------------------------------------------------------------------------------------------------------------------------
--------------------------------------------------------------------------------------------------------------------------------------------------------------------------------------------------------
--------------------------------------------------------------------------------------------------------------------------------------------------------------------------------------------------------
--------------------------------------------------------------------------------------------------------------------------------------------------------------------------------------------------------
--------------------------------------------------------------------------------------------------------------------------------------------------------------------------------------------------------
--------------------------------------------------------------------------------------------------------------------------------------------------------------------------------------------------------
--------------------------------------------------------------------------------------------------------------------------------------------------------------------------------------------------------
----------------------------ooo--------------------------------------------------------------ooooo--------------------------------------------------------------------------------------------oSSSSo----
------------------------------------------ooSoooo----oSoSoo------------------------------------------------------------------------------------ooS---------------SSS------------------------------------
-----------------------------ooo-------------------------------------------------------------ooo-----------------------------------------------------------------------------------SSooSooo---oooooo----
-------------oooSoSo---------RkkG---oooo-----oooooo------------oooSS------oo---------ooSoo-----------r---------oSoo-------oooo------------------oo---------------ooo------SSooS--------------kkg---yk---
--------------------------XXXXXXXX-----------rg-y----yry----------------gy-----------------XXXXXXXXXXXXXXX------------------k-----------------r--rk-XX----------K-Y-ry---------------oooooo-XXXXXXXXXXX-
XXXXXXXXXX---ooooo--------XXXXXXXX-------XXXXXXXXXXXXXXXXXXXX-oooooooo-XXXXXX-oooo-----oo--XXXXXXXXXXXXXXX-------oooo--XXXXXXXXX------------XXXXXXXXXXXXXXX----XXXXXXXX--oooooo---g--r--g-r-XXXXXXXXXXX-
XXXXXXXXXXXX--k------XXXXXXXXXXXXX--R----XXXXXXXXXXXXXXXXXXXX----gY-Rg-XXXXXX---y-----g----XXXXXXXXXXXXXXXXXXX-gK-yr---XXXXXXXXX--XXXXXXXXXXXXXXXXXXXXXXXXX----XXXXXXXX---rgy-rr-XXXXXXXXXXXXXXXXXXXXXXX
XXXXXXXXXXXXXXXXXXXXXXXXXXXXXXXXXXXXXXXXXXXXXXXXXXXXXXXXXXXXXXXXXXXXXXXXXXXXXXXXXXXXXXXXXXXXXXXXXXXXXXXXXXXXXXXXXXXXXXXXXXXXXXXXXXXXXXXXXXXXXXXXXXXXXXXXXXXXXXXXXXXXXXXXXXXXXXXXXXXXXXXXXXXXXXXXXXXXXXXX

