--------------------------------------------------------------------------------------------------------------------------------------------------------------------------------------------------------
--------------------------------------------------------------------------------------------------------------------------------------------------------------------------------------------------------
--------------------------------------------------------------------------------------------------------------------------------------------------------------------------------------------------------
--------------------------------------------------------------------------------------------------------------------------------------------------------------------------------------------------------
--------------------------------------------------------------------------------------------------------------------------------------------------------------------------------------------------------
--------------------------------------------------------------------------------------------------------------------------------------------------------------------------------------------------------
--------------------------------------------------------------------------------------------------------------------------------------------------------------------------------------------------------
--------------------------------------------------------------------------------------------------------------------------------------------------------------------------------------------------------
--------------------------------------------------------------------------------------------------------------------------------------------------------------------------------------------------------
--------------------------------------------------------------------------------------------------------------------------------------------------------------------------------------------------------
--------------------------------------------------------------------------------------------------------------------------------------------------------------------------------------------------------
--------------------------------------------------------------------------------------------------------------------------------------------------------------------------------------------------------
------------------------------------------------------------------------oSoooSo------------ooS----------------------------------------------------------------------ooSo---------------------------oSoo-
--------------ooooSooo-------------------SooS------------------------------------------------------------------------------------oSoS------------------------------------------ooo----------------------
----------------------------------------------------------------------ooooooooo-------------ooo--------------------------------------------------------------ooSo--ooooo--------------------------------
---------------oooo------------ooSSS-----ooooooo--oooooo----oooSoooo-----r---------------yG-------SoS-------------------------------oooo-----ooooS------------------k--------oooooo-------ooooo----r----
--------------gk--r---------------------g---r-y----------------------XXXXXXXXXXX--------XXXXXXXX---------XX---------------ooooo--k----rg----------------k---ooo---XXXXXXX-----k--r----------------XXXXXX
-------------XXXXXXXXXX----------ooo---XXXXXXXXXX-oooooooo----ooooo--XXXXXXXXXXX-oooo---XXXXXXXX---ooooo-XX--------------k-rRg--XXXXXXXXX-----------XXXXXXX-------XXXXXXXXXXXXXXXXXXXXX--oooooo---XXXXXX
-------------XXXXXXXXXX-----XX---y-----XXXXXXXXXX-k-g-------k-y--Yy--XXXXXXXXXXX-Y-g----XXXXXXXX-k-------XX-----k-XXXXXXXXXXXXXXXXXXXXXXXXXX--K--y--XXXXXXXXXXXXXXXXXXXXXXXXXXXXXXXXXXX---gy---g--XXXXXX
XXXXXXXXXXXXXXXXXXXXXXXXXXXXXXXXXXXXXXXXXXXXXXXXXXXXXXXXXXXXXXXXXXXXXXXXXXXXXXXXXXXXXXXXXXXXXXXXXXXXXXXXXXXXXXXXXXXXXXXXXXXXXXXXXXXXXXXXXXXXXXXXXXXXXXXXXXXXXXXXXXXXXXXXXXXXXXXXXXXXXXXXXXXXXXXXXXXXXXXX

