--------------------------------------------------------------------------------------------------------------------------------------------------------------------------------------------------------
--------------------------------------------------------------------------------------------------------------------------------------------------------------------------------------------------------
--------------------------------------------------------------------------------------------------------------------------------------------------------------------------------------------------------
--------------------------------------------------------------------------------------------------------------------------------------------------------------------------------------------------------
--------------------------------------------------------------------------------------------------------------------------------------------------------------------------------------------------------
--------------------------------------------------------------------------------------------------------------------------------------------------------------------------------------------------------
--------------------------------------------------------------------------------------------------------------------------------------------------------------------------------------------------------
--------------------------------------------------------------------------------------------------------------------------------------------------------------------------------------------------------
--------------------------------------------------------------------------------------------------------------------------------------------------------------------------------------------------------
--------------------------------------------------------------------------------------------------------------------------------------------------------------------------------------------------------
--------------------------------------------------------------------------------------------------------------------------------------------------------------------------------------------------------
--------------------------------------------------------------------------------------------------------------------------------------------------------------------------------------------------------
--------------------------------------oSoSSS------------------------------------------ooSoo----------------------SooooSoo-------------------------------------------------------------------------------
---------------------------oSoooSoo---------------------ooSoo---------------------------------------------------------------------oooSo------------------------------------------------------SoS--------
--------------oo----------------------ooooooo-----------------------------------------oooo----ooooo----------------ooo-----------------------------------SSooo------------------------------------------
-------------y-g-------------ooo-----Gy-G--Gr-------------ooo------ooooooo---------------------RG----------------yGy-r---------------oo--------------------------g-y----------ooooS-----------oo--------
------------XXXXXXXX-------rk--r----XXXXXXXXXXXXXX--------gg-R--------------------XXXXXXXXXXXXXXXXXXXX---------XXXXXXXXXXXXXXXXXX--y--R-R---------------oooo---XXXXXX--gY--------------------r-g--------
------------XXXXXXXXXXXXXXXXXXXXXXXXXXXXXXXXXXXXXXXXXXXXXXXXXXXX---oooooo-----oo--XXXXXXXXXXXXXXXXXXXX---------XXXXXXXXXXXXXXXXXXXXXXXXXXXXXXXXX----------k-G--XXXXXXXXXXXX---ooo----------XXXXXXX------
------------XXXXXXXXXXXXXXXXXXXXXXXXXXXXXXXXXXXXXXXXXXXXXXXXXXXX------yk-k----r-k-XXXXXXXXXXXXXXXXXXXXXXXXX----XXXXXXXXXXXXXXXXXXXXXXXXXXXXXXXXX-g----XXXXXXXXXXXXXXXXXXXXX----Y-Y-r-XXXXXXXXXXXXX------
XXXXXXXXXXXXXXXXXXXXXXXXXXXXXXXXXXXXXXXXXXXXXXXXXXXXXXXXXXXXXXXXXXXXXXXXXXXXXXXXXXXXXXXXXXXXXXXXXXXXXXXXXXXXXXXXXXXXXXXXXXXXXXXXXXXXXXXXXXXXXXXXXXXXXXXXXXXXXXXXXXXXXXXXXXXXXXXXXXXXXXXXXXXXXXXXXXXXXXXX

