--------------------------------------------------------------------------------------------------------------------------------------------------------------------------------------------------------
--------------------------------------------------------------------------------------------------------------------------------------------------------------------------------------------------------
--------------------------------------------------------------------------------------------------------------------------------------------------------------------------------------------------------
--------------------------------------------------------------------------------------------------------------------------------------------------------------------------------------------------------
--------------------------------------------------------------------------------------------------------------------------------------------------------------------------------------------------------
--------------------------------------------------------------------------------------------------------------------------------------------------------------------------------------------------------
--------------------------------------------------------------------------------------------------------------------------------------------------------------------------------------------------------
--------------------------------------------------------------------------------------------------------------------------------------------------------------------------------------------------------
--------------------------------------------------------------------------------------------------------------------------------------------------------------------------------------------------------
--------------------------------------------------------------------------------------------------------------------------------------------------------------------------------------------------------
--------------------------------------------------------------------------------------------------------------------------------------------------------------------------------------------------------
--------------------------------------------------------------------------------------------------------------------------------------------------------------------------------------------------------
----------------------------------------ooo------------------ooSooSoS-------oooooooo---------------------------------------------oSoo------------------------------------oooo---------------SooSSo------
-----------------------------oooooo----------------------------------------------------------------------SooS---------------------------------------------------ooSS------------------------------------
-----------------oooooo-----------------oooo--------ooooS-------ooooo--------ooooo-----------------------------------------------oooo-----------------------------------oooo---------------ooooooo------
----------------------------oooooooo---ykyg-R-------------------r---g--------KYK-------oSSoo-----------ooooo--------Sooooo-------g--rr----------SSS-----------ooooooo--k--y---------------------Kk------
--------------XX---oooo----y-kk----G-XXXXXXXXX------ooooooo-XXXXXXXXXXXXXXXXXXXXXXXXX----------------------y-g-------------XXXXXXXXXXXXXXXXX------------------r-----y-XXXXXXXX-------ooo--XXXXXXXXXXXX--
--------------XX-k-r------XXXXXXXXXXXXXXXXXXXX-------y-k----XXXXXXXXXXXXXXXXXXXXXXXXX--oooooo--------XXXXXXXXXXX--ooooooo--XXXXXXXXXXXXXXXXX--ooooo-----g---XXXXXXXXXXXXXXXXXX---XX-----K-XXXXXXXXXXXXXX
XXXXXXXXXXXXXXXXXXXXXXXXXXXXXXXXXXXXXXXXXXXXXX---XXXXXXXXXXXXXXXXXXXXXXXXXXXXXXXXXXXX---g------------XXXXXXXXXXX---------g-XXXXXXXXXXXXXXXXX----kY-yy-XXXXXXXXXXXXXXXXXXXXXXXXXXXXXXXXXXXXXXXXXXXXXXXXXX
XXXXXXXXXXXXXXXXXXXXXXXXXXXXXXXXXXXXXXXXXXXXXXXXXXXXXXXXXXXXXXXXXXXXXXXXXXXXXXXXXXXXXXXXXXXXXXXXXXXXXXXXXXXXXXXXXXXXXXXXXXXXXXXXXXXXXXXXXXXXXXXXXXXXXXXXXXXXXXXXXXXXXXXXXXXXXXXXXXXXXXXXXXXXXXXXXXXXXXXX

