--------------------------------------------------------------------------------------------------------------------------------------------------------------------------------------------------------
--------------------------------------------------------------------------------------------------------------------------------------------------------------------------------------------------------
--------------------------------------------------------------------------------------------------------------------------------------------------------------------------------------------------------
--------------------------------------------------------------------------------------------------------------------------------------------------------------------------------------------------------
--------------------------------------------------------------------------------------------------------------------------------------------------------------------------------------------------------
--------------------------------------------------------------------------------------------------------------------------------------------------------------------------------------------------------
--------------------------------------------------------------------------------------------------------------------------------------------------------------------------------------------------------
--------------------------------------------------------------------------------------------------------------------------------------------------------------------------------------------------------
--------------------------------------------------------------------------------------------------------------------------------------------------------------------------------------------------------
--------------------------------------------------------------------------------------------------------------------------------------------------------------------------------------------------------
--------------------------------------------------------------------------------------------------------------------------------------------------------------------------------------------------------
--------------------------------------------------------------------------------------------------------------------------------------------------------------------------------------------------------
--------------------------------------------------------------------------------------------------------------ooooSo------------------------------------------------------------------------------------
--------------oooooSo-------------------------ooo-----oooo-----oSoSSS------------oSo-------------------------------------------Sooo---------------------------------------------------------------------
------------------------ooooSo---------ooo---------------------------------------------------------ooSooSo--oooooooo-------------------------------------oooSoo---SoSS-------------------------Soo------
-----------------oo--------------------------oooo------oooooo-----oo------------oo-------ooSooo-------------r--kK--------------ooooo--------------------------------------------------------------------
--------------G-Gy--------ooooo-XXXXXX--------k--------r-Kk-----k----g-XXX------r------------------oooo----XXXXXXXXXX---------RG--rr---oo---k-Ky-----------ooo-----ooooo---------------k--g----oooooo---
XXXXXXXXXXXXXXXXXXXXXX-------yR-XXXXXX----Y-XXXXXXXXXXXXXXXXXXXXXXXXXXXXXXXXXXXXXXXXX---ooooooo----k--r----XXXXXXXXXX----R--XXXXXXXXX-gg---XXXXXX---Y----RK---k--R-g-r-----------XXXXXXXXXXX------------
XXXXXXXXXXXXXXXXXXXXXXXXXXXXXXXXXXXXXXXXXXXXXXXXXXXXXXXXXXXXXXXXXXXXXXXXXXXXXXXXXXXXXXX-----R-k-g-XXXXXXXXXXXXXXXXXXXXXXXXXXXXXXXXXXXXXXXXXXXXXXXXXXXXXXXXXXXXXXXXXXXXXXXX--gy-r-XXXXXXXXXXXXXXXXXXXXXXX
XXXXXXXXXXXXXXXXXXXXXXXXXXXXXXXXXXXXXXXXXXXXXXXXXXXXXXXXXXXXXXXXXXXXXXXXXXXXXXXXXXXXXXXXXXXXXXXXXXXXXXXXXXXXXXXXXXXXXXXXXXXXXXXXXXXXXXXXXXXXXXXXXXXXXXXXXXXXXXXXXXXXXXXXXXXXXXXXXXXXXXXXXXXXXXXXXXXXXXXX

