--------------------------------------------------------------------------------------------------------------------------------------------------------------------------------------------------------
--------------------------------------------------------------------------------------------------------------------------------------------------------------------------------------------------------
--------------------------------------------------------------------------------------------------------------------------------------------------------------------------------------------------------
--------------------------------------------------------------------------------------------------------------------------------------------------------------------------------------------------------
--------------------------------------------------------------------------------------------------------------------------------------------------------------------------------------------------------
--------------------------------------------------------------------------------------------------------------------------------------------------------------------------------------------------------
--------------------------------------------------------------------------------------------------------------------------------------------------------------------------------------------------------
--------------------------------------------------------------------------------------------------------------------------------------------------------------------------------------------------------
--------------------------------------------------------------------------------------------------------------------------------------------------------------------------------------------------------
--------------------------------------------------------------------------------------------------------------------------------------------------------------------------------------------------------
--------------------------------------------------------------------------------------------------------------------------------------------------------------------------------------------------------
--------------------------------------------------------------------------------------------------------------------------------------------------------------------------------------------------------
-------------------------------------------oSoo----------------oooSoo----------------------------------------------ooSoSoo----------------------------------------------------------SoooS-------oooSSoo-
------------------------------------------------------------------------------------------------------Sooo--------------------------------------------------------SoS-----------------------------------
-----------------ooo------------------------oo-------------------ooo---------ooo-----------------------------oooo----ooooo----------------------------ooSooooS------------oSSoo-----ooooooo-----oooooo--
---------------------------------------------G-r---------------g----k--------rr--k-----------Soooo---oooo-----------R-K------------------SoS-----g-------------------------------------Grryk-----kg---g-
----------------oo------------------------XXXXXXX------------XXXXXXXXX------XXXXXXXX----------------y----Yy-------XXXXXXXXXX-----XXXXX---------XXXXXX--oooooo----r---k---oooooo---XXXXXXXXXXXXXXXXXXXXXX
XXXXXXXXXXXXX----gR-----kK----XXXXX-------XXXXXXX---ooooo----XXXXXXXXX--XXXXXXXXXXXX------oooooooo-XXXXXXXXX-K----XXXXXXXXXX-----XXXXX--oooo---XXXXXX--G---gk---XXXXXXXX-g--------XXXXXXXXXXXXXXXXXXXXXX
XXXXXXXXXXXXXXXXXXXXXXXXXXXXXXXXXXX-------XXXXXXXXX---ryGY---XXXXXXXXX--XXXXXXXXXXXX------k--rY-Gk-XXXXXXXXXXXXXXXXXXXXXXXXX-----XXXXX-y-Y--R--XXXXXXXXXXXXXXXXXXXXXXXXXXXXXXXXXXXXXXXXXXXXXXXXXXXXXXXXX
XXXXXXXXXXXXXXXXXXXXXXXXXXXXXXXXXXXXXXXXXXXXXXXXXXXXXXXXXXXXXXXXXXXXXXXXXXXXXXXXXXXXXXXXXXXXXXXXXXXXXXXXXXXXXXXXXXXXXXXXXXXXXXXXXXXXXXXXXXXXXXXXXXXXXXXXXXXXXXXXXXXXXXXXXXXXXXXXXXXXXXXXXXXXXXXXXXXXXXXX

