--------------------------------------------------------------------------------------------------------------------------------------------------------------------------------------------------------
--------------------------------------------------------------------------------------------------------------------------------------------------------------------------------------------------------
--------------------------------------------------------------------------------------------------------------------------------------------------------------------------------------------------------
--------------------------------------------------------------------------------------------------------------------------------------------------------------------------------------------------------
--------------------------------------------------------------------------------------------------------------------------------------------------------------------------------------------------------
--------------------------------------------------------------------------------------------------------------------------------------------------------------------------------------------------------
--------------------------------------------------------------------------------------------------------------------------------------------------------------------------------------------------------
--------------------------------------------------------------------------------------------------------------------------------------------------------------------------------------------------------
--------------------------------------------------------------------------------------------------------------------------------------------------------------------------------------------------------
--------------------------------------------------------------------------------------------------------------------------------------------------------------------------------------------------------
--------------------------------------------------------------------------------------------------------------------------------------------------------------------------------------------------------
--------------------------------------------------------------------------------------------------------------------------------------------------------------------------------------------------------
-----------------------------------------------oooooo----SSoS----------------------oSSo----------------------------------------------------------------oooo---------------------------------------------
-----------------------------------------ooo--------------------------------------------------------------------------------------------------------------------------SSo-------------------------------
--------------------------oooSS-----------------oo------ooooo------------------------------------------------------------------------------------------oooo---------------------------------------------
---------------------------------------oooooo-----y----g----------oooo----SSo------g-y------------------------------------ooo-----oSooSo---------oSoo---K-G-r--------oooo----------------------oSS------
----------------------------oooo------YG------XXXXXXXXXXXXXXXXX-------------------XXXXXXXXXXXXX-------------------------------------------------------XXXXXXXX---XXX-r-------------ooooooo-----------XX-
-------------XXX-oooooo--g-y--gk-XXXXXXXXXXXXXXXXXXXXXXXXXXXXXX--ooo--------------XXXXXXXXXXXXX--ooo--------------XX------ooooo----oooooooo-----------XXXXXXXXXXXXXXXXXXXXXXXXXXXX--k--YGy---oooo----XX-
-------------XXX-r-krrK-XXXXXXXXXXXXXXXXXXXXXXXXXXXXXXXXXXXXXXX---rrk-----kg-Y-XXXXXXXXXXXXXXXX-krgr-KK------XXXXXXXXXX----------------y-Ry-----------XXXXXXXXXXXXXXXXXXXXXXXXXXXXXXXXXXXXX-k----r-K-XX-
XXXXXXXXXXXXXXXXXXXXXXXXXXXXXXXXXXXXXXXXXXXXXXXXXXXXXXXXXXXXXXXXXXXXXXXXXXXXXXXXXXXXXXXXXXXXXXXXXXXXXXXXXXXXXXXXXXXXXXXXXXXXXXXXXXXXXXXXXXXXXXXXXXXXXXXXXXXXXXXXXXXXXXXXXXXXXXXXXXXXXXXXXXXXXXXXXXXXXXXX

