--------------------------------------------------------------------------------------------------------------------------------------------------------------------------------------------------------
--------------------------------------------------------------------------------------------------------------------------------------------------------------------------------------------------------
--------------------------------------------------------------------------------------------------------------------------------------------------------------------------------------------------------
--------------------------------------------------------------------------------------------------------------------------------------------------------------------------------------------------------
--------------------------------------------------------------------------------------------------------------------------------------------------------------------------------------------------------
--------------------------------------------------------------------------------------------------------------------------------------------------------------------------------------------------------
--------------------------------------------------------------------------------------------------------------------------------------------------------------------------------------------------------
--------------------------------------------------------------------------------------------------------------------------------------------------------------------------------------------------------
--------------------------------------------------------------------------------------------------------------------------------------------------------------------------------------------------------
--------------------------------------------------------------------------------------------------------------------------------------------------------------------------------------------------------
--------------------------------------------------------------------------------------------------------------------------------------------------------------------------------------------------------
--------------------------------------------------------------------------------------------------------------------------------------------------------------------------------------------------------
------------------------------------------------------------------------------------------------------------------------------------------------------------------------------------------oSo-----------
--------------------------------oooooo-------------------------------------------------------------SooS-------------------------------------oooooS------------------------------------------------------
-------------oooo-----------------------ooooSSS----------ooo--------------------------------------------------------------------------------------------oSS----oooSo--------ooo-------------------------
-------------k-g----------------oooo---------------------r-Ky--------ooo-----oSSS------oooooo------ooooo---oo----------oSoo----------ooo-------oo---------------------------------yy----yG--k-----------
------------XXXXXXXXX----------Y----------oooooo--ky---XXXXXXX----------G-----------------------g-Y---gr---k--g--------------XXXX-Y-----k---g--g-----ooooo------------------oo---XXXXXXXXXXXXX---oo---XX
XXXXXXXXXXXXXXXXXXXXX----G-r-XXXXXXXXXX-Kk--yy-g-XXXXXXXXXXXXXXXXXXXXXXXXXXX-oooooo--ooooooo---XXXXXXXXXXXXXXXXXX--------oo--XXXXXXXXXXXXXXXXXXXXXXX-----k-----Y-K--r------G---r-XXXXXXXXXXXXX--r---k-XX
XXXXXXXXXXXXXXXXXXXXXXXXXXXXXXXXXXXXXXXXXXXXXXXXXXXXXXXXXXXXXXXXXXXXXXXXXXXX--G---r---r--g-R---XXXXXXXXXXXXXXXXXX------y-----XXXXXXXXXXXXXXXXXXXXXXXXXXXXXXXXXXXXXXXXXX--XXXXXXXXXXXXXXXXXXXXXXXXXXXXXXX
XXXXXXXXXXXXXXXXXXXXXXXXXXXXXXXXXXXXXXXXXXXXXXXXXXXXXXXXXXXXXXXXXXXXXXXXXXXXXXXXXXXXXXXXXXXXXXXXXXXXXXXXXXXXXXXXXXXXXXXXXXXXXXXXXXXXXXXXXXXXXXXXXXXXXXXXXXXXXXXXXXXXXXXXXXXXXXXXXXXXXXXXXXXXXXXXXXXXXXXX

