--------------------------------------------------------------------------------------------------------------------------------------------------------------------------------------------------------
--------------------------------------------------------------------------------------------------------------------------------------------------------------------------------------------------------
--------------------------------------------------------------------------------------------------------------------------------------------------------------------------------------------------------
--------------------------------------------------------------------------------------------------------------------------------------------------------------------------------------------------------
--------------------------------------------------------------------------------------------------------------------------------------------------------------------------------------------------------
--------------------------------------------------------------------------------------------------------------------------------------------------------------------------------------------------------
--------------------------------------------------------------------------------------------------------------------------------------------------------------------------------------------------------
--------------------------------------------------------------------------------------------------------------------------------------------------------------------------------------------------------
--------------------------------------------------------------------------------------------------------------------------------------------------------------------------------------------------------
--------------------------------------------------------------------------------------------------------------------------------------------------------------------------------------------------------
--------------------------------------------------------------------------------------------------------------------------------------------------------------------------------------------------------
--------------------------------------------------------------------------------------------------------------------------------------------------------------------------------------------------------
-------------------------------------------------SSSoo-------------------------------------oooooSo-------------------------------------------------------------ooS------------ooSooo--------------------
-------------------------------------oooo----------------------------SSS-------------------------------ooo----------------------------------------------------------------------------------------------
-----------------------------ooS---------------oooooooo-----------------------ooo------------oooooo--------------------------ooooo---ooooSoo--------------------oooo------------------------------------
------------------------------------------------gr--g------ooo-----ooooooo--y---kr---------k--r-r-k--oooo---------------------------------------------------------RG-------------g----------------------
-------------XXXX--oooo-----oooo----k---------XXXXXXXXXXX-----Y----r---R---XXXXXXXX-------XXXXXXXXXX-Y----------oo-------------ooo-----oooo-----------------XXXXXXXXXX---oo--XXXXXXXX------XXXXX--------
XXXXXXXXXXXXXXXXX--y--------r-----XXXXXXXX----XXXXXXXXXXXXXXXXXXXXXXXXXXXXXXXXXXXXX---XXXXXXXXXXXXXXXXXXXXXX-gg--G---XXX---------gk--Y----g------g--y-------XXXXXXXXXX-------XXXXXXXXXXXX--XXXXX--------
XXXXXXXXXXXXXXXXXXXXXXXXXXXXXXXXXXXXXXXXXXXXXXXXXXXXXXXXXXXXXXXXXXXXXXXXXXXXXXXXXXX---XXXXXXXXXXXXXXXXXXXXXXXXXXXXXXXXXX----XXXXXXXXXXXXXXXXXXXXXXXXXX-G----XXXXXXXXXXXXXXXXXXXXXXXXXXXXX--XXXXX------XX
XXXXXXXXXXXXXXXXXXXXXXXXXXXXXXXXXXXXXXXXXXXXXXXXXXXXXXXXXXXXXXXXXXXXXXXXXXXXXXXXXXXXXXXXXXXXXXXXXXXXXXXXXXXXXXXXXXXXXXXXXXXXXXXXXXXXXXXXXXXXXXXXXXXXXXXXXXXXXXXXXXXXXXXXXXXXXXXXXXXXXXXXXXXXXXXXXXXXXXXX

