--------------------------------------------------------------------------------------------------------------------------------------------------------------------------------------------------------
--------------------------------------------------------------------------------------------------------------------------------------------------------------------------------------------------------
--------------------------------------------------------------------------------------------------------------------------------------------------------------------------------------------------------
--------------------------------------------------------------------------------------------------------------------------------------------------------------------------------------------------------
--------------------------------------------------------------------------------------------------------------------------------------------------------------------------------------------------------
--------------------------------------------------------------------------------------------------------------------------------------------------------------------------------------------------------
--------------------------------------------------------------------------------------------------------------------------------------------------------------------------------------------------------
--------------------------------------------------------------------------------------------------------------------------------------------------------------------------------------------------------
--------------------------------------------------------------------------------------------------------------------------------------------------------------------------------------------------------
--------------------------------------------------------------------------------------------------------------------------------------------------------------------------------------------------------
--------------------------------------------------------------------------------------------------------------------------------------------------------------------------------------------------------
--------------------------------------------------------------------------------------------------------------------------------------------------------------------------------------------------------
------------------SSooSoo-------------------oSSo-------------------------------------------------------------------------------------SSoo--------------------------SSoo---------------------------------
----------------------------------oooo------------------------SSSSo--------------oSooo-----ooooo-----------Soo-------oooSo------------------------------------------------------------------------------
------------------ooooo------oo-------------oooo-----SooSoo------------ooo------------------------------------------------------------ooooo-------------------------------------------------------------
------------------g----r-----------ooo---r---yR-y------------ooooooo--------------ooo----oooooo------------oooo-------ooo-----------k--K------oooo-------ooo------g-ygr------ooSoo----------------------
----------------XXXXXXXXXXXXXXXXX-r--rr-XXXXXXXXXXX--ooooo---------yy--------------kR-G--y-k-g-----------g-----g----g--------------XXXXXXXXX-k-g---k------------XXXXXXXX-------------oooo--------XXX----
XXXXXXXXXXXX----XXXXXXXXXXXXXXXXXXXXXXXXXXXXXXXXXXX---g-y---XXXXXXXXXX----gY--XXXXXXXXXXXXXXXXXXX-------XXXXXXXXXXXXXXXXXXXXX--gg--XXXXXXXXXXXXXXXXXXX-ooooooo--XXXXXXXX-------ooo---------kr----XXX----
XXXXXXXXXXXXXXXXXXXXXXXXXXXXXXXXXXXXXXXXXXXXXXXXXXXXXXXXXXXXXXXXXXXXXXXXXXXXXXXXXXXXXXXXXXXXXXXXX--Y-g--XXXXXXXXXXXXXXXXXXXXXXXXXXXXXXXXXXXXXXXXXXXXXX--G-K-----XXXXXXXXXXX-r--r--y-XXXXXXXXXXXXXXXX----
XXXXXXXXXXXXXXXXXXXXXXXXXXXXXXXXXXXXXXXXXXXXXXXXXXXXXXXXXXXXXXXXXXXXXXXXXXXXXXXXXXXXXXXXXXXXXXXXXXXXXXXXXXXXXXXXXXXXXXXXXXXXXXXXXXXXXXXXXXXXXXXXXXXXXXXXXXXXXXXXXXXXXXXXXXXXXXXXXXXXXXXXXXXXXXXXXXXXXXXX

