--------------------------------------------------------------------------------------------------------------------------------------------------------------------------------------------------------
--------------------------------------------------------------------------------------------------------------------------------------------------------------------------------------------------------
--------------------------------------------------------------------------------------------------------------------------------------------------------------------------------------------------------
--------------------------------------------------------------------------------------------------------------------------------------------------------------------------------------------------------
--------------------------------------------------------------------------------------------------------------------------------------------------------------------------------------------------------
--------------------------------------------------------------------------------------------------------------------------------------------------------------------------------------------------------
--------------------------------------------------------------------------------------------------------------------------------------------------------------------------------------------------------
--------------------------------------------------------------------------------------------------------------------------------------------------------------------------------------------------------
--------------------------------------------------------------------------------------------------------------------------------------------------------------------------------------------------------
--------------------------------------------------------------------------------------------------------------------------------------------------------------------------------------------------------
--------------------------------------------------------------------------------------------------------------------------------------------------------------------------------------------------------
--------------------------------------------------------------------------------------------------------------------------------------------------------------------------------------------------------
-------------------------------------------------------------------------------------------------------------------------------------------------------------------------------------------ooo----------
-------------------------------------------SooSo--------------------------------------------------------------------Sooo--------------------------------------oSSoSSo------------ooSoSS-----------------
----------------------------------------------------------------------------------------------------oooo-----oo-------------------SoooS-----------------------------------------------------------------
----------------------------oooS---------oooooo-----------------------------------K----------------y---------G-----oooo---------------------------------------ooooooo----oSoo-----oooo-----rrk-----oo---
-----------------------------------------g------gr-----------------gR-g--------XXXXXX------------XXXXXXXXXXXXXXXX-Kgg--------------oooo------------------------------------------r--------XXXXXX----yk--
XXXXXXXXXXXXXX----ooo-XXX----ooo--------XXXXXXXXXXX---------XXX--XXXXXXXX------XXXXXXXXX---------XXXXXXXXXXXXXXXXXXXXXXXX-----------y--g---K-------------XXXXXXXXXXXXX---ooo---XXXXXXXXXXXXXXXXXXXXXXXX-
XXXXXXXXXXXXXX-g---k--XXX---k-G---XX----XXXXXXXXXXXXXXX-----XXXXXXXXXXXXX--gg--XXXXXXXXX---------XXXXXXXXXXXXXXXXXXXXXXXXXXXXXXXXXXXXXXXXXXXXXXXXXXXXXXXXXXXXXXXXXXXXX----y-y--XXXXXXXXXXXXXXXXXXXXXXXXX
XXXXXXXXXXXXXXXXXXXXXXXXXXXXXXXXXXXXXXXXXXXXXXXXXXXXXXXXXXXXXXXXXXXXXXXXXXXXXXXXXXXXXXXXXXXXXXXXXXXXXXXXXXXXXXXXXXXXXXXXXXXXXXXXXXXXXXXXXXXXXXXXXXXXXXXXXXXXXXXXXXXXXXXXXXXXXXXXXXXXXXXXXXXXXXXXXXXXXXXX

