--------------------------------------------------------------------------------------------------------------------------------------------------------------------------------------------------------
--------------------------------------------------------------------------------------------------------------------------------------------------------------------------------------------------------
--------------------------------------------------------------------------------------------------------------------------------------------------------------------------------------------------------
--------------------------------------------------------------------------------------------------------------------------------------------------------------------------------------------------------
--------------------------------------------------------------------------------------------------------------------------------------------------------------------------------------------------------
--------------------------------------------------------------------------------------------------------------------------------------------------------------------------------------------------------
--------------------------------------------------------------------------------------------------------------------------------------------------------------------------------------------------------
--------------------------------------------------------------------------------------------------------------------------------------------------------------------------------------------------------
--------------------------------------------------------------------------------------------------------------------------------------------------------------------------------------------------------
--------------------------------------------------------------------------------------------------------------------------------------------------------------------------------------------------------
--------------------------------------------------------------------------------------------------------------------------------------------------------------------------------------------------------
--------------------------------------------------------------------------------------------------------------------------------------------------------------------------------------------------------
--------------------------------------------------------------------------------------------oooo-----------------------------------------------------------------------------------ooo------------------
---------------------------------------------------------------oSS------------------------------------------------------------------------Sooo-----------------------ooooo------------------------------
-------------------------Soo-------oSooo------------------------------oooo--------------------oooo--------SoSo-----oooSoo--ooSoo--------------------oo---------------------------oooooo------Soooo------
---------------oooo------------------------G----------------oooooo-----k-k--------SooSo----------k----------------------------------------ooo----yg----r------------ooooo-------yk----------------------
XXXXXXXXXXXXX--rKgKg---ooooooo--oooooooo-XXXXXX--------------------y-XXXXXX----------------XXXXXXXX--------------ooooo------------XXXXX----R----XXXXXXXXX----------R-g-R-------XXXXXXXXXXX--ooooo--XXXX-
XXXXXXXXXXXXXXXXXXXXX---R-G-----g---rR---XXXXXX---------XXXXXXXXXXXXXXXXXXX------oooooooo--XXXXXXXX-------r-ky---r--g--r-----r--y-XXXXXXXXXXXXXXXXXXXXXXX-------XXXXXXXXXXXXX--XXXXXXXXXXX-Yy-G----XXXX-
XXXXXXXXXXXXXXXXXXXXXXXXXXXXXXXXXXXXXXXXXXXXXXXXXXXXXXXXXXXXXXXXXXXXXXXXXXXXXXXX-----y---G-XXXXXXXX-----XXXXXXXXXXXXXXXXXXXXXXXXXXXXXXXXXXXXXXXXXXXXXXXXX-------XXXXXXXXXXXXX--XXXXXXXXXXXXXXXXXXXXXXXXX
XXXXXXXXXXXXXXXXXXXXXXXXXXXXXXXXXXXXXXXXXXXXXXXXXXXXXXXXXXXXXXXXXXXXXXXXXXXXXXXXXXXXXXXXXXXXXXXXXXXXXXXXXXXXXXXXXXXXXXXXXXXXXXXXXXXXXXXXXXXXXXXXXXXXXXXXXXXXXXXXXXXXXXXXXXXXXXXXXXXXXXXXXXXXXXXXXXXXXXXX

