--------------------------------------------------------------------------------------------------------------------------------------------------------------------------------------------------------
--------------------------------------------------------------------------------------------------------------------------------------------------------------------------------------------------------
--------------------------------------------------------------------------------------------------------------------------------------------------------------------------------------------------------
--------------------------------------------------------------------------------------------------------------------------------------------------------------------------------------------------------
--------------------------------------------------------------------------------------------------------------------------------------------------------------------------------------------------------
--------------------------------------------------------------------------------------------------------------------------------------------------------------------------------------------------------
--------------------------------------------------------------------------------------------------------------------------------------------------------------------------------------------------------
--------------------------------------------------------------------------------------------------------------------------------------------------------------------------------------------------------
--------------------------------------------------------------------------------------------------------------------------------------------------------------------------------------------------------
--------------------------------------------------------------------------------------------------------------------------------------------------------------------------------------------------------
--------------------------------------------------------------------------------------------------------------------------------------------------------------------------------------------------------
--------------------------------------------------------------------------------------------------------------------------------------------------------------------------------------------------------
-----------------------------------------------------------------------Sooooo---------------------------------------------------------------------------------------------------------------------------
---------------------------------------------------------------------------------------------------------oSSS-------------------------------------------------------------------------------------------
----------------------------------------------------------------oo------ooooo-----------------oo---------------------------------------oooo-------------------------------------------------------------
-------------SooSSS---------------------------k----------------------r-yKy-K----------Sooo----GgK--------oo-----------------k-g--------Rr------------------------------g----ooooooSoo-------------------
XXXXXXXXXX-----------XXXXX-----------------XXXXXX------------XXXXXXXXXXXXXXXXXX-------------XXXXXX----k-yy-----------------XXXXXXXXX--XXXXXXXXXXX--------------------XXXXXX-----------XXX---------------
XXXXXXXXXX----ooo----XXXXX-----------------XXXXXX--XXXXX-----XXXXXXXXXXXXXXXXXX--------ooo--XXXXXX---XXXXXXXXXX------------XXXXXXXXXXXXXXXXXXXXXX------oo----r-r--r--XXXXXX---oooooo--XXXXXX-ooo--------
XXXXXXXXXX-R---r-Yr--XXXXX-kgY--XXXX-----R-XXXXXXXXXXXXXXXXXXXXXXXXXXXXXXXXXXXXXXXXX--K-----XXXXXX---XXXXXXXXXXXXXX-----XXXXXXXXXXXXXXXXXXXXXXXXX-------g---XXXXXXXXXXXXXXX-----------XXXXXX---rgYg-XXXX
XXXXXXXXXXXXXXXXXXXXXXXXXXXXXXXXXXXXXXXXXXXXXXXXXXXXXXXXXXXXXXXXXXXXXXXXXXXXXXXXXXXXXXXXXXXXXXXXXXXXXXXXXXXXXXXXXXXXXXXXXXXXXXXXXXXXXXXXXXXXXXXXXXXXXXXXXXXXXXXXXXXXXXXXXXXXXXXXXXXXXXXXXXXXXXXXXXXXXXXX

