--------------------------------------------------------------------------------------------------------------------------------------------------------------------------------------------------------
--------------------------------------------------------------------------------------------------------------------------------------------------------------------------------------------------------
--------------------------------------------------------------------------------------------------------------------------------------------------------------------------------------------------------
--------------------------------------------------------------------------------------------------------------------------------------------------------------------------------------------------------
--------------------------------------------------------------------------------------------------------------------------------------------------------------------------------------------------------
--------------------------------------------------------------------------------------------------------------------------------------------------------------------------------------------------------
--------------------------------------------------------------------------------------------------------------------------------------------------------------------------------------------------------
--------------------------------------------------------------------------------------------------------------------------------------------------------------------------------------------------------
--------------------------------------------------------------------------------------------------------------------------------------------------------------------------------------------------------
--------------------------------------------------------------------------------------------------------------------------------------------------------------------------------------------------------
--------------------------------------------------------------------------------------------------------------------------------------------------------------------------------------------------------
--------------------------------------------------------------------------------------------------------------------------------------------------------------------------------------------------------
----------------------------------------------------------------------------------------------------------------------oSo---------------------oSSoooooo-------------------------------------------------
---------------------------------oSoooS-----------------------------------------------------------------------------------------------------------------------------------------------------------------
-------------------------------------------------oSoo---------------------oSS-----------------------------ooSSSS----ooo------------------------ooooo------------Sooooo--------------oooo-----------SSS--
---------------------------------ooooo--------------------------oSo-------------------------------------------------g-y------------------------r------k-------------------------------------------------
------------------XXXXX-----------k--k----------oooooo-XXXXXXXX-----------ooo--XXXXXXXXX-------------------ooooo---XXXXXXXX-------------XXXXXXXXXXXXXXXXXXXXXX---ooo----XXX-------ooo------------ooo----
------------------XXXXX-------XXXXXXXXXXX-G-Y------gy--XXXXXXXX-ooooo------kr--XXXXXXXXX-oo------oo-XX------Yk-KgR-XXXXXXXX--------R--g-XXXXXXXXXXXXXXXXXXXXXX---r----r-XXXXXXXX---R--K-----ooo--Y--r---
XXXXXXXXXXXXX-----XXXXX-----XXXXXXXXXXXXXXXXXXXXXXXXXXXXXXXXXXX--y-Y-r-XXXXXXXXXXXXXXXXX--kky----g--XXXXXXXXXXXXXXXXXXXXXXX-------XXXXXXXXXXXXXXXXXXXXXXXXXXXXXXXXXXXXXXXXXXXXXXXXXXXXXXX-r--G--XXXXXXXX
XXXXXXXXXXXXXXXXXXXXXXXXXXXXXXXXXXXXXXXXXXXXXXXXXXXXXXXXXXXXXXXXXXXXXXXXXXXXXXXXXXXXXXXXXXXXXXXXXXXXXXXXXXXXXXXXXXXXXXXXXXXXXXXXXXXXXXXXXXXXXXXXXXXXXXXXXXXXXXXXXXXXXXXXXXXXXXXXXXXXXXXXXXXXXXXXXXXXXXXX

