--------------------------------------------------------------------------------------------------------------------------------------------------------------------------------------------------------
--------------------------------------------------------------------------------------------------------------------------------------------------------------------------------------------------------
--------------------------------------------------------------------------------------------------------------------------------------------------------------------------------------------------------
--------------------------------------------------------------------------------------------------------------------------------------------------------------------------------------------------------
--------------------------------------------------------------------------------------------------------------------------------------------------------------------------------------------------------
--------------------------------------------------------------------------------------------------------------------------------------------------------------------------------------------------------
--------------------------------------------------------------------------------------------------------------------------------------------------------------------------------------------------------
--------------------------------------------------------------------------------------------------------------------------------------------------------------------------------------------------------
--------------------------------------------------------------------------------------------------------------------------------------------------------------------------------------------------------
--------------------------------------------------------------------------------------------------------------------------------------------------------------------------------------------------------
--------------------------------------------------------------------------------------------------------------------------------------------------------------------------------------------------------
--------------------------------------------------------------------------------------------------------------------------------------------------------------------------------------------------------
----------------------------------------SSSoo---------------------------------------------------------------ooSo---------------------------------------------------------------oooo---------------------
-------------------------------------------------SoSo---------------------------------------------------------------------------------------------------------------------------------------------------
--------------------------------------oooooo---------------ooooo-----------oooo-----------oSoSooSSo----------ooo-----------------------------------------oooooo-------oooo---oooooo---------------------
----------------------------------------R-k------oooo----------------------g--------------------------------g-----ooooS--------ooo-------------------------------------------k---g-----oSoSoo--oSoo-----
------------------XXXX----------r-rg-XXXXXXXXX-r--y--Y-------oo-----oo----XXXXXX------------ooooooo---R----XXXXXX------------------------------------------ooooo-------oo--XXXXXXXXX--------------------
------------------XXXX-oo------XXXXXXXXXXXXXXXXXXXXXXXXXX-gy-g-------r----XXXXXXXXXXX---------------XXXXXXXXXXXXX----ooo----oooooo----XXX----ooo----ooo----------k-------k-XXXXXXXXX--ooooo------oooo---
-------------XXXXXXXXX--ky-----XXXXXXXXXXXXXXXXXXXXXXXXXXXXXXXXXXXXXXXXXXXXXXXXXXXXXX--XXXXXXXXXXXXXXXXXXXXXXXXXX--r-----y------g--Yk-XXXXX---k-K-------XXXXXXXXXXXXXXXXXXXXXXXXXXXX---r-K-y---K--y-----
XXXXXXXXXXXXXXXXXXXXXXXXXXXXXXXXXXXXXXXXXXXXXXXXXXXXXXXXXXXXXXXXXXXXXXXXXXXXXXXXXXXXXXXXXXXXXXXXXXXXXXXXXXXXXXXXXXXXXXXXXXXXXXXXXXXXXXXXXXXXXXXXXXXXXXXXXXXXXXXXXXXXXXXXXXXXXXXXXXXXXXXXXXXXXXXXXXXXXXXX

