--------------------------------------------------------------------------------------------------------------------------------------------------------------------------------------------------------
--------------------------------------------------------------------------------------------------------------------------------------------------------------------------------------------------------
--------------------------------------------------------------------------------------------------------------------------------------------------------------------------------------------------------
--------------------------------------------------------------------------------------------------------------------------------------------------------------------------------------------------------
--------------------------------------------------------------------------------------------------------------------------------------------------------------------------------------------------------
--------------------------------------------------------------------------------------------------------------------------------------------------------------------------------------------------------
--------------------------------------------------------------------------------------------------------------------------------------------------------------------------------------------------------
--------------------------------------------------------------------------------------------------------------------------------------------------------------------------------------------------------
--------------------------------------------------------------------------------------------------------------------------------------------------------------------------------------------------------
--------------------------------------------------------------------------------------------------------------------------------------------------------------------------------------------------------
--------------------------------------------------------------------------------------------------------------------------------------------------------------------------------------------------------
--------------------------------------------------------------------------------------------------------------------------------------------------------------------------------------------------------
---------------------------------------------------------------------ooSSSo--------------------------------------------------------------------------ooS------------------------------------------------
--------------------------------oooo--ooo----------------------------------------------------------------------------------------------------oSSoo---------------------------Soo------------------------
-------------------------------------------------------oSooS----------ooooooo------oooSSS---------------------------------------ooSooSoo------------oooooo----------------------------------------------
------------------------oo--------------------------------------------K-----------------------------------------------ooSoo----------------ooooooo----y-----------------------oo-------g----------------
XXXXXXXXXXXXXX---------kk--yG--y---K--R--------------ooooo----------XXXXXXXXXX------oooo--------------XXX-----------------------ooooooo----R---KR--XXXXXXXXX---------------Kr-kYYr-XXXXXX------XXXXXXXXX
XXXXXXXXXXXXXX-ooooo--XXXXXXXXXXXXXXXXXXXXX-------------g-----XXXX--XXXXXXXXXX--------r---g-------XX--XXX------XXXX----ooo---XX--k--r----XXXXXXXXXXXXXXXXXXX--------------XXXXXXXXXXXXXXX------XXXXXXXXX
XXXXXXXXXXXXXX--gkk---XXXXXXXXXXXXXXXXXXXXXXXXX--XXXXXXXXXXXXXXXXX--XXXXXXXXXXXXXXXXXXXXXXXXXXXXXXXX--XXX-rgK--XXXX-----ryk--XXXXXXXXXXXXXXXXXXXXXXXXXXXXXXX-r-G------XXXXXXXXXXXXXXXXXXXXXXXXXXXXXXXXXX
XXXXXXXXXXXXXXXXXXXXXXXXXXXXXXXXXXXXXXXXXXXXXXXXXXXXXXXXXXXXXXXXXXXXXXXXXXXXXXXXXXXXXXXXXXXXXXXXXXXXXXXXXXXXXXXXXXXXXXXXXXXXXXXXXXXXXXXXXXXXXXXXXXXXXXXXXXXXXXXXXXXXXXXXXXXXXXXXXXXXXXXXXXXXXXXXXXXXXXXX

