--------------------------------------------------------------------------------------------------------------------------------------------------------------------------------------------------------
--------------------------------------------------------------------------------------------------------------------------------------------------------------------------------------------------------
--------------------------------------------------------------------------------------------------------------------------------------------------------------------------------------------------------
--------------------------------------------------------------------------------------------------------------------------------------------------------------------------------------------------------
--------------------------------------------------------------------------------------------------------------------------------------------------------------------------------------------------------
--------------------------------------------------------------------------------------------------------------------------------------------------------------------------------------------------------
--------------------------------------------------------------------------------------------------------------------------------------------------------------------------------------------------------
--------------------------------------------------------------------------------------------------------------------------------------------------------------------------------------------------------
--------------------------------------------------------------------------------------------------------------------------------------------------------------------------------------------------------
--------------------------------------------------------------------------------------------------------------------------------------------------------------------------------------------------------
--------------------------------------------------------------------------------------------------------------------------------------------------------------------------------------------------------
--------------------------------------------------------------------------------------------------------------------------------------------------------------------------------------------------------
-----------------------------------------------------------------------------------ooo------ooo---------------------ooooooo-----------------------------------------------------------------------------
-----------oooo-----------------------------ooSoo--------SoSo---------------------------------------------ooooSo----------------------------------------------------------------------------------------
-----------------------------------SSooo--------------------------------------------ooo-----oooooo------------------oooooo-----oo---------------ooooSo--------------------------------------------------
-----------------------oSS-----------------ooo----------oooooo---------------------R--------g---r--------ooooooo----rKkrKk-r-----g--------------------------oSSoooo-------------------------------------
-----------------------------XXX---oo------r---------------g-------oo-------------XXXXXXXXXXXXXXXXX-------y---k--Y-XXXXXXXXXXXXXXXX----XX---oo---oo----XXXX----------XXXXX---------------------XXXXXXXXX
----------XXXXXXX------ooooo-XXX-g-R-KY--XXXXXXXXX---XXXXXXXXXXX------------------XXXXXXXXXXXXXXXXXXXX--XXXXXXXXXXXXXXXXXXXXXXXXXXXXX--XX-yKk-----RR---XXXX--ooooo---XXXXX---------XX----------XXXXXXXXX
----------XXXXXXXXXX--g----K-XXXXXXXXXXXXXXXXXXXXXXXXXXXXXXXXXXXXXXXXXXXXXXX----y-XXXXXXXXXXXXXXXXXXXX--XXXXXXXXXXXXXXXXXXXXXXXXXXXXX--XXXXXXXXXXXXXXXXXXXX----R--K--XXXXXXXXXXX---XXXXXX--XXXXXXXXXXXXX
XXXXXXXXXXXXXXXXXXXXXXXXXXXXXXXXXXXXXXXXXXXXXXXXXXXXXXXXXXXXXXXXXXXXXXXXXXXXXXXXXXXXXXXXXXXXXXXXXXXXXXXXXXXXXXXXXXXXXXXXXXXXXXXXXXXXXXXXXXXXXXXXXXXXXXXXXXXXXXXXXXXXXXXXXXXXXXXXXXXXXXXXXXXXXXXXXXXXXXXX

