--------------------------------------------------------------------------------------------------------------------------------------------------------------------------------------------------------
--------------------------------------------------------------------------------------------------------------------------------------------------------------------------------------------------------
--------------------------------------------------------------------------------------------------------------------------------------------------------------------------------------------------------
--------------------------------------------------------------------------------------------------------------------------------------------------------------------------------------------------------
--------------------------------------------------------------------------------------------------------------------------------------------------------------------------------------------------------
--------------------------------------------------------------------------------------------------------------------------------------------------------------------------------------------------------
--------------------------------------------------------------------------------------------------------------------------------------------------------------------------------------------------------
--------------------------------------------------------------------------------------------------------------------------------------------------------------------------------------------------------
--------------------------------------------------------------------------------------------------------------------------------------------------------------------------------------------------------
--------------------------------------------------------------------------------------------------------------------------------------------------------------------------------------------------------
--------------------------------------------------------------------------------------------------------------------------------------------------------------------------------------------------------
--------------------------------------------------------------------------------------------------------------------------------------------------------------------------------------------------------
----------------------------ooS-------------------------------------------------------oSooS-------------------------------------------------------------------------------------------------------------
------------------SoS---------------------------------------------------ooSooooS-----------------------------------oSSSo-------------------oSS----oSooooo-----------------------------------------------
---------------------------ooo----ooo---ooSSoo--ooooo---------------------------------ooo------------------------------------------------------------------------------------SoooSo----------oSooo------
-------------------ooooo--K-g-------------------------------ooo----------oooooo----g--y---g--------------oooSoo--ooooooo--oSSooSo----------------oooooo--------------------------------oSo--------------
----------------yy--r----XXXXXXXXXXXXXX-ooo--------oooo-------------------R-g--Rk-XXXXXXXXXXXXXXX-------------------rk-g-----------XXX-------k------------------------------oooooo--------------oo--XXXX
----------XXXXXXXXXXXXXXXXXXXXXXXXXXXXX--yk----------Y--XXXXXXXX--ooo--XXXXXXXXXXXXXXXXXXXXXXXXXX---------ooo---XXXXXXXXX-oooooo---XXXXXXXXXXXXXXXXXXXXXXX----------oo------r----------oooo--rr-----XXXX
XXXXXXXXXXXXXXXXXXXXXXXXXXXXXXXXXXXXXXXXXXXXXXXXXXXXXXXXXXXXXXXX-kr----XXXXXXXXXXXXXXXXXXXXXXXXXXXXXXX-------g--XXXXXXXXX-----y----XXXXXXXXXXXXXXXXXXXXXXXXXXXXXX----g--XXXXXXXXXXXX-k------XXXXXXXXXXXX
XXXXXXXXXXXXXXXXXXXXXXXXXXXXXXXXXXXXXXXXXXXXXXXXXXXXXXXXXXXXXXXXXXXXXXXXXXXXXXXXXXXXXXXXXXXXXXXXXXXXXXXXXXXXXXXXXXXXXXXXXXXXXXXXXXXXXXXXXXXXXXXXXXXXXXXXXXXXXXXXXXXXXXXXXXXXXXXXXXXXXXXXXXXXXXXXXXXXXXXX

