--------------------------------------------------------------------------------------------------------------------------------------------------------------------------------------------------------
--------------------------------------------------------------------------------------------------------------------------------------------------------------------------------------------------------
--------------------------------------------------------------------------------------------------------------------------------------------------------------------------------------------------------
--------------------------------------------------------------------------------------------------------------------------------------------------------------------------------------------------------
--------------------------------------------------------------------------------------------------------------------------------------------------------------------------------------------------------
--------------------------------------------------------------------------------------------------------------------------------------------------------------------------------------------------------
--------------------------------------------------------------------------------------------------------------------------------------------------------------------------------------------------------
--------------------------------------------------------------------------------------------------------------------------------------------------------------------------------------------------------
--------------------------------------------------------------------------------------------------------------------------------------------------------------------------------------------------------
--------------------------------------------------------------------------------------------------------------------------------------------------------------------------------------------------------
--------------------------------------------------------------------------------------------------------------------------------------------------------------------------------------------------------
--------------------------------------------------------------------------------------------------------------------------------------------------------------------------------------------------------
----------------Sooo-------------------------------------------------------------------------ooSooSo------------------------------------------------------------------------------------ooSSo-----------
--------------------------------------------oooSoo------------------------------------------------------------------------------------------------------------------------------------------------------
---------------oooooooo----Soo-----------------------------------ooooSooSo------------------oooooo----------------------------------ooooo----oooooo----Soooooo--------------------------oooooooo---oooo-
--------------ky---------------------ooo----ooooo-----oSo----oo-------------oooo-------------yr---------oo--G-yg-------------------------------------------------------Soo------------------r--g--------
XXXXXXXXXXXXXXXXXXXXXXXX-ooooo-------r--------yG-----------y--y----oooo------------------XXXXXXXXXXXX--GGr-XXXXXXX----------------XXXXXXXX--ooooooo---oooooo---XXXXX----------------XXXXXXXXXXXXX-------
XXXXXXXXXXXXXXXXXXXXXXXX---y--Ky--XXXXXXXXXXXXXXXXXX--ooo-XXXXXX---g-Y--rk-XXXXXXX-------XXXXXXXXXXXXXXXXXXXXXXXXX--------oooooo--XXXXXXXX----Y--k----r-----gG-XXXXX---oooo------oo-XXXXXXXXXXXXX----r--
XXXXXXXXXXXXXXXXXXXXXXXXXXXXXXXXXXXXXXXXXXXXXXXXXXXX----K-XXXXXXXXXXXXXXXXXXXXXXXXXXXXXXXXXXXXXXXXXXXXXXXXXXXXXXXX-------krr-rk-g-XXXXXXXXXXXXXXXXXXXXXXXXXXXXXXXXXX-kr---------Y-r-XXXXXXXXXXXXXXXXXXXX
XXXXXXXXXXXXXXXXXXXXXXXXXXXXXXXXXXXXXXXXXXXXXXXXXXXXXXXXXXXXXXXXXXXXXXXXXXXXXXXXXXXXXXXXXXXXXXXXXXXXXXXXXXXXXXXXXXXXXXXXXXXXXXXXXXXXXXXXXXXXXXXXXXXXXXXXXXXXXXXXXXXXXXXXXXXXXXXXXXXXXXXXXXXXXXXXXXXXXXXX

