--------------------------------------------------------------------------------------------------------------------------------------------------------------------------------------------------------
--------------------------------------------------------------------------------------------------------------------------------------------------------------------------------------------------------
--------------------------------------------------------------------------------------------------------------------------------------------------------------------------------------------------------
--------------------------------------------------------------------------------------------------------------------------------------------------------------------------------------------------------
--------------------------------------------------------------------------------------------------------------------------------------------------------------------------------------------------------
--------------------------------------------------------------------------------------------------------------------------------------------------------------------------------------------------------
--------------------------------------------------------------------------------------------------------------------------------------------------------------------------------------------------------
--------------------------------------------------------------------------------------------------------------------------------------------------------------------------------------------------------
--------------------------------------------------------------------------------------------------------------------------------------------------------------------------------------------------------
--------------------------------------------------------------------------------------------------------------------------------------------------------------------------------------------------------
--------------------------------------------------------------------------------------------------------------------------------------------------------------------------------------------------------
--------------------------------------------------------------------------------------------------------------------------------------------------------------------------------------------------------
------------------------------------ooS---------------------------------------oSooo---------------------------------------------------------------------------------------------------------------------
-----------------------------------------------------oSoo-----------ooSo------------------------------------------------------------------------------------oSoSoo---ooSSSo----ooo-----oSoSo------------
---------------------------------oooooo--------------------------------------ooooo------------------------------------Sooo---------------------------------------------------------------------oooo-----
-----------------------------------g--------ooooS-----ooooo--------ooooo-------------------------------ooSoo--------------------------SSo----------------------oo------oooo----ooo-----------------K-y--
---------------------XXX---XXXXXXXXXXXXXX------------K-k--y---------kRR----XXXXXXXXXXX-----XXX------------------------oooo----------------------------XXXXX---r----------YY--------y----yg--y-XXXXXXXXXX
XXXXXXXXXXXXXXXXXXXXXXXX---XXXXXXXXXXXXXX-----ooooo-XXXXXXXXXXXXXXXXXXXXXXXXXXXXXXXXXX-----XXX----------oooooo-XX---k--g------------oooo----kr-k------XXXXXXXXXXXXXXXXXXXXXXXXXXXXXXXXXXXXXXXXXXXXXXXXXX
XXXXXXXXXXXXXXXXXXXXXXXXXXXXXXXXXXXXXXXXXXX-y----r--XXXXXXXXXXXXXXXXXXXXXXXXXXXXXXXXXX-----XXX----XXX-r---gky--XXXXXXXXXXXXXXXXXXX-g-rR-r--XXXXXXXXXXXXXXXXXXXXXXXXXXXXXXXXXXXXXXXXXXXXXXXXXXXXXXXXXXXXX
XXXXXXXXXXXXXXXXXXXXXXXXXXXXXXXXXXXXXXXXXXXXXXXXXXXXXXXXXXXXXXXXXXXXXXXXXXXXXXXXXXXXXXXXXXXXXXXXXXXXXXXXXXXXXXXXXXXXXXXXXXXXXXXXXXXXXXXXXXXXXXXXXXXXXXXXXXXXXXXXXXXXXXXXXXXXXXXXXXXXXXXXXXXXXXXXXXXXXXXX

