--------------------------------------------------------------------------------------------------------------------------------------------------------------------------------------------------------
--------------------------------------------------------------------------------------------------------------------------------------------------------------------------------------------------------
--------------------------------------------------------------------------------------------------------------------------------------------------------------------------------------------------------
--------------------------------------------------------------------------------------------------------------------------------------------------------------------------------------------------------
--------------------------------------------------------------------------------------------------------------------------------------------------------------------------------------------------------
--------------------------------------------------------------------------------------------------------------------------------------------------------------------------------------------------------
--------------------------------------------------------------------------------------------------------------------------------------------------------------------------------------------------------
--------------------------------------------------------------------------------------------------------------------------------------------------------------------------------------------------------
--------------------------------------------------------------------------------------------------------------------------------------------------------------------------------------------------------
--------------------------------------------------------------------------------------------------------------------------------------------------------------------------------------------------------
--------------------------------------------------------------------------------------------------------------------------------------------------------------------------------------------------------
--------------------------------------------------------------------------------------------------------------------------------------------------------------------------------------------------------
---------------------------------------------------------------------------------SoooS----------------------------------------------------------------------SSoSS---------------------------------------
----------------------------------------------------------------------------------------------------------------SSSSSooo----------------------------------------------------------oooo------------------
---------------------------------------oooSSo-----------------------------------ooooo------------------------------------------------SSo-----oooSo----------ooooooo-------------------------------------
---------------------------Rg----------------------------------------------SSo--rk-G------------------oooooo------oooooo-----------------------------------G-----------oooooo-------oo-----------ooooo--
------------------XX---XXXXXXXXXXX------ooo-----------gr-----------------------XXXXXXXXXX--oo--------y--YG-----------kk------------oooooo-----ooooo--XXXXXXXXXXXXXXX-------------r-k--------------------
------------------XXXXXXXXXXXXXXXX---KgK----G------XXXXXXX-------oo-------oo---XXXXXXXXXX-k-GRy--XXXXXXXXXXXXXXXXXXXXXXXX--ooooo---g--g-----R-----R--XXXXXXXXXXXXXXX--oooo------XXXXXXXXX--------oo----X
--------------XXXXXXXXXXXXXXXXXXXX--XXXXXXXXXXXXXXXXXXXXXXXXXXX----k----Gg-----XXXXXXXXXXXXXXXXXXXXXXXXXXXXXXXXXXXXXXXXXX-yry-g--XXXXXXXXXXXXXXXXXXXXXXXXXXXXXXXXXXX-rR----y----XXXXXXXXX-------r------X
XXXXXXXXXXXXXXXXXXXXXXXXXXXXXXXXXXXXXXXXXXXXXXXXXXXXXXXXXXXXXXXXXXXXXXXXXXXXXXXXXXXXXXXXXXXXXXXXXXXXXXXXXXXXXXXXXXXXXXXXXXXXXXXXXXXXXXXXXXXXXXXXXXXXXXXXXXXXXXXXXXXXXXXXXXXXXXXXXXXXXXXXXXXXXXXXXXXXXXXX

