--------------------------------------------------------------------------------------------------------------------------------------------------------------------------------------------------------
--------------------------------------------------------------------------------------------------------------------------------------------------------------------------------------------------------
--------------------------------------------------------------------------------------------------------------------------------------------------------------------------------------------------------
--------------------------------------------------------------------------------------------------------------------------------------------------------------------------------------------------------
--------------------------------------------------------------------------------------------------------------------------------------------------------------------------------------------------------
--------------------------------------------------------------------------------------------------------------------------------------------------------------------------------------------------------
--------------------------------------------------------------------------------------------------------------------------------------------------------------------------------------------------------
--------------------------------------------------------------------------------------------------------------------------------------------------------------------------------------------------------
--------------------------------------------------------------------------------------------------------------------------------------------------------------------------------------------------------
--------------------------------------------------------------------------------------------------------------------------------------------------------------------------------------------------------
--------------------------------------------------------------------------------------------------------------------------------------------------------------------------------------------------------
--------------------------------------------------------------------------------------------------------------------------------------------------------------------------------------------------------
----------------------------------------------------------------------------------oSSooo----------------------------------------------------------------------------------------------------------------
-----------------------------------------------oSoSo--oooS------------------Soo----------------------------------oooS-------------------------------------oooSoo----------------------------------------
-------------------------------SooS-----ooooo----------------------------------------ooo----------------------------------------------------------------------------------------------------------------
--------------ooooS--------------------g----R----------ooooo-------------oooooo-----g-k-------ooSo----------------oooo------------------------ooSS--------ooooooo---SoooS----------------------------oo-
-----------------------ooo------ooo---XXXXXXXX-Ry------------------------R----k--XXXXXXXXX--------------oo-XXXX-----------------------XX----------------------k----------------------XXX-----oo---Y-----
----------------ooo------------y--kky-XXXXXXXXXXXXXXXXXXXXXXXXXX--------XXXXXXXXXXXXXXXXXX-----oo----yRg-g-XXXXXXXXXXXXXXXXX----ooo---XX-----oooooo-----XXXXXXXXXX--ooooo---XXX------XXX------Kg-XXXXXXX
XXXXXXXXXXXX--r-K-R-y-XXXXXXXXXXXXXXXXXXXXXXXXXXXXXXXXXXXXXXXXXXXXXX----XXXXXXXXXXXXXXXXXX------K---XXXXXXXXXXXXXXXXXXXXXXXX----y--r--XX----gK--kR--XXXXXXXXXXXXXX----------XXX----k-XXXXXXXXXXXXXXXXXXX
XXXXXXXXXXXXXXXXXXXXXXXXXXXXXXXXXXXXXXXXXXXXXXXXXXXXXXXXXXXXXXXXXXXXXXXXXXXXXXXXXXXXXXXXXXXXXXXXXXXXXXXXXXXXXXXXXXXXXXXXXXXXXXXXXXXXXXXXXXXXXXXXXXXXXXXXXXXXXXXXXXXXXXXXXXXXXXXXXXXXXXXXXXXXXXXXXXXXXXXX

