--------------------------------------------------------------------------------------------------------------------------------------------------------------------------------------------------------
--------------------------------------------------------------------------------------------------------------------------------------------------------------------------------------------------------
--------------------------------------------------------------------------------------------------------------------------------------------------------------------------------------------------------
--------------------------------------------------------------------------------------------------------------------------------------------------------------------------------------------------------
--------------------------------------------------------------------------------------------------------------------------------------------------------------------------------------------------------
--------------------------------------------------------------------------------------------------------------------------------------------------------------------------------------------------------
--------------------------------------------------------------------------------------------------------------------------------------------------------------------------------------------------------
--------------------------------------------------------------------------------------------------------------------------------------------------------------------------------------------------------
--------------------------------------------------------------------------------------------------------------------------------------------------------------------------------------------------------
--------------------------------------------------------------------------------------------------------------------------------------------------------------------------------------------------------
--------------------------------------------------------------------------------------------------------------------------------------------------------------------------------------------------------
--------------------------------------------------------------------------------------------------------------------------------------------------------------------------------------------------------
------------------------ooSoSo--------------------------------------------------------------------------------------------------------------------------------------------------------------------------
------------------------------------------------------------------------oooSoSo-------------------------------------------------SoS---------------------------------------------------------------------
-----------oSooSS-----ooooooo------------------------------------------------------SoSoooo-----------------------------------------------oooSo----------------------------------------------------------
-----------------------G-Yy--y----------------ooo----------------------oooooo---------------y-krG--------------------oooooo------ooooo-------------------ooSooo---------------------------SoS-----------
------------ooooo---XXXXXXXXXXX---oo--r-R-Y----------------------XXXXX---kr--------ooooo---XXXXXXX------ooo---XXXXX------------g--r-----oooooo---------------------XXXXX--------------Y--------XXXXX----
-----------k-Y------XXXXXXXXXXX------XXXXXXXXXXXXX------------XXXXXXXXXXXXXXXXXX-k-gkK-----XXXXXXX----g---r---XXXXX-ooooooo---XXXXXXXXX---gG-----ooooo-----ooooooo-XXXXX----------XXXXXX-oo----XXXXX----
----------XXXXXXXXXXXXXXXXXXXXXXXXXXXXXXXXXXXXXXXX------------XXXXXXXXXXXXXXXXXXXXXXXXXXXXXXXXXXXXXXXXXXXXXXXXXXXXX-k-Y----Ry-XXXXXXXXXXXXXXXXXX---KK-----YRrkKYk--XXXXX-----XXXXXXXXXXX--y--y-XXXXX---X
XXXXXXXXXXXXXXXXXXXXXXXXXXXXXXXXXXXXXXXXXXXXXXXXXXXXXXXXXXXXXXXXXXXXXXXXXXXXXXXXXXXXXXXXXXXXXXXXXXXXXXXXXXXXXXXXXXXXXXXXXXXXXXXXXXXXXXXXXXXXXXXXXXXXXXXXXXXXXXXXXXXXXXXXXXXXXXXXXXXXXXXXXXXXXXXXXXXXXXXX

