--------------------------------------------------------------------------------------------------------------------------------------------------------------------------------------------------------
--------------------------------------------------------------------------------------------------------------------------------------------------------------------------------------------------------
--------------------------------------------------------------------------------------------------------------------------------------------------------------------------------------------------------
--------------------------------------------------------------------------------------------------------------------------------------------------------------------------------------------------------
--------------------------------------------------------------------------------------------------------------------------------------------------------------------------------------------------------
--------------------------------------------------------------------------------------------------------------------------------------------------------------------------------------------------------
--------------------------------------------------------------------------------------------------------------------------------------------------------------------------------------------------------
--------------------------------------------------------------------------------------------------------------------------------------------------------------------------------------------------------
--------------------------------------------------------------------------------------------------------------------------------------------------------------------------------------------------------
--------------------------------------------------------------------------------------------------------------------------------------------------------------------------------------------------------
--------------------------------------------------------------------------------------------------------------------------------------------------------------------------------------------------------
--------------------------------------------------------------------------------------------------------------------------------------------------------------------------------------------------------
-----------------------------------------------------------------------------------------oSo---------------------------------------------------oSoooo----------oooo-------------------------------------
---------------------------------------------SoSooSS----------------------------------------------------------------------------------------------------------------------------------------------------
-------------------------------------------------------------------------------------------ooo--oo-------------oooo-----------------------------ooooo-----------oo-------------------------------oooo---
-------------------------------------ooooo-----ooooo-------------oooo--ooSooS-------oo-----------gg------------------ooo----------------------k---g------------G-Gg-------------ky-------------------y--
----------------------------XX-------g--yr----r----y------------------------------------XXXXXXXXXXXXXXXXXXX----oo---------Y-----ooooo-XX-----XXXXXXXXX------XXXXXXXXXXXXX-----XXXXXX--oo-------XXXXXXXX-
XXXXXXXXXXXXXX---------ooo--XX-----XXXXXXXXXXXXXXXXXXXXXXXXX-----------ooooo----XXXXXXXXXXXXXXXXXXXXXXXXXXX--K---g--XXXXXXXX--gG--g---XXXXX--XXXXXXXXX------XXXXXXXXXXXXXXXXXXXXXXXX-y-y-------XXXXXXXX-
XXXXXXXXXXXXXX--------k-g---XXXXXXXXXXXXXXXXXXXXXXXXXXXXXXXX-------g---k----g-g-XXXXXXXXXXXXXXXXXXXXXXXXXXXXXXXXXXXXXXXXXXXXXXXXXXXXXXXXXXX--XXXXXXXXX------XXXXXXXXXXXXXXXXXXXXXXXXXXXXXXXXXXXXXXXXXXX-
XXXXXXXXXXXXXXXXXXXXXXXXXXXXXXXXXXXXXXXXXXXXXXXXXXXXXXXXXXXXXXXXXXXXXXXXXXXXXXXXXXXXXXXXXXXXXXXXXXXXXXXXXXXXXXXXXXXXXXXXXXXXXXXXXXXXXXXXXXXXXXXXXXXXXXXXXXXXXXXXXXXXXXXXXXXXXXXXXXXXXXXXXXXXXXXXXXXXXXXX

