--------------------------------------------------------------------------------------------------------------------------------------------------------------------------------------------------------
--------------------------------------------------------------------------------------------------------------------------------------------------------------------------------------------------------
--------------------------------------------------------------------------------------------------------------------------------------------------------------------------------------------------------
--------------------------------------------------------------------------------------------------------------------------------------------------------------------------------------------------------
--------------------------------------------------------------------------------------------------------------------------------------------------------------------------------------------------------
--------------------------------------------------------------------------------------------------------------------------------------------------------------------------------------------------------
--------------------------------------------------------------------------------------------------------------------------------------------------------------------------------------------------------
--------------------------------------------------------------------------------------------------------------------------------------------------------------------------------------------------------
--------------------------------------------------------------------------------------------------------------------------------------------------------------------------------------------------------
--------------------------------------------------------------------------------------------------------------------------------------------------------------------------------------------------------
--------------------------------------------------------------------------------------------------------------------------------------------------------------------------------------------------------
--------------------------------------------------------------------------------------------------------------------------------------------------------------------------------------------------------
--------------------------------------------ooSoS-------------------------------------------------------------------------------------------------------------------------------------------------------
-------------------------------------------------------------------------------Sooo-----------------------------oooooS-----------------------------------------------------------SooSS------------------
-----------------------oooo------------------oo----------------------------------------------oSooooo--------------------------------------------ooo----------------------oSoo---------------------------
-------------------------------------oSo--------Gy-------SoSSSo----------------oo-------------------------------ooooooo--------------------------------------------------------ooooooo-----------oo-----
------------------------oo-----------------XXXXXXXX-------------XXXXXXXXXXXXX-y------------oooooo--------------ky-----r---ooooooo---------------ooo--------Y--g-XXXXX------------r---ry-------g-kr--XXXX
---------------ooooo--g---R--XXX-------ooo-XXXXXXXX-----oooooo--XXXXXXXXXXXXXXXXXXXXX--------Rg----k---------XXXXXXXXXXX---R-k----XXXXX--oo---R------R-Yg-XXXXXXXXXXX---------XXXXXXXXXX-----XXXXXXXXXXX
---------------K--k--XXXXXXXXXXXXXXX-K-----XXXXXXXX------k-g----XXXXXXXXXXXXXXXXXXXXX-----XXXXXXXXXXX-R--gr--XXXXXXXXXXXXXXXXXXXXXXXXXX---R--XXXXXXXXXXXXXXXXXXXXXXXXXXXXXXXXXXXXXXXXXXX--XXXXXXXXXXXXXX
XXXXXXXXXXXXXXXXXXXXXXXXXXXXXXXXXXXXXXXXXXXXXXXXXXXXXXXXXXXXXXXXXXXXXXXXXXXXXXXXXXXXXXXXXXXXXXXXXXXXXXXXXXXXXXXXXXXXXXXXXXXXXXXXXXXXXXXXXXXXXXXXXXXXXXXXXXXXXXXXXXXXXXXXXXXXXXXXXXXXXXXXXXXXXXXXXXXXXXXX

