--------------------------------------------------------------------------------------------------------------------------------------------------------------------------------------------------------
--------------------------------------------------------------------------------------------------------------------------------------------------------------------------------------------------------
--------------------------------------------------------------------------------------------------------------------------------------------------------------------------------------------------------
--------------------------------------------------------------------------------------------------------------------------------------------------------------------------------------------------------
--------------------------------------------------------------------------------------------------------------------------------------------------------------------------------------------------------
--------------------------------------------------------------------------------------------------------------------------------------------------------------------------------------------------------
--------------------------------------------------------------------------------------------------------------------------------------------------------------------------------------------------------
--------------------------------------------------------------------------------------------------------------------------------------------------------------------------------------------------------
--------------------------------------------------------------------------------------------------------------------------------------------------------------------------------------------------------
--------------------------------------------------------------------------------------------------------------------------------------------------------------------------------------------------------
--------------------------------------------------------------------------------------------------------------------------------------------------------------------------------------------------------
--------------------------------------------------------------------------------------------------------------------------------------------------------------------------------------------------------
-------------------------------------------------------------------------------------------------------ooSo-----------------------------------------------ooS----------------ooooo----------------------
-------------------------oooSo--------------------------------------------------------------------------------------------------------oooo-------SoS------------oSSo------------------------------------
------------------------------------oSSS------oo-------------------------------oooo---------------------oo------------oooo------------------------------oooo-----------------ooo------------------------
---------------G-----------ooo------------------kyy---ooo------------------------------------------------k-------------k-r--y---------oooo-------------rr-G-----ooo----------r--------------------------
--------------XXXXXX-----yy--rY--oooooo----XXXXXXXXX---------XXXXXXXX-ooo-----------------XXXXX-------XXXXXX-g--r-R-XXXXXXXXXXXXXXX-y--------------Gr-XXXXXXXXX---K-k-------XXXXXXX----XXXX---XX-ooo----
XXXXXXXXXXXXXXXXXXXX----XXXXXXXX-K---r-K-y-XXXXXXXXX---oo----XXXXXXXX--k--------ky--XXXXXXXXXXXXX-----XXXXXXXXXXXXXXXXXXXXXXXXXXXXXXXXXXXXXXX--XXXXXXXXXXXXXXXXXXXXXXX------XXXXXXX----XXXX---XX-r-----X
XXXXXXXXXXXXXXXXXXXX----XXXXXXXXXXXXXXXXXXXXXXXXXXXX-k--ry---XXXXXXXXXXXXXXXXXXXXXXXXXXXXXXXXXXXX-----XXXXXXXXXXXXXXXXXXXXXXXXXXXXXXXXXXXXXXX--XXXXXXXXXXXXXXXXXXXXXXX---kr-XXXXXXXXXXXXXXXXXXXXXXXXXXXX
XXXXXXXXXXXXXXXXXXXXXXXXXXXXXXXXXXXXXXXXXXXXXXXXXXXXXXXXXXXXXXXXXXXXXXXXXXXXXXXXXXXXXXXXXXXXXXXXXXXXXXXXXXXXXXXXXXXXXXXXXXXXXXXXXXXXXXXXXXXXXXXXXXXXXXXXXXXXXXXXXXXXXXXXXXXXXXXXXXXXXXXXXXXXXXXXXXXXXXXX

