--------------------------------------------------------------------------------------------------------------------------------------------------------------------------------------------------------
--------------------------------------------------------------------------------------------------------------------------------------------------------------------------------------------------------
--------------------------------------------------------------------------------------------------------------------------------------------------------------------------------------------------------
--------------------------------------------------------------------------------------------------------------------------------------------------------------------------------------------------------
--------------------------------------------------------------------------------------------------------------------------------------------------------------------------------------------------------
--------------------------------------------------------------------------------------------------------------------------------------------------------------------------------------------------------
--------------------------------------------------------------------------------------------------------------------------------------------------------------------------------------------------------
--------------------------------------------------------------------------------------------------------------------------------------------------------------------------------------------------------
--------------------------------------------------------------------------------------------------------------------------------------------------------------------------------------------------------
--------------------------------------------------------------------------------------------------------------------------------------------------------------------------------------------------------
--------------------------------------------------------------------------------------------------------------------------------------------------------------------------------------------------------
--------------------------------------------------------------------------------------------------------------------------------------------------------------------------------------------------------
--------------------------------------------------------------------------------oSoooo---------------------------Sooo------------------------------oooo------------------oooSo--------------------------
----------------oooSo----------------------------------------------------------------------------------------------------------------------------------------Sooo---------------------------------------
-----------------------------------oooo------------------------------------------ooooo------Sooo-----------------ooo--------------------SSo------------------------------ooo----------------------------
----------------ooooo--ooooo------------------Soo-------------Y---------------r---ykk---------------------------g---g-------------------------------Gk-r-------ooo----k------k-------ooSooSo------------
-------------ky-k---y--------------ooooo------------------XXXXXX-------------XXXXXXXXXXX--oooooo----------oooo-XXXXXXXXX--oo------------ooo-------XXXXXXX-----k-g--k-XXXXXXXXXX--------------------XXXXX
XXXXXXXXXXXXXXXXXXXXXX--ooo----------g--r----ooo------ykk-XXXXXX-------------XXXXXXXXXXX--y-r-----------k--Y---XXXXXXXXX-----r--oo------gr--------XXXXXXX--XXXXXXXXXXXXXXXXXXXX-------oooo------oo-XXXXX
XXXXXXXXXXXXXXXXXXXXXX---------XXXXXXXXXXX-k--R-----XXXXXXXXXXXXXXXXXXX------XXXXXXXXXXXXXXXXXXXXXX----XXXXXXXXXXXXXXXXXXXXXXXX--g----XXXXXX--g---XXXXXXXXXXXXXXXXXXXXXXXXXXXXX------k--------Ykg--XXXXX
XXXXXXXXXXXXXXXXXXXXXXXXXXXXXXXXXXXXXXXXXXXXXXXXXXXXXXXXXXXXXXXXXXXXXXXXXXXXXXXXXXXXXXXXXXXXXXXXXXXXXXXXXXXXXXXXXXXXXXXXXXXXXXXXXXXXXXXXXXXXXXXXXXXXXXXXXXXXXXXXXXXXXXXXXXXXXXXXXXXXXXXXXXXXXXXXXXXXXXXX

