--------------------------------------------------------------------------------------------------------------------------------------------------------------------------------------------------------
--------------------------------------------------------------------------------------------------------------------------------------------------------------------------------------------------------
--------------------------------------------------------------------------------------------------------------------------------------------------------------------------------------------------------
--------------------------------------------------------------------------------------------------------------------------------------------------------------------------------------------------------
--------------------------------------------------------------------------------------------------------------------------------------------------------------------------------------------------------
--------------------------------------------------------------------------------------------------------------------------------------------------------------------------------------------------------
--------------------------------------------------------------------------------------------------------------------------------------------------------------------------------------------------------
--------------------------------------------------------------------------------------------------------------------------------------------------------------------------------------------------------
--------------------------------------------------------------------------------------------------------------------------------------------------------------------------------------------------------
--------------------------------------------------------------------------------------------------------------------------------------------------------------------------------------------------------
--------------------------------------------------------------------------------------------------------------------------------------------------------------------------------------------------------
--------------------------------------------------------------------------------------------------------------------------------------------------------------------------------------------------------
-----------------------------------------------------------ooSo-------------oSo-----------------------------------oooooSo-------------------------------------------------------------------------------
----------------------------------------------------------------------------------------------Sooo---------------------------SoSo--------------------------------------------------------------ooSS-----
----------------------------------------------------------ooooo----------------------------------------------------oooo--------------------------------------------------Sooo---------------------------
------------------k------------------------------oooSS---G-rY--G-----------k--K----------------oooo------ooooo---------y---ooooooooo-----*---------ooooo----------oo------------------------ooooo-------
XXXXXXXXXXXXXX--XXXXXX-------------------oo-------------XXXXXXXXX-----XXXXXXXXXX-R--G----XX--r----R--------------XXXXXXXXX---r-----G-----*-----*----rG-----------rgkY-----oooo---------------kk--g-G----
XXXXXXXXXXXXXX--XXXXXXXXXXX--r---XX------y--Y---oooooo--XXXXXXXXX-----XXXXXXXXXXXXXXXX---XXXXXXXXXXXXX--ooooooo--XXXXXXXXXXXXXXXXXXXX----*-----*-XXXXXXXX------XXXXXXX------Kr-----oo------XXXXXXXXXX---
XXXXXXXXXXXXXXXXXXXXXXXXXXXXXXXXXXX---XXXXXXXX-y--k-y---XXXXXXXXX-----XXXXXXXXXXXXXXXX---XXXXXXXXXXXXX--------r--XXXXXXXXXXXXXXXXXXXXXX--*---*-*-XXXXXXXX--y---XXXXXXXXXXXXXXXXX-rk-g-XXXXXXXXXXXXXXXXXX
XXXXXXXXXXXXXXXXXXXXXXXXXXXXXXXXXXXXXXXXXXXXXXXXXXXXXXXXXXXXXXXXXXXXXXXXXXXXXXXXXXXXXXXXXXXXXXXXXXXXXXXXXXXXXXXXXXXXXXXXXXXXXXXXXXXXXXXXXXXXXXXXXXXXXXXXXXXXXXXXXXXXXXXXXXXXXXXXXXXXXXXXXXXXXXXXXXXXXXXX

