--------------------------------------------------------------------------------------------------------------------------------------------------------------------------------------------------------
--------------------------------------------------------------------------------------------------------------------------------------------------------------------------------------------------------
--------------------------------------------------------------------------------------------------------------------------------------------------------------------------------------------------------
--------------------------------------------------------------------------------------------------------------------------------------------------------------------------------------------------------
--------------------------------------------------------------------------------------------------------------------------------------------------------------------------------------------------------
--------------------------------------------------------------------------------------------------------------------------------------------------------------------------------------------------------
--------------------------------------------------------------------------------------------------------------------------------------------------------------------------------------------------------
--------------------------------------------------------------------------------------------------------------------------------------------------------------------------------------------------------
--------------------------------------------------------------------------------------------------------------------------------------------------------------------------------------------------------
--------------------------------------------------------------------------------------------------------------------------------------------------------------------------------------------------------
--------------------------------------------------------------------------------------------------------------------------------------------------------------------------------------------------------
--------------------------------------------------------------------------------------------------------------------------------------------------------------------------------------------------------
-------------------------------------------------------------------------------------------------------------------oSo----------------------------------------------------------ooS---------------------
-----------ooSoSSS------SooSoo--------------------------------------------------------------------------------------------------------------------------------------------------------------------------
------------------------------------------oo--------------------------------------------------oSSo--------------ooooooooo-----------oSSo----------------------------------------------------------------
--------------oooo----oooooo-----oSSoo----kky-----------oSoo-------------------ooS-----ooo-----------oooo-------g-y-yGR-----------------------------------------SSoooSo---------y-k---------------ooo---
----------------------g-K----K---------XXXXXXXXX--------------------------XXX----------krg---ooo---------------XXXXXXXXXXXXXX----------ooo--oooooo------oooo----------------XXXXXXXXX-------------kgg---
----------XXXXXXXXXXXXXXXXXXXXX---ooo--XXXXXXXXX-------oooo--------XX-----XXX-ooooo---XXXXXX---kg----------XXXXXXXXXXXXXXXXXX-------y-g-----G-----------------ooooooo-------XXXXXXXXX------------XXXXXXX
----------XXXXXXXXXXXXXXXXXXXXX-r--g---XXXXXXXXX------G---G-k-XXXXXXXXXXXXXXX--R------XXXXXXXXXXXXXX--y----XXXXXXXXXXXXXXXXXX--gr--XXXXXXXXXXXXXXXXXXXXXXXXXX-g-r--y--g-----XXXXXXXXX------------XXXXXXX
XXXXXXXXXXXXXXXXXXXXXXXXXXXXXXXXXXXXXXXXXXXXXXXXXXXXXXXXXXXXXXXXXXXXXXXXXXXXXXXXXXXXXXXXXXXXXXXXXXXXXXXXXXXXXXXXXXXXXXXXXXXXXXXXXXXXXXXXXXXXXXXXXXXXXXXXXXXXXXXXXXXXXXXXXXXXXXXXXXXXXXXXXXXXXXXXXXXXXXXX

