--------------------------------------------------------------------------------------------------------------------------------------------------------------------------------------------------------
--------------------------------------------------------------------------------------------------------------------------------------------------------------------------------------------------------
--------------------------------------------------------------------------------------------------------------------------------------------------------------------------------------------------------
--------------------------------------------------------------------------------------------------------------------------------------------------------------------------------------------------------
--------------------------------------------------------------------------------------------------------------------------------------------------------------------------------------------------------
--------------------------------------------------------------------------------------------------------------------------------------------------------------------------------------------------------
--------------------------------------------------------------------------------------------------------------------------------------------------------------------------------------------------------
--------------------------------------------------------------------------------------------------------------------------------------------------------------------------------------------------------
--------------------------------------------------------------------------------------------------------------------------------------------------------------------------------------------------------
--------------------------------------------------------------------------------------------------------------------------------------------------------------------------------------------------------
--------------------------------------------------------------------------------------------------------------------------------------------------------------------------------------------------------
--------------------------------------------------------------------------------------------------------------------------------------------------------------------------------------------------------
----------------------Soooo-------------------------------------------------------------------------------------------------------------------------------------------------oSSSSooo--------------------
----------------------------------------------------------------Soo------------------------ooo-----------------ooooSo-----------------------------------------------------------------------------------
--------------oo----oooooooo------------------------------------------------------------------------------------------------oooS--------------------ooo---ooo-----------------ooooooo--ooSoooo----------
--------------y-----------K-------------------------oSooo--------oo------------------------oo---------------------oooooo-------------yY------------------R-k------oooSoS-----r----k---------------------
------------XXXXXXXXXXXXXXXXX------------------------------------y--y--------------oooo-XX-yky--------XXXXX-------R-gr-G--oooooo---XXXXXXXX-------ooooo-XXXXXX-------------XXXXXXXXXXX----oooo-------K--
XXXXXXXXXXXXXXXXXXXXXXXXXXXXX----XXXXXXX--XXXX------oooooo-XXXXXXXXXXXX------XXXXX-g--Y-XXXXXXXX------XXXXX---XXXXXXXXXXX---R----k-XXXXXXXX-oo----------XXXXXX-------ooooo-XXXXXXXXXXX-r-g---g-XXXXXXXXX
XXXXXXXXXXXXXXXXXXXXXXXXXXXXX----XXXXXXXXXXXXXXXX----y---r-XXXXXXXXXXXXXXXXXXXXXXXXXXXXXXXXXXXXXXXXXXXXXXXX---XXXXXXXXXXXXXXXXXXXXXXXXXXXXX-g--R-XXXXXXXXXXXXXXXX--r--K----XXXXXXXXXXXXXXXXXXXXXXXXXXXXX
XXXXXXXXXXXXXXXXXXXXXXXXXXXXXXXXXXXXXXXXXXXXXXXXXXXXXXXXXXXXXXXXXXXXXXXXXXXXXXXXXXXXXXXXXXXXXXXXXXXXXXXXXXXXXXXXXXXXXXXXXXXXXXXXXXXXXXXXXXXXXXXXXXXXXXXXXXXXXXXXXXXXXXXXXXXXXXXXXXXXXXXXXXXXXXXXXXXXXXXX

