--------------------------------------------------------------------------------------------------------------------------------------------------------------------------------------------------------
--------------------------------------------------------------------------------------------------------------------------------------------------------------------------------------------------------
--------------------------------------------------------------------------------------------------------------------------------------------------------------------------------------------------------
--------------------------------------------------------------------------------------------------------------------------------------------------------------------------------------------------------
--------------------------------------------------------------------------------------------------------------------------------------------------------------------------------------------------------
--------------------------------------------------------------------------------------------------------------------------------------------------------------------------------------------------------
--------------------------------------------------------------------------------------------------------------------------------------------------------------------------------------------------------
--------------------------------------------------------------------------------------------------------------------------------------------------------------------------------------------------------
--------------------------------------------------------------------------------------------------------------------------------------------------------------------------------------------------------
--------------------------------------------------------------------------------------------------------------------------------------------------------------------------------------------------------
--------------------------------------------------------------------------------------------------------------------------------------------------------------------------------------------------------
--------------------------------------------------------------------------------------------------------------------------------------------------------------------------------------------------------
--------------------------------------------------------------------------------------------------------------------------------------------------------------------------ooSSSo------------------------
-------------------------------------------------------------------------------SSS-------------------------------------------oSooo--------oooooooSo-----------------------------------------------------
---------------------------------------------------------------------------------------------------------ooo--------------------------------------------------------------ooooo----------ooooo----------
-----------------------------------SSo----ooSoo-----oo-----------------------ooooooo-----------------------------ooSoSSSo-----oo----------ooooooooo----ooo----oo---------rY-gk--------------------------
-----------------------XXXXX-----------XX-------------g-XXXXX--------------------g----oooooo-------------oooo--------------r--yr-k-XX--------kk---G----------------XXXXXXXXXXXXXXX----Y-----oo----------
XXXXXXXXXXXXXX---------XXXXXXXXXX------XX---oooo-XXXXXXXXXXXX-----XXXX------XXXXXXXXX-y----g--------------y---k----oooooo-XXXXXXXXXXX----XXXXXXXXXXX----oooo-XXXXXXXXXXXXXXXXXXXXXXXXXXX-------k--XXXXX-
XXXXXXXXXXXXXX---------XXXXXXXXXX------XX--rK--k-XXXXXXXXXXXX-----XXXX----XXXXXXXXXXXXXXXXXXX--------XXXXXXXXXXX----------XXXXXXXXXXXXXXXXXXXXXXXXXX-----K-k-XXXXXXXXXXXXXXXXXXXXXXXXXXXXXXXXXXXXXXXXXX-
XXXXXXXXXXXXXXXXXXXXXXXXXXXXXXXXXXXXXXXXXXXXXXXXXXXXXXXXXXXXXXXXXXXXXXXXXXXXXXXXXXXXXXXXXXXXXXXXXXXXXXXXXXXXXXXXXXXXXXXXXXXXXXXXXXXXXXXXXXXXXXXXXXXXXXXXXXXXXXXXXXXXXXXXXXXXXXXXXXXXXXXXXXXXXXXXXXXXXXXX

