--------------------------------------------------------------------------------------------------------------------------------------------------------------------------------------------------------
--------------------------------------------------------------------------------------------------------------------------------------------------------------------------------------------------------
--------------------------------------------------------------------------------------------------------------------------------------------------------------------------------------------------------
--------------------------------------------------------------------------------------------------------------------------------------------------------------------------------------------------------
--------------------------------------------------------------------------------------------------------------------------------------------------------------------------------------------------------
--------------------------------------------------------------------------------------------------------------------------------------------------------------------------------------------------------
--------------------------------------------------------------------------------------------------------------------------------------------------------------------------------------------------------
--------------------------------------------------------------------------------------------------------------------------------------------------------------------------------------------------------
--------------------------------------------------------------------------------------------------------------------------------------------------------------------------------------------------------
--------------------------------------------------------------------------------------------------------------------------------------------------------------------------------------------------------
--------------------------------------------------------------------------------------------------------------------------------------------------------------------------------------------------------
--------------------------------------------------------------------------------------------------------------------------------------------------------------------------------------------------------
---------------SSoooo-----oSSo------oSS-----------------------------------------ooo--------------------------------------oSooS--------------------------------------------------------------------------
--------------------------------------------------------------------oooooo--------------oooo------------------------------------------------------------oSoSoooSo---------------oSo---------------------
---------------ooooo-------oooo-----------ooooo--------------------------------------------------------------------------ooo------------------ooSooo------------------------------------SoSSooo---------
--------------r-----K-----k--YKk---k----------Y-k--------------------ooooooo---ggr----oooo-----k--------------------------r--------SSS------------------oooooo--------ooooS----oooo---------------------
-------------XXXXXXXXXX--XXXXXXXXXXXXXXXXXXXXXXXXX-------------------K-K---g-XXXXXXX--y-----G-XXXXXXXXXXXXXXXX----------XXXXXXXX----------------oooooo--yy-kk-------------------k-K-------oooo----------
-------------XXXXXXXXXX--XXXXXXXXXXXXXXXXXXXXXXXXX-----------------XXXXXXXXXXXXXXXXXXXXXXXXXXXXXXXXXXXXXXXXXXX----------XXXXXXXX----oo---XX------R-y---XXXXXXXXXXXXX-oooooo---XXXXXX---g-g---KR------XXX
-------------XXXXXXXXXXXXXXXXXXXXXXXXXXXXXXXXXXXXXXXXXXX---r-------XXXXXXXXXXXXXXXXXXXXXXXXXXXXXXXXXXXXXXXXXXX----g-XXXXXXXXXXXX----rG-y-XX--XXXXXXXXXXXXXXXXXXXXXXX--------r-XXXXXX--XXXXXXXXXXX----XXX
XXXXXXXXXXXXXXXXXXXXXXXXXXXXXXXXXXXXXXXXXXXXXXXXXXXXXXXXXXXXXXXXXXXXXXXXXXXXXXXXXXXXXXXXXXXXXXXXXXXXXXXXXXXXXXXXXXXXXXXXXXXXXXXXXXXXXXXXXXXXXXXXXXXXXXXXXXXXXXXXXXXXXXXXXXXXXXXXXXXXXXXXXXXXXXXXXXXXXXXX

