--------------------------------------------------------------------------------------------------------------------------------------------------------------------------------------------------------
--------------------------------------------------------------------------------------------------------------------------------------------------------------------------------------------------------
--------------------------------------------------------------------------------------------------------------------------------------------------------------------------------------------------------
--------------------------------------------------------------------------------------------------------------------------------------------------------------------------------------------------------
--------------------------------------------------------------------------------------------------------------------------------------------------------------------------------------------------------
--------------------------------------------------------------------------------------------------------------------------------------------------------------------------------------------------------
--------------------------------------------------------------------------------------------------------------------------------------------------------------------------------------------------------
--------------------------------------------------------------------------------------------------------------------------------------------------------------------------------------------------------
--------------------------------------------------------------------------------------------------------------------------------------------------------------------------------------------------------
--------------------------------------------------------------------------------------------------------------------------------------------------------------------------------------------------------
--------------------------------------------------------------------------------------------------------------------------------------------------------------------------------------------------------
--------------------------------------------------------------------------------------------------------------------------------------------------------------------------------------------------------
---------------------------------------------------------------------------------------------------------------------------Sooooooo---------------------------------------------------------------------
---------------------------------------Soo---------------------------oSoo----------------------------------------------------------------------------------------------ooSSooo---------oSS--------------
------------------ooS-----------------------ooSSSSSS----oSoSoo-------------------------------------oo-------------oSoo----oooooo------------oooooo-------------------------------------------oo---------
-----------------------------------------------------------------------oooo------------------------kr---ooSSoSS--------------k-----------------------------SSoooSS------oooooo---------------g----------
---------------------------------XXX-----y-----oooo----ooooo---XXX----g----g------------XXXXX----XXXXXX-----------oooooo-XXXXXXXXXXXXXXXXXX--oooooo-----------------------r--r-----------y--XXXXXX----XX
------------r--R---g-k-----------XXXXXXXXXX-KgY--------k-----r-XXXXXXXXXXXXXXXX---oo----XXXXX----XXXXXX---ooooo----K-----XXXXXXXXXXXXXXXXXX----k---y------ooooooo---XXXXXXXXXXXXXXXXXXXXXXXXXXXXXX----XX
-----------XXXXXXXXXXXXXXXXXX----XXXXXXXXXXXXXXXXXXXXXXXXXXXXXXXXXXXXXXXXXXXXXX--y-Y-XXXXXXXX----XXXXXX----rK--r-XXXXXXXXXXXXXXXXXXXXXXXXXXXXXXXXXXXX------------g--XXXXXXXXXXXXXXXXXXXXXXXXXXXXXX----XX
XXXXXXXXXXXXXXXXXXXXXXXXXXXXXXXXXXXXXXXXXXXXXXXXXXXXXXXXXXXXXXXXXXXXXXXXXXXXXXXXXXXXXXXXXXXXXXXXXXXXXXXXXXXXXXXXXXXXXXXXXXXXXXXXXXXXXXXXXXXXXXXXXXXXXXXXXXXXXXXXXXXXXXXXXXXXXXXXXXXXXXXXXXXXXXXXXXXXXXXX

