--------------------------------------------------------------------------------------------------------------------------------------------------------------------------------------------------------
--------------------------------------------------------------------------------------------------------------------------------------------------------------------------------------------------------
--------------------------------------------------------------------------------------------------------------------------------------------------------------------------------------------------------
--------------------------------------------------------------------------------------------------------------------------------------------------------------------------------------------------------
--------------------------------------------------------------------------------------------------------------------------------------------------------------------------------------------------------
--------------------------------------------------------------------------------------------------------------------------------------------------------------------------------------------------------
--------------------------------------------------------------------------------------------------------------------------------------------------------------------------------------------------------
--------------------------------------------------------------------------------------------------------------------------------------------------------------------------------------------------------
--------------------------------------------------------------------------------------------------------------------------------------------------------------------------------------------------------
--------------------------------------------------------------------------------------------------------------------------------------------------------------------------------------------------------
--------------------------------------------------------------------------------------------------------------------------------------------------------------------------------------------------------
--------------------------------------------------------------------------------------------------------------------------------------------------------------------------------------------------------
----------------------------------------------------------------------------------------------------------------------------------------ooSo------------------------------------------------------------
-------------------------------------------------------------------------------------------------------------------------oSSSoooo-------------------------------------oooSS---------------------ooSS----
---------------------------------------------------------------------oSooo--------oooo----------------------SoSo-----------------------oooo-----------------------------------ooooSS--------------------
----------------------------------------------ooooSo-----------------------------y-y--y-------------oo---------------------oooo--------r---K--ooooooSS-----oSo------oooooooo------------------ooooo-----
------------oooo----------------oooo------XXX-----------XXXXX--XXXXX-oooooooo---XXXXXXXXXXXX--------KkK----oooo---XXXX----K--grG-r----XXXXXXX--------------------------G-rr-----oooo------------gk-G----
XXXXXXXXXXX-----k-XXXXX---------r-g-------XXX-ooooooooo-XXXXX--XXXXX--Y---------XXXXXXXXXXXX-----XXXXXXX-k--yK----XXXXXXXXXXXXXXXXX---XXXXXXX-oooooooo---ooooo----XXXXXXXXXXX--------y-XXXXXXXXXXXXXXX--
XXXXXXXXXXXXXXXXXXXXXXXXX----XXXXXXXXXXXXXXXX--k-r-ry---XXXXX--XXXXXXXXXXXXXXXXXXXXXXXXXXXXXXXXXXXXXXXXXXXXXXXXXXXXXXXXXXXXXXXXXXXX---XXXXXXX--rk---gGr---g-kr-Rg-XXXXXXXXXXXXXXXXXXXXXXXXXXXXXXXXXXXXXX
XXXXXXXXXXXXXXXXXXXXXXXXXXXXXXXXXXXXXXXXXXXXXXXXXXXXXXXXXXXXXXXXXXXXXXXXXXXXXXXXXXXXXXXXXXXXXXXXXXXXXXXXXXXXXXXXXXXXXXXXXXXXXXXXXXXXXXXXXXXXXXXXXXXXXXXXXXXXXXXXXXXXXXXXXXXXXXXXXXXXXXXXXXXXXXXXXXXXXXXX

