--------------------------------------------------------------------------------------------------------------------------------------------------------------------------------------------------------
--------------------------------------------------------------------------------------------------------------------------------------------------------------------------------------------------------
--------------------------------------------------------------------------------------------------------------------------------------------------------------------------------------------------------
--------------------------------------------------------------------------------------------------------------------------------------------------------------------------------------------------------
--------------------------------------------------------------------------------------------------------------------------------------------------------------------------------------------------------
--------------------------------------------------------------------------------------------------------------------------------------------------------------------------------------------------------
--------------------------------------------------------------------------------------------------------------------------------------------------------------------------------------------------------
--------------------------------------------------------------------------------------------------------------------------------------------------------------------------------------------------------
--------------------------------------------------------------------------------------------------------------------------------------------------------------------------------------------------------
--------------------------------------------------------------------------------------------------------------------------------------------------------------------------------------------------------
--------------------------------------------------------------------------------------------------------------------------------------------------------------------------------------------------------
--------------------------------------------------------------------------------------------------------------------------------------------------------------------------------------------------------
------------------------------------------------------------------------------oSo-----------------------------------------------------------------------------------------------------------------------
--------------------------------------------------------SoooSoo-----------------------------------------------------------------------------------------------------------------------------------------
-----------------ooooo---------oSS---------oo---------------------------------oooo------------------ooS----------SooooSo-------------------------------------------------SSoo---------------------------
----------------------------------------r-k-R-----------ooooooo-----ooSoS---g------g-----oSooo------------------------------------------------------oo---------y----------------------------------------
-----------------oo------------oo----XXXXXXXXX----XXX-----r-k-K------------XXXXXXXXXX-------------ooooo-----------ooooo------------------------------r----XXXXXXXXXX-----ooo---oo-----------oo----------
---------------g--R----------g-------XXXXXXXXX----XXXXXXXXXXXXXX--ooooooo--XXXXXXXXXX-ooooooo----k-rr---g-------yy-K--rg---------R-------oo-------XXXXXXXXXXXXXXXXXX------r-r--------XXXX-Y--rYR-XXX----
XXXXXXXXXXXXXXXXXXXXXXXXXXXXXXXXXXXXXXXXXXXXXX----XXXXXXXXXXXXXX--K--yG--r-XXXXXXXXXX---k---Gy--XXXXXXXXXXXXXXXXXXXXXXXXXX-----XXXXXXX--r-G-y-----XXXXXXXXXXXXXXXXXXXXXXXXXXXXXXXXXXXXXXXXXXXXXXXXXX----
XXXXXXXXXXXXXXXXXXXXXXXXXXXXXXXXXXXXXXXXXXXXXXXXXXXXXXXXXXXXXXXXXXXXXXXXXXXXXXXXXXXXXXXXXXXXXXXXXXXXXXXXXXXXXXXXXXXXXXXXXXXXXXXXXXXXXXXXXXXXXXXXXXXXXXXXXXXXXXXXXXXXXXXXXXXXXXXXXXXXXXXXXXXXXXXXXXXXXXXX

