--------------------------------------------------------------------------------------------------------------------------------------------------------------------------------------------------------
--------------------------------------------------------------------------------------------------------------------------------------------------------------------------------------------------------
--------------------------------------------------------------------------------------------------------------------------------------------------------------------------------------------------------
--------------------------------------------------------------------------------------------------------------------------------------------------------------------------------------------------------
--------------------------------------------------------------------------------------------------------------------------------------------------------------------------------------------------------
--------------------------------------------------------------------------------------------------------------------------------------------------------------------------------------------------------
--------------------------------------------------------------------------------------------------------------------------------------------------------------------------------------------------------
--------------------------------------------------------------------------------------------------------------------------------------------------------------------------------------------------------
--------------------------------------------------------------------------------------------------------------------------------------------------------------------------------------------------------
--------------------------------------------------------------------------------------------------------------------------------------------------------------------------------------------------------
--------------------------------------------------------------------------------------------------------------------------------------------------------------------------------------------------------
--------------------------------------------------------------------------------------------------------------------------------------------------------------------------------------------------------
-----------------------------------------oSo-------ooSooo--------------------------------------------------------------------------------------oSSo------------------------oSo--------------------------
--------------------------------------------------------------------------------------------------------------------------------------------------------oSoSS-------------------------------------------
----------------------------------------ooooo---------oo--------------------------------------------------------------------------------------ooooo-------------------------------------------------Tt--
------------------oooooo--------------------R--------yy---y-----Soo------------oSooooS--------------------------yy--------------------------k-------G--ooooooo-----------k--Y--------------oSoo-----Tt--
XXXXXXXXXXXX---------------ooooo-------XXXXXXX----XXXXXXXXXX-----------------------------ooooo---------------XXXXXXX-----------------------XXXXXXXXXXX------------------XXXXXXXX------------------XXXXXX
XXXXXXXXXXXXXXXXX-oooooo----y------ooo-XXXXXXX----XXXXXXXXXX-------------XXXX-ooooooo-----g----k-XXXXX-ooo---XXXXXXX---------oo-----G---k--XXXXXXXXXXXXXXXXXXXXXX-------XXXXXXXXXXXXXXX---oooo----XXXXXX
XXXXXXXXXXXXXXXXX---------XXXXXXX-R----XXXXXXXXXXXXXXXXXXXXX-----k--XXXXXXXXX--k-k--k-g-XXXXXXXXXXXXXX-G-gr--XXXXXXX---XX-------kk-XXXXXXXXXXXXXXXXXXXXXXXXXXXXXX-K--yG-XXXXXXXXXXXXXXX-----GR-g--XXXXXX
XXXXXXXXXXXXXXXXXXXXXXXXXXXXXXXXXXXXXXXXXXXXXXXXXXXXXXXXXXXXXXXXXXXXXXXXXXXXXXXXXXXXXXXXXXXXXXXXXXXXXXXXXXXXXXXXXXXXXXXXXXXXXXXXXXXXXXXXXXXXXXXXXXXXXXXXXXXXXXXXXXXXXXXXXXXXXXXXXXXXXXXXXXXXXXXXXXXXXXXX

