--------------------------------------------------------------------------------------------------------------------------------------------------------------------------------------------------------
--------------------------------------------------------------------------------------------------------------------------------------------------------------------------------------------------------
--------------------------------------------------------------------------------------------------------------------------------------------------------------------------------------------------------
--------------------------------------------------------------------------------------------------------------------------------------------------------------------------------------------------------
--------------------------------------------------------------------------------------------------------------------------------------------------------------------------------------------------------
--------------------------------------------------------------------------------------------------------------------------------------------------------------------------------------------------------
--------------------------------------------------------------------------------------------------------------------------------------------------------------------------------------------------------
--------------------------------------------------------------------------------------------------------------------------------------------------------------------------------------------------------
--------------------------------------------------------------------------------------------------------------------------------------------------------------------------------------------------------
--------------------------------------------------------------------------------------------------------------------------------------------------------------------------------------------------------
--------------------------------------------------------------------------------------------------------------------------------------------------------------------------------------------------------
--------------------------------------------------------------------------------------------------------------------------------------------------------------------------------------------------------
----------------------------ooooooSo---------------------------------------------------------------------------------------------------------------------------------------------------oSoo-------------
----------------------------------------------------ooS-----------------------------------------------------oSSo-----------------------------------------------------oooS-------------------------------
---------------------------ooooooooo--ooo----------------------------------------------------------------------------------------------------------------------oSoo--------------------oo----oSoSoS-----
-------------------oSoSoo--g------------r------ooo---------------------SooSo----------oSoooooo-------------ooooooo---oSSo---------------------oooo--oooo-------------ooooo--------------y---------------
--------------------------XXXXXXXXXXXXXXXXXXX----r---------------XXXX-----------------------------oo-----------Gr----------------------------------------k-----ooo-------Y-XXXXXXX---XXXXXXX-ooooooooo--
XXXXXXXXXXXXXXXXX--ooooo--XXXXXXXXXXXXXXXXXXXXXXXXXXXXXXXXX---XXXXXXX--oooooooo-XXXXX--oooooo---YkY-------XXXXXXXXXX--oooooo-----------oo----------XXXXXXXXX-yrr--k-XXXXXXXXXXXXXX---XXXXXXX-Yk---y-----
XXXXXXXXXXXXXXXXX---------XXXXXXXXXXXXXXXXXXXXXXXXXXXXXXXXXXXXXXXXXXX--r----ry--XXXXX-r---r----XXXXXX-----XXXXXXXXXX----------kyr--XXX-k-k-----ry--XXXXXXXXXXXXXXXXXXXXXXXXXXXXXXX---XXXXXXXXXXXXXXXXXX-
XXXXXXXXXXXXXXXXXXXXXXXXXXXXXXXXXXXXXXXXXXXXXXXXXXXXXXXXXXXXXXXXXXXXXXXXXXXXXXXXXXXXXXXXXXXXXXXXXXXXXXXXXXXXXXXXXXXXXXXXXXXXXXXXXXXXXXXXXXXXXXXXXXXXXXXXXXXXXXXXXXXXXXXXXXXXXXXXXXXXXXXXXXXXXXXXXXXXXXXX

