--------------------------------------------------------------------------------------------------------------------------------------------------------------------------------------------------------
--------------------------------------------------------------------------------------------------------------------------------------------------------------------------------------------------------
--------------------------------------------------------------------------------------------------------------------------------------------------------------------------------------------------------
--------------------------------------------------------------------------------------------------------------------------------------------------------------------------------------------------------
--------------------------------------------------------------------------------------------------------------------------------------------------------------------------------------------------------
--------------------------------------------------------------------------------------------------------------------------------------------------------------------------------------------------------
--------------------------------------------------------------------------------------------------------------------------------------------------------------------------------------------------------
--------------------------------------------------------------------------------------------------------------------------------------------------------------------------------------------------------
--------------------------------------------------------------------------------------------------------------------------------------------------------------------------------------------------------
--------------------------------------------------------------------------------------------------------------------------------------------------------------------------------------------------------
--------------------------------------------------------------------------------------------------------------------------------------------------------------------------------------------------------
--------------------------------------------------------------------------------------------------------------------------------------------------------------------------------------------------------
------------------------------------ooo---ooooSo--------------------------------------------------------------------------------------------------------------------------------------------------------
---------------------------------------------------------------------------------------------ooo---------------oSo--------------------------------------------------------------------------------------
-----------oo-------SooSo-----------oooo---ooooo------------oo---------------------------------------SooSoS---------------------------------------------------------------------------------------------
-------------------------------------y--------g------------kyK--------------ooo------g-------ooooo--------------------------------oSooSo-----------------------KyR-R-----ryK-------oSSS-----------------
----------XXXXXXX--oooo----oo------XXXXXXXXXXXXXXX--oo---XXXXXX--------------------XXXXXX-y-g-r-----ooooo------Y-----------------------------------------oooo-XXXXXXXXXXXXXXXX------------XXXXXX-----XXX
----------XXXXXXX-----r------r--XXXXXXXXXXXXXXXXXX---k---XXXXXX-------XXXX----oo---XXXXXXXXXXXXXXXX---K-kr-G-XXXXXX------XXXX------ooooo-XXXXXXX-------G-kkGG-XXXXXXXXXXXXXXXX------ooooo-XXXXXXXXXXXXXX
XXXXXXXXXXXXXXXXXXXXXXXXXXXXXXXXXXXXXXXXXXXXXXXXXXXXXXXXXXXXXXX--r----XXXX-kk-K--r-XXXXXXXXXXXXXXXXXXXXXXXXXXXXXXXX------XXXX------y---y-XXXXXXX------XXXXXXXXXXXXXXXXXXXXXXXXXXXX---yr---XXXXXXXXXXXXXX
XXXXXXXXXXXXXXXXXXXXXXXXXXXXXXXXXXXXXXXXXXXXXXXXXXXXXXXXXXXXXXXXXXXXXXXXXXXXXXXXXXXXXXXXXXXXXXXXXXXXXXXXXXXXXXXXXXXXXXXXXXXXXXXXXXXXXXXXXXXXXXXXXXXXXXXXXXXXXXXXXXXXXXXXXXXXXXXXXXXXXXXXXXXXXXXXXXXXXXXX

