--------------------------------------------------------------------------------------------------------------------------------------------------------------------------------------------------------
--------------------------------------------------------------------------------------------------------------------------------------------------------------------------------------------------------
--------------------------------------------------------------------------------------------------------------------------------------------------------------------------------------------------------
--------------------------------------------------------------------------------------------------------------------------------------------------------------------------------------------------------
--------------------------------------------------------------------------------------------------------------------------------------------------------------------------------------------------------
--------------------------------------------------------------------------------------------------------------------------------------------------------------------------------------------------------
--------------------------------------------------------------------------------------------------------------------------------------------------------------------------------------------------------
--------------------------------------------------------------------------------------------------------------------------------------------------------------------------------------------------------
--------------------------------------------------------------------------------------------------------------------------------------------------------------------------------------------------------
--------------------------------------------------------------------------------------------------------------------------------------------------------------------------------------------------------
--------------------------------------------------------------------------------------------------------------------------------------------------------------------------------------------------------
--------------------------------------------------------------------------------------------------------------------------------------------------------------------------------------------------------
----------------------------------------oSoSo---------ooSooo-------------------------------------------Sooooo---------Soo-------------------------------------------------------------------------------
----------------------------------------------------------------------oooSoo--------ooo--------ooooo-----------------------------------------------------------------------------------------ooSooooo---
-----------------SSSoS------------------oooooo---------oo--------oo--------------------------------------oooo--------ooooo--ooS-----SoSoo-------------------------------------------SooSoo--------------
------------------------------oSoSoo----g---k---------r-------g-------oooo---------------------oooo-----g-----------Y-y--g-------------------oSoooooo------oo-----------k---------------------oooo------
----------------oooooo--XXXX----------XXXXXXXXXXX----XXXXXXXXXXXXXXX--r--R-y---------Y----------k----XXXXXXXXX--XXXXXXXXXXX-oo------ooooooo-----------------y---------XXXXXXXXXXX--oooo---------Rr-G----
--------------gG--r--K--XXXX-ooooo----XXXXXXXXXXX----XXXXXXXXXXXXXXXXXXXXXXXXXXX--XXXXXX---XXXXXXXXXXXXXXXXXXX--XXXXXXXXXXX-gY-----y------Y--oooooo-----XXXXXX--------XXXXXXXXXXX---r------XXXXXXXXXXX--
XXXXXXXXXXXXXXXXXXXXXXXXXXXX--K--k--g-XXXXXXXXXXX----XXXXXXXXXXXXXXXXXXXXXXXXXXX--XXXXXX---XXXXXXXXXXXXXXXXXXX--XXXXXXXXXXXXXXXXXXXXXXXXXXXX-yR----r----XXXXXXXX-r----XXXXXXXXXXXXXXXXXXXXXXXXXXXXXXXX--
XXXXXXXXXXXXXXXXXXXXXXXXXXXXXXXXXXXXXXXXXXXXXXXXXXXXXXXXXXXXXXXXXXXXXXXXXXXXXXXXXXXXXXXXXXXXXXXXXXXXXXXXXXXXXXXXXXXXXXXXXXXXXXXXXXXXXXXXXXXXXXXXXXXXXXXXXXXXXXXXXXXXXXXXXXXXXXXXXXXXXXXXXXXXXXXXXXXXXXXX

