--------------------------------------------------------------------------------------------------------------------------------------------------------------------------------------------------------
--------------------------------------------------------------------------------------------------------------------------------------------------------------------------------------------------------
--------------------------------------------------------------------------------------------------------------------------------------------------------------------------------------------------------
--------------------------------------------------------------------------------------------------------------------------------------------------------------------------------------------------------
--------------------------------------------------------------------------------------------------------------------------------------------------------------------------------------------------------
--------------------------------------------------------------------------------------------------------------------------------------------------------------------------------------------------------
--------------------------------------------------------------------------------------------------------------------------------------------------------------------------------------------------------
--------------------------------------------------------------------------------------------------------------------------------------------------------------------------------------------------------
--------------------------------------------------------------------------------------------------------------------------------------------------------------------------------------------------------
--------------------------------------------------------------------------------------------------------------------------------------------------------------------------------------------------------
--------------------------------------------------------------------------------------------------------------------------------------------------------------------------------------------------------
--------------------------------------------------------------------------------------------------------------------------------------------------------------------------------------------------------
--------------------------------------------------------------------------------------------------------------------------------------------------------------------------------------------------------
--------------------------------------------------------------------------------------------------------------------------------------------------------------------------------------------------------
---------------------------SoooS-----------------------oooo----ooo-----------------------------------------oSo-----------------------------------------------oooo---------------------------------------
----------------g----------------------------oooooooo-----r----R--GK---oooooo--------oooo-----kk--------------------------oSooo----------------------oSoo---------------oSooo----ooooo-------------oo---
-------------XXXXXX--------oooooo---------------------XXXXXXXXXXXXXXX---ykGYy---------------XXXXXX---g------oo-XXXXXXXXXX---------XXXXX----------------------------XX------------Ry---gr-----------Y--XX
-------------XXXXXX-GK-K----y------XXXXXXXXX----oooo--XXXXXXXXXXXXXXXXXXXXXXXXX-------------XXXXXXXXXXXXX----K-XXXXXXXXXX---oooo--XXXXX--oooo--------ooo------Y-R--XX----oooo---XXXXXXXXX------XXXXXXXXX
-------------XXXXXXXXXXXXXXXXXXXXXXXXXXXXXXX-Rky--y---XXXXXXXXXXXXXXXXXXXXXXXXX-----------XXXXXXXXXXXXXXXXXXXXXXXXXXXXXXX------r--XXXXX--Yk-y-XXXXXX---G-G-XXXXXXXXXX--k--------XXXXXXXXX------XXXXXXXXX
XXXXXXXXXXXXXXXXXXXXXXXXXXXXXXXXXXXXXXXXXXXXXXXXXXXXXXXXXXXXXXXXXXXXXXXXXXXXXXXXXXXXXXXXXXXXXXXXXXXXXXXXXXXXXXXXXXXXXXXXXXXXXXXXXXXXXXXXXXXXXXXXXXXXXXXXXXXXXXXXXXXXXXXXXXXXXXXXXXXXXXXXXXXXXXXXXXXXXXXX

