--------------------------------------------------------------------------------------------------------------------------------------------------------------------------------------------------------
--------------------------------------------------------------------------------------------------------------------------------------------------------------------------------------------------------
--------------------------------------------------------------------------------------------------------------------------------------------------------------------------------------------------------
--------------------------------------------------------------------------------------------------------------------------------------------------------------------------------------------------------
--------------------------------------------------------------------------------------------------------------------------------------------------------------------------------------------------------
--------------------------------------------------------------------------------------------------------------------------------------------------------------------------------------------------------
--------------------------------------------------------------------------------------------------------------------------------------------------------------------------------------------------------
--------------------------------------------------------------------------------------------------------------------------------------------------------------------------------------------------------
--------------------------------------------------------------------------------------------------------------------------------------------------------------------------------------------------------
--------------------------------------------------------------------------------------------------------------------------------------------------------------------------------------------------------
--------------------------------------------------------------------------------------------------------------------------------------------------------------------------------------------------------
--------------------------------------------------------------------------------------------------------------------------------------------------------------------------------------------------------
-----------------------------------oooSSo---------------------------------------------------------------------------------------------------------------------------------------------------------------
--------------------------------------------------------------------oSooS----ooooo-------------oooo----------------------------------------------------ooSo------------oSSSoS---------------------------
-------------oSoooo----------------oooooo-----ooooo----------------------------------------------------------------------------ooooo------oooo----------------------------------------------------------
-----------------------------------g-Ykg----ky---yr-------------------oo-----ooooo-----------ooooo-----------------oo---------------k------------------ooooo--------------ooo---------------------------
------------oooooo----------------XXXXXXXXXXXXXXXXXX---------ooo----R----y---y----------XXXX-----yg--XXXX----------Y----------XXXXXXXX---ooooo---XXXXX-kY--------------g-----krg------------XXX------XXX
--------------Krk---XXXX-oo----XXXXXXXXXXXXXXXXXXXXX-----------g---XXXXXXXXXXXXXXXX-----XXXXXXXXXXXXXXXXX--oo--XXXXXXXX-------XXXXXXXX-----k-----XXXXXXXXXXXX---------XXXXXXXXXXXXXXXX------XXX---Y--XXX
-----------XXXXXXXXXXXXX--gg---XXXXXXXXXXXXXXXXXXXXXXXXXXXXXXXXXXXXXXXXXXXXXXXXXXXX-----XXXXXXXXXXXXXXXXX--y-r-XXXXXXXXXXXXXXXXXXXXXXXXXXXXXXXXXXXXXXXXXXXXXX---g-----XXXXXXXXXXXXXXXXXXXXXXXXXXXXXXXXXX
XXXXXXXXXXXXXXXXXXXXXXXXXXXXXXXXXXXXXXXXXXXXXXXXXXXXXXXXXXXXXXXXXXXXXXXXXXXXXXXXXXXXXXXXXXXXXXXXXXXXXXXXXXXXXXXXXXXXXXXXXXXXXXXXXXXXXXXXXXXXXXXXXXXXXXXXXXXXXXXXXXXXXXXXXXXXXXXXXXXXXXXXXXXXXXXXXXXXXXXX

