--------------------------------------------------------------------------------------------------------------------------------------------------------------------------------------------------------
--------------------------------------------------------------------------------------------------------------------------------------------------------------------------------------------------------
--------------------------------------------------------------------------------------------------------------------------------------------------------------------------------------------------------
--------------------------------------------------------------------------------------------------------------------------------------------------------------------------------------------------------
--------------------------------------------------------------------------------------------------------------------------------------------------------------------------------------------------------
--------------------------------------------------------------------------------------------------------------------------------------------------------------------------------------------------------
--------------------------------------------------------------------------------------------------------------------------------------------------------------------------------------------------------
--------------------------------------------------------------------------------------------------------------------------------------------------------------------------------------------------------
--------------------------------------------------------------------------------------------------------------------------------------------------------------------------------------------------------
--------------------------------------------------------------------------------------------------------------------------------------------------------------------------------------------------------
--------------------------------------------------------------------------------------------------------------------------------------------------------------------------------------------------------
--------------------------------------------------------------------------------------------------------------------------------------------------------------------------------------------------------
---------------------------------------------------------------------------------------------------------------------------------------------------------------------------------------------oSoSoo-----
---------------oooooSoo-----------------------------------------------------------------------------------------X---X--------ooo---------ooSoo------------------------------------oSSoS-----------------
-----------------------------------------------------------------oo----oSoooo---oo-----------------------------XX---XX----------------------------oSSo-------ooSooooo-----------------------ooooooo-----
---------------oooooo---------------------ooSoo------------------Krkk-----------------------------------------XXX---XXX-----ooo-------------------------------------------ooo--oooooooo----G-rry--------
--------------y---K-K---XX----XXXXXX----------------------------XXXXXX---ooo--XXXXXXXX-------------------y--XXXXX---XXXXX-------------XX--r------oooooo--------ooo----------------rRRY---XXXXXXXXXXX----
XXXXXXXXXXXXXXXXXXXXXXXXXXXXXXXXXXXX------oooooo----------oo----XXXXXX---y----XXXXXXXX----------------XXXXXXXXXXX---XXXXXXXXXXXXXXXXXXXXXXXXXXX---y---K--XX-----k--------ooo--XXXXXXXXXXXXXXXXXXXXXX----
XXXXXXXXXXXXXXXXXXXXXXXXXXXXXXXXXXXXXXXX----y------XXXXX--krr---XXXXXXXXXXXXXXXXXXXXXXXXXXXX-----XXXXXXXXXXXXXXXX---XXXXXXXXXXXXXXXXXXXXXXXXXXXXXXXXXXXXXXXXXXXXXXXXXX--Y-----XXXXXXXXXXXXXXXXXXXXXXXXXX
XXXXXXXXXXXXXXXXXXXXXXXXXXXXXXXXXXXXXXXXXXXXXXXXXXXXXXXXXXXXXXXXXXXXXXXXXXXXXXXXXXXXXXXXXXXXXXXXXXXXXXXXXXXXXXXXX---XXXXXXXXXXXXXXXXXXXXXXXXXXXXXXXXXXXXXXXXXXXXXXXXXXXXXXXXXXXXXXXXXXXXXXXXXXXXXXXXXXXX

