--------------------------------------------------------------------------------------------------------------------------------------------------------------------------------------------------------
--------------------------------------------------------------------------------------------------------------------------------------------------------------------------------------------------------
--------------------------------------------------------------------------------------------------------------------------------------------------------------------------------------------------------
--------------------------------------------------------------------------------------------------------------------------------------------------------------------------------------------------------
--------------------------------------------------------------------------------------------------------------------------------------------------------------------------------------------------------
--------------------------------------------------------------------------------------------------------------------------------------------------------------------------------------------------------
--------------------------------------------------------------------------------------------------------------------------------------------------------------------------------------------------------
--------------------------------------------------------------------------------------------------------------------------------------------------------------------------------------------------------
--------------------------------------------------------------------------------------------------------------------------------------------------------------------------------------------------------
--------------------------------------------------------------------------------------------------------------------------------------------------------------------------------------------------------
--------------------------------------------------------------------------------------------------------------------------------------------------------------------------------------------------------
--------------------------------------------------------------------------------------------------------------------------------------------------------------------------------------------------------
----------------------------------------------------------------------------------------------------------------------ooo-------------------------------------------------------------------------------
-----------------------------------------------------------oSoSo----------------------------ooooSSo-----------------------------------------------------------------------------------------------------
--------------------------------------------------------------------------------------SSo------------------ooSSoo------ooo----------oSSoo-----------ooooooo---------------------------------------------
------------ooooo------------------------------------------oooo---------------kr-------------oooooo------------------r---y----------------------------------------------------oo------------------------
------------Yy-r-G------------------------XX----------------------XX--------XXXXXX----ooo-----kK--gK-XXX-ooooooo---XXXXXXXX---------oooooo---------oooooooo---ooooo--------XX--------------------k------
-----------XXXXXXXXX---------------oooo---XX-ooo---ooooo--XXXXXXXXXXXXXXX---XXXXXX--Yrg---XXXXXXXXXXXXXX-rg--------XXXXXXXX-------G-----kR--oooo------g-rkYg--g----gg------XXXXXXXX-------XXXXXXXXXXX---
-----------XXXXXXXXXXXXXXXXXXXXXX-----y-y-XX------------y-XXXXXXXXXXXXXXX---XXXXXXXXXXXXXXXXXXXXXXXXXXXXXXXXXXXXXXXXXXXXXXXXXXXXXXXXXXXXXXX-r---y-XXXXXXXXXXXXXXXXXXXXXXX--XXXXXXXX---G---XXXXXXXXXXX---
XXXXXXXXXXXXXXXXXXXXXXXXXXXXXXXXXXXXXXXXXXXXXXXXXXXXXXXXXXXXXXXXXXXXXXXXXXXXXXXXXXXXXXXXXXXXXXXXXXXXXXXXXXXXXXXXXXXXXXXXXXXXXXXXXXXXXXXXXXXXXXXXXXXXXXXXXXXXXXXXXXXXXXXXXXXXXXXXXXXXXXXXXXXXXXXXXXXXXXXX

