--------------------------------------------------------------------------------------------------------------------------------------------------------------------------------------------------------
--------------------------------------------------------------------------------------------------------------------------------------------------------------------------------------------------------
--------------------------------------------------------------------------------------------------------------------------------------------------------------------------------------------------------
--------------------------------------------------------------------------------------------------------------------------------------------------------------------------------------------------------
--------------------------------------------------------------------------------------------------------------------------------------------------------------------------------------------------------
--------------------------------------------------------------------------------------------------------------------------------------------------------------------------------------------------------
--------------------------------------------------------------------------------------------------------------------------------------------------------------------------------------------------------
--------------------------------------------------------------------------------------------------------------------------------------------------------------------------------------------------------
--------------------------------------------------------------------------------------------------------------------------------------------------------------------------------------------------------
--------------------------------------------------------------------------------------------------------------------------------------------------------------------------------------------------------
--------------------------------------------------------------------------------------------------------------------------------------------------------------------------------------------------------
--------------------------------------------------------------------------------------------------------------------------------------------------------------------------------------------------------
--------------------------------ooS---------------------------------------------------------------ooo---------------------------------------------------------------------------------------------------
----------------oSS------ooo------------------------------------------------------------------------------------SooSo---------------------------oSoSSoSoo-----------oSSoo-------------------------------
--------------------------------oo----------------------------Sooooo------------------------------oo------------------------ooooo---------------------------------------------------------oooo----------
----------------oo------oooo----------ooooo--------oooooo------------------SSSo---------ooo---------rg----------oooo----------------------oooo----oooo-------------ooooooooo-------oooS-----------------
------------------r-----Gr---Y-XXXXXX-------------------------ooooo--------------------gg--------XXXXXXX--XXXX--RR--k-----ooooooo-------k--yK--------y-k--XXXXXXXX--rggGy-g-----XX----------ooo---------
XXXXXXXXXXXXXXXXXXXXXXXXXXXXXXXXXXXXX---ooo----------oooooo----Gkyr-r-----oooo--------XXXXXXXXXXXXXXXXXX--XXXXXXXXXXXXX-------K-Y------XXXXXXXXXXXXXXXXXXXXXXXXXXXXXXXXXXXXXX---XX--oo---------------yg-
XXXXXXXXXXXXXXXXXXXXXXXXXXXXXXXXXXXXX-----------------K-G---XXXXXXXXXXX-r----y---R--r-XXXXXXXXXXXXXXXXXXXXXXXXXXXXXXXXXXXXXXXXXXXXXXXXXXXXXXXXXXXXXXXXXXXXXXXXXXXXXXXXXXXXXXX---XX-------XXXXXXXXXXXXXXX
XXXXXXXXXXXXXXXXXXXXXXXXXXXXXXXXXXXXXXXXXXXXXXXXXXXXXXXXXXXXXXXXXXXXXXXXXXXXXXXXXXXXXXXXXXXXXXXXXXXXXXXXXXXXXXXXXXXXXXXXXXXXXXXXXXXXXXXXXXXXXXXXXXXXXXXXXXXXXXXXXXXXXXXXXXXXXXXXXXXXXXXXXXXXXXXXXXXXXXXX

