--------------------------------------------------------------------------------------------------------------------------------------------------------------------------------------------------------
--------------------------------------------------------------------------------------------------------------------------------------------------------------------------------------------------------
--------------------------------------------------------------------------------------------------------------------------------------------------------------------------------------------------------
--------------------------------------------------------------------------------------------------------------------------------------------------------------------------------------------------------
--------------------------------------------------------------------------------------------------------------------------------------------------------------------------------------------------------
--------------------------------------------------------------------------------------------------------------------------------------------------------------------------------------------------------
--------------------------------------------------------------------------------------------------------------------------------------------------------------------------------------------------------
--------------------------------------------------------------------------------------------------------------------------------------------------------------------------------------------------------
--------------------------------------------------------------------------------------------------------------------------------------------------------------------------------------------------------
--------------------------------------------------------------------------------------------------------------------------------------------------------------------------------------------------------
--------------------------------------------------------------------------------------------------------------------------------------------------------------------------------------------------------
--------------------------------------------------------------------------------------------------------------------------------------------------------------------------------------------------------
----------------oooo-------------------------oSS----ooooo------------------------------------------------------------oooSo------------------------------------------------------------------------------
---------------------------------------------------------------------------ooo---------------ooo-----------------------------------------ooooo-------------------------------------------ooS----oooo----
----------------ooooo-------oSSSo---------oooooo---oooooo--------------------------------------------------------------oo-----------------------------------oSSooSo-------oooS--------------------------
----------------g---Gr-------------oooo----gK--------r-----------oSoo------oo--------------oooooooo----------oSoSo-----yg-----------------oo-------------------------------------------oooo--------oooo-
-----------XXXXXXXXXXXXX----oo-------k---XXXXXXXXXXXXXXXXXXXX--------------Y-Y---------------gr-----XX-------------XXXXXXXXXXXXXXXXX----rk-Yy------y---------oooooo--------------------y---r-----y------
XXXXXXXXXXXXXXXXXXXXXXXX--gR-r----XXXXXXXXXXXXXXXXXXXXXXXXXXX----ooo----XXXXXXXXXXXX-g-Yg-XXXXXXXXXXXX-yg-r--------XXXXXXXXXXXXXXXXXXXXXXXXXXXXXXXXXX-----rrk--g----XXXX-----R-------XXXXXXXXXXXXXXXXXXX
XXXXXXXXXXXXXXXXXXXXXXXXXXXXXXXXXXXXXXXXXXXXXXXXXXXXXXXXXXXXX---G--RY-K-XXXXXXXXXXXXXXXXXXXXXXXXXXXXXXXXXXXX----yk-XXXXXXXXXXXXXXXXXXXXXXXXXXXXXXXXXXXXXXXXXXXXXXXXXXXXXXXXXXXXXXXXXXXXXXXXXXXXXXXXXXXXX
XXXXXXXXXXXXXXXXXXXXXXXXXXXXXXXXXXXXXXXXXXXXXXXXXXXXXXXXXXXXXXXXXXXXXXXXXXXXXXXXXXXXXXXXXXXXXXXXXXXXXXXXXXXXXXXXXXXXXXXXXXXXXXXXXXXXXXXXXXXXXXXXXXXXXXXXXXXXXXXXXXXXXXXXXXXXXXXXXXXXXXXXXXXXXXXXXXXXXXXX

