--------------------------------------------------------------------------------------------------------------------------------------------------------------------------------------------------------
--------------------------------------------------------------------------------------------------------------------------------------------------------------------------------------------------------
--------------------------------------------------------------------------------------------------------------------------------------------------------------------------------------------------------
--------------------------------------------------------------------------------------------------------------------------------------------------------------------------------------------------------
--------------------------------------------------------------------------------------------------------------------------------------------------------------------------------------------------------
--------------------------------------------------------------------------------------------------------------------------------------------------------------------------------------------------------
--------------------------------------------------------------------------------------------------------------------------------------------------------------------------------------------------------
--------------------------------------------------------------------------------------------------------------------------------------------------------------------------------------------------------
--------------------------------------------------------------------------------------------------------------------------------------------------------------------------------------------------------
--------------------------------------------------------------------------------------------------------------------------------------------------------------------------------------------------------
--------------------------------------------------------------------------------------------------------------------------------------------------------------------------------------------------------
--------------------------------------------------------------------------------------------------------------------------------------------------------------------------------------------------------
----------------------------------------------------------------oooSoo--------------------------------oSoo----------------------------------------------------------------------------------------------
----------------------------------------------------------------------------ooo-------------------------------------------------------------------------------------------------------------------------
-----------------SSooSS------------------------------------------oooooo--------------------oSS--------oooooo------------------------oSSSo---------------------------------------------------------------
------------------------------------------------------------------g-yg---ooooooo----------------------r-G-y------------------------------------SooSoo---------------------SSo---------------------------
----------------oooooooo--------g-k-----------------------kK---XXXXXXXXX----g------XXX------oo-------XXXXXXXXX---XXXXXX--ooo--------oooooo--------------------oo-----------------------------------XXXXX
XXXXXXXXXXXXXX---K--y-g--XXXXXXXXXXX----------XX--------XXXXXXXXXXXXXXXXXXXXXXXXXXXXXX--------R------XXXXXXXXX---XXXXXX--r--k-XXXXX-R---g-y-----ooooooo---------kr------oooooo--------oooooo-------XXXXX
XXXXXXXXXXXXXXXXXXXXXXXXXXXXXXXXXXXX-gY-y-----XXXXXXXXXXXXXXXXXXXXXXXXXXXXXXXXXXXXXXXXXX--XXXXXXXXXXXXXXXXXXXXXXXXXXXXXXXXXXXXXXXXXXXXXXXXXXX----------------XXXXXXXXX-----yG---XXXXX-yYrg----XXXXXXXXXX
XXXXXXXXXXXXXXXXXXXXXXXXXXXXXXXXXXXXXXXXXXXXXXXXXXXXXXXXXXXXXXXXXXXXXXXXXXXXXXXXXXXXXXXXXXXXXXXXXXXXXXXXXXXXXXXXXXXXXXXXXXXXXXXXXXXXXXXXXXXXXXXXXXXXXXXXXXXXXXXXXXXXXXXXXXXXXXXXXXXXXXXXXXXXXXXXXXXXXXXX

