--------------------------------------------------------------------------------------------------------------------------------------------------------------------------------------------------------
--------------------------------------------------------------------------------------------------------------------------------------------------------------------------------------------------------
--------------------------------------------------------------------------------------------------------------------------------------------------------------------------------------------------------
--------------------------------------------------------------------------------------------------------------------------------------------------------------------------------------------------------
--------------------------------------------------------------------------------------------------------------------------------------------------------------------------------------------------------
--------------------------------------------------------------------------------------------------------------------------------------------------------------------------------------------------------
--------------------------------------------------------------------------------------------------------------------------------------------------------------------------------------------------------
--------------------------------------------------------------------------------------------------------------------------------------------------------------------------------------------------------
--------------------------------------------------------------------------------------------------------------------------------------------------------------------------------------------------------
--------------------------------------------------------------------------------------------------------------------------------------------------------------------------------------------------------
--------------------------------------------------------------------------------------------------------------------------------------------------------------------------------------------------------
--------------------------------------------------------------------------------------------------------------------------------------------------------------------------------------------------------
---------------------------------------------------------------------------------------------------------------------------------------------------------------------oSoSoS-----------------------------
----------------------------------------------oooSSoo---------------------------------------------------------------------------------------------------------------------------------------------------
---------------ooo-----------------------------------------------------------------oo------------------oSoo----------------------------------------------------------oooooooo---------------------------
-------------r------------SSoo--------SooS----oooooooo------------------------------r-------oooooS----------------------------------ooo----oooo-----oo-------oo--------k----R--oSoSSooo-----------------
------------XXXXXXXX---------------------------kY------------------XXXXX-------XXXXXXX----------------oooo-----------oo--------------r----------XXX-Y---------gGr--XXXXXXXXXXX----------------------XXXX
XXXXXXXXXXXXXXXXXXXX------ooooo-------ooooo--XXXXXXXXXXX-------oo--XXXXX-------XXXXXXXXXXXX---ooooo----------------grg---oooo----XXXXXXX--ooooo-XXXXXXXXXX--XXXXXXXXXXXXXXXXXX--ooooooo--XXXXXXXXXXXXXXX
XXXXXXXXXXXXXXXXXXXX------gyG--k---y---r--g--XXXXXXXXXXXXXXX-R-----XXXXXXXX----XXXXXXXXXXXX-K-g-yKk--XXXXXXXX----XXXXXXX-K-----r-XXXXXXX--KyRk--XXXXXXXXXX--XXXXXXXXXXXXXXXXXX-g----g-K--XXXXXXXXXXXXXXX
XXXXXXXXXXXXXXXXXXXXXXXXXXXXXXXXXXXXXXXXXXXXXXXXXXXXXXXXXXXXXXXXXXXXXXXXXXXXXXXXXXXXXXXXXXXXXXXXXXXXXXXXXXXXXXXXXXXXXXXXXXXXXXXXXXXXXXXXXXXXXXXXXXXXXXXXXXXXXXXXXXXXXXXXXXXXXXXXXXXXXXXXXXXXXXXXXXXXXXXX

