--------------------------------------------------------------------------------------------------------------------------------------------------------------------------------------------------------
--------------------------------------------------------------------------------------------------------------------------------------------------------------------------------------------------------
--------------------------------------------------------------------------------------------------------------------------------------------------------------------------------------------------------
--------------------------------------------------------------------------------------------------------------------------------------------------------------------------------------------------------
--------------------------------------------------------------------------------------------------------------------------------------------------------------------------------------------------------
--------------------------------------------------------------------------------------------------------------------------------------------------------------------------------------------------------
--------------------------------------------------------------------------------------------------------------------------------------------------------------------------------------------------------
--------------------------------------------------------------------------------------------------------------------------------------------------------------------------------------------------------
--------------------------------------------------------------------------------------------------------------------------------------------------------------------------------------------------------
--------------------------------------------------------------------------------------------------------------------------------------------------------------------------------------------------------
--------------------------------------------------------------------------------------------------------------------------------------------------------------------------------------------------------
--------------------------------------------------------------------------------------------------------------------------------------------------------------------------------------------------------
------------------------------------------------------------------------------------------------------------------SSo---------------------------------------oooooSo-------------------------------------
---------------------------------------------ooo------------oSSSSooo-----------------------------ooooo--------------------------------------------------------------------------------------------------
---------------------------ooo-------------------------------------------------------------------------------------oo----------------oooo----------------------ooo--------------oooSSoS-----------------
-----------oooSo----------ggkGr-------------oooo-----------ooooooo-----------------oSoo--------ooooooo-----oooo---G-yr-R--ooooSoo--------------------------------------ooo------------------------------
-------------------------XXXXXXXX-ooo---------ryr--oo-------yg-----r--------------------------------g-----------XXXXXXXXX-----------ooooo-----y-------r----XXXXXXXXXX---R-------oooooo---------------XXX
--------------------XXX--XXXXXXXX--G-----XXXXXXXXX--GY----XXXXXXXXXXX---ooooo-----ooooo-------XXXXXXXXXXX---ooo-XXXXXXXXX---ooooo--G--rKg-XXXXXX-----XXXXXXXXXXXXXXXXXXXXXXXX------------------------XXX
XXXXXXXXXX---g------XXXXXXXXXXXXXXXXXXXXXXXXXXXXXXXXXXXXXXXXXXXXXXXXX----r-r-------k----------XXXXXXXXXXX----KR-XXXXXXXXX----G----XXXXXXXXXXXXXX-----XXXXXXXXXXXXXXXXXXXXXXXX--XXXXXXXXXXXXXXXXXXXXXXXXX
XXXXXXXXXXXXXXXXXXXXXXXXXXXXXXXXXXXXXXXXXXXXXXXXXXXXXXXXXXXXXXXXXXXXXXXXXXXXXXXXXXXXXXXXXXXXXXXXXXXXXXXXXXXXXXXXXXXXXXXXXXXXXXXXXXXXXXXXXXXXXXXXXXXXXXXXXXXXXXXXXXXXXXXXXXXXXXXXXXXXXXXXXXXXXXXXXXXXXXXX

