--------------------------------------------------------------------------------------------------------------------------------------------------------------------------------------------------------
--------------------------------------------------------------------------------------------------------------------------------------------------------------------------------------------------------
--------------------------------------------------------------------------------------------------------------------------------------------------------------------------------------------------------
--------------------------------------------------------------------------------------------------------------------------------------------------------------------------------------------------------
--------------------------------------------------------------------------------------------------------------------------------------------------------------------------------------------------------
--------------------------------------------------------------------------------------------------------------------------------------------------------------------------------------------------------
--------------------------------------------------------------------------------------------------------------------------------------------------------------------------------------------------------
--------------------------------------------------------------------------------------------------------------------------------------------------------------------------------------------------------
--------------------------------------------------------------------------------------------------------------------------------------------------------------------------------------------------------
--------------------------------------------------------------------------------------------------------------------------------------------------------------------------------------------------------
--------------------------------------------------------------------------------------------------------------------------------------------------------------------------------------------------------
--------------------------------------------------------------------------------------------------------------------------------------------------------------------------------------------------------
---------------------------------SSo-----------------------------------------------oSoSS--------------------------------------------------------------------ooo-----------------------oooSSooo----------
----------------------------------------------------------------------ooSo-------------------------------------------------------------oooooo------------------------------oSooooS----------------------
-------------------------------oooo--------------------oooSo--------------------------ooo----------------oSS------------------------------------------oooo---ooooo--ooo-----------------oooooo----------
------------------oo------ooo-----R----------------------------------oooo----------K-g-------------------------------oooooo---oooooo----oooo-----------------G---k--Y--g------oooooo----g-r-r-----------
---------------g--rr-R--------XXXXXXXX---------oo------oooooo--------g----------XXXXXXXXXXXXXX---kg----ooooo------------------G--k----R---k--Y-------------XXXXXXXXXXXXXXX--rg-------XXXXXXXXXXXXXXXXX--
--------------XXXXXXXXX-------XXXXXXXXXX--------g-y---y---y--------XXXXXXXXXXXXXXXXXXXXXXXXXXXXXXXXXX-Y--k-------gy-----oo---XXXXXXXXXXXXXXXXXX------gg--k-XXXXXXXXXXXXXXXXXXXXXXXXXXXXXXXXXXXXXXXXXXXXX
--------------XXXXXXXXX-------XXXXXXXXXXXXXXXXXXXXXXXXXXXXXXXXXXXXXXXXXXXXXXXXXXXXXXXXXXXXXXXXXXXXXXXXXXXXXXXXXXXXXX-y-------XXXXXXXXXXXXXXXXXX-----XXXXXXXXXXXXXXXXXXXXXXXXXXXXXXXXXXXXXXXXXXXXXXXXXXXX
XXXXXXXXXXXXXXXXXXXXXXXXXXXXXXXXXXXXXXXXXXXXXXXXXXXXXXXXXXXXXXXXXXXXXXXXXXXXXXXXXXXXXXXXXXXXXXXXXXXXXXXXXXXXXXXXXXXXXXXXXXXXXXXXXXXXXXXXXXXXXXXXXXXXXXXXXXXXXXXXXXXXXXXXXXXXXXXXXXXXXXXXXXXXXXXXXXXXXXXX

