--------------------------------------------------------------------------------------------------------------------------------------------------------------------------------------------------------
--------------------------------------------------------------------------------------------------------------------------------------------------------------------------------------------------------
--------------------------------------------------------------------------------------------------------------------------------------------------------------------------------------------------------
--------------------------------------------------------------------------------------------------------------------------------------------------------------------------------------------------------
--------------------------------------------------------------------------------------------------------------------------------------------------------------------------------------------------------
--------------------------------------------------------------------------------------------------------------------------------------------------------------------------------------------------------
--------------------------------------------------------------------------------------------------------------------------------------------------------------------------------------------------------
--------------------------------------------------------------------------------------------------------------------------------------------------------------------------------------------------------
--------------------------------------------------------------------------------------------------------------------------------------------------------------------------------------------------------
--------------------------------------------------------------------------------------------------------------------------------------------------------------------------------------------------------
--------------------------------------------------------------------------------------------------------------------------------------------------------------------------------------------------------
--------------------------------------------------------------------------------------------------------------------------------------------------------------------------------------------------------
-------------------------------------------------------------------------------------------------------------ooooSSo-----------oSo----------------------------------------------------------------------
---------------------SoSoo-----------------------------------------------oSoooSo--------------------------------------------------------------------------------------------------oSS-------------------
-------------------------------------------------Soooo--oooSo----------------------------------oSo------------ooooooo-----------oooo----------------------ooSo-----ooo---------------------oooo---------
--------------------ooooooo-----------------------------------------------ooo--------------------------oooo--Gy-----G--------gy-GGk-r-------------------------------------ooooo---ooo---------gr--------
---------------oo-------G----------ooooo---------ooooo-----ooo-----------------G--------ooooo--------Yr-----XXXXXXXXXX--oo--XXXXXXXXXX-------------oooo----ooooo-XXXXXX-------R----g-----XXXXXXXXXXXXXX-
----------------r--XXXXXXXXXXXXXX--G-k----XXXX-g----r---r----k---y---K-XXXXXXXXXX---------r------r--XXXXXXXXXXXXXXXXXX-y--y-XXXXXXXXXX--g---------rg-gk---G-r----XXXXXX--XXXXXXXXXXXXXXXXXXXXXXXXXXXXXXX
XXXXXXXXXXXXXXXXXXXXXXXXXXXXXXXXXXXXXXXXXXXXXXXXXXXXXXXXXXXXXXXXXXXXXXXXXXXXXXXXXXXXXXXXXXXXXXXXXXXXXXXXXXXXXXXXXXXXXXXXXXXXXXXXXXXXXXXXXXXXXXXXXXXXXXXXXXXXXXXXXXXXXXX--XXXXXXXXXXXXXXXXXXXXXXXXXXXXXXX
XXXXXXXXXXXXXXXXXXXXXXXXXXXXXXXXXXXXXXXXXXXXXXXXXXXXXXXXXXXXXXXXXXXXXXXXXXXXXXXXXXXXXXXXXXXXXXXXXXXXXXXXXXXXXXXXXXXXXXXXXXXXXXXXXXXXXXXXXXXXXXXXXXXXXXXXXXXXXXXXXXXXXXXXXXXXXXXXXXXXXXXXXXXXXXXXXXXXXXXX

