--------------------------------------------------------------------------------------------------------------------------------------------------------------------------------------------------------
--------------------------------------------------------------------------------------------------------------------------------------------------------------------------------------------------------
--------------------------------------------------------------------------------------------------------------------------------------------------------------------------------------------------------
--------------------------------------------------------------------------------------------------------------------------------------------------------------------------------------------------------
--------------------------------------------------------------------------------------------------------------------------------------------------------------------------------------------------------
--------------------------------------------------------------------------------------------------------------------------------------------------------------------------------------------------------
--------------------------------------------------------------------------------------------------------------------------------------------------------------------------------------------------------
--------------------------------------------------------------------------------------------------------------------------------------------------------------------------------------------------------
--------------------------------------------------------------------------------------------------------------------------------------------------------------------------------------------------------
--------------------------------------------------------------------------------------------------------------------------------------------------------------------------------------------------------
--------------------------------------------------------------------------------------------------------------------------------------------------------------------------------------------------------
--------------------------------------------------------------------------------------------------------------------------------------------------------------------------------------------------------
----------------------------------------------------------------------------------------------------------oooSo------------------------------------------------------------SoSSooo----------------------
--------------oSo---------------------------------------------------------------------------------------------------------------------------------------------------------------------------------------
---------------------------------------------oooooo-----------------Sooo----------------oooo--------------oooo-------------------oooooSSoo---------------------ooooo--------oooooo-----------------oooo-
-----------------ooo--------------------------y-------------oooo------------------------------------------k------------Soo----------------------------oSSSoo------------------g-k-----------------------
----------------k------------XXXXX--oo------XXXXXXXX----------r------oooo-------------XXXXXXXXXXXXXXX---XXXXXXXX-------------------oooooo------------------------oooooo-XXXXXXXXXXXXXXX-----XXX---XXXXXX
-------------XXXXXXXX-rKk----XXXXX--yr------XXXXXXXX------XXXXXXX------Gg-Y-XX-----XXXXXXXXXXXXXXXXXX---XXXXXXXXXXX--------XXXXX------k--------------oooooo----r--------XXXXXXXXXXXXXXX-----XXXXXXXXXXXX
XXXXXXXXXXXXXXXXXXXXXXXXXXXXXXXXXXXXXXXXXXXXXXXXXXXX-y-y--XXXXXXXXXXXXXXXXXXXX-----XXXXXXXXXXXXXXXXXXXXXXXXXXXXXXXX----r---XXXXXXXXXXXXXXXX----------grr------XXXXXXXXXXXXXXXXXXXXXXXXXXXXXXXXXXXXXXXXXX
XXXXXXXXXXXXXXXXXXXXXXXXXXXXXXXXXXXXXXXXXXXXXXXXXXXXXXXXXXXXXXXXXXXXXXXXXXXXXXXXXXXXXXXXXXXXXXXXXXXXXXXXXXXXXXXXXXXXXXXXXXXXXXXXXXXXXXXXXXXXXXXXXXXXXXXXXXXXXXXXXXXXXXXXXXXXXXXXXXXXXXXXXXXXXXXXXXXXXXXX

