--------------------------------------------------------------------------------------------------------------------------------------------------------------------------------------------------------
--------------------------------------------------------------------------------------------------------------------------------------------------------------------------------------------------------
--------------------------------------------------------------------------------------------------------------------------------------------------------------------------------------------------------
--------------------------------------------------------------------------------------------------------------------------------------------------------------------------------------------------------
--------------------------------------------------------------------------------------------------------------------------------------------------------------------------------------------------------
--------------------------------------------------------------------------------------------------------------------------------------------------------------------------------------------------------
--------------------------------------------------------------------------------------------------------------------------------------------------------------------------------------------------------
--------------------------------------------------------------------------------------------------------------------------------------------------------------------------------------------------------
--------------------------------------------------------------------------------------------------------------------------------------------------------------------------------------------------------
--------------------------------------------------------------------------------------------------------------------------------------------------------------------------------------------------------
--------------------------------------------------------------------------------------------------------------------------------------------------------------------------------------------------------
--------------------------------------------------------------------------------------------------------------------------------------------------------------------------------------------------------
---------------ooSSoS----------------------------------------Soo------------------Soo-----------------------------ooo-----------------------------------------------------ooSooo------------------------
------------------------oSooSo------------------ooS------------------------------------------------------------------------SoSoS-----------------oSoo--oooSo--------------------------------------------
---------------oooo-----------------------------------------oooo--------------------ooo---------------oooooS------ooo------------------------------------------------------ooooo------oSoo--------------
---------------r---y----oooo--------------------------------yr--Rr------------------kR-------oooo---------------Y----y----ooooo---------oooo--ooooooo---ooooo-----oSo-------yr--y----------------oooo---
XXXXXXXXXXXXXXXXXXXXXXX---yg------oo--XXXXXXXXX------------XXXXXXXX-------------XXXXXXXX-----------------oo---XXXXXXXXXX---g-k-k--------------gk--------gg--------------XXXXXXXXXX---------XXX----------
XXXXXXXXXXXXXXXXXXXXXXXXXXXXXXXX------XXXXXXXXXXXXXXX---oo-XXXXXXXXXXXXXX--XXXXXXXXXXXXX-------oooo----G------XXXXXXXXXXXXXXXXXXXXXXXXX------XXXXXXXXXXXXXXXXXXX--------XXXXXXXXXXXXX-rgg--XXX-----ooo--
XXXXXXXXXXXXXXXXXXXXXXXXXXXXXXXXXXXXXXXXXXXXXXXXXXXXX----K-XXXXXXXXXXXXXX--XXXXXXXXXXXXX-----g-------XXXXXXXXXXXXXXXXXXXXXXXXXXXXXXXXXX---Yk-XXXXXXXXXXXXXXXXXXX---rKKr-XXXXXXXXXXXXXXXXXXXXXX----------
XXXXXXXXXXXXXXXXXXXXXXXXXXXXXXXXXXXXXXXXXXXXXXXXXXXXXXXXXXXXXXXXXXXXXXXXXXXXXXXXXXXXXXXXXXXXXXXXXXXXXXXXXXXXXXXXXXXXXXXXXXXXXXXXXXXXXXXXXXXXXXXXXXXXXXXXXXXXXXXXXXXXXXXXXXXXXXXXXXXXXXXXXXXXXXXXXXXXXXXX

