--------------------------------------------------------------------------------------------------------------------------------------------------------------------------------------------------------
--------------------------------------------------------------------------------------------------------------------------------------------------------------------------------------------------------
--------------------------------------------------------------------------------------------------------------------------------------------------------------------------------------------------------
--------------------------------------------------------------------------------------------------------------------------------------------------------------------------------------------------------
--------------------------------------------------------------------------------------------------------------------------------------------------------------------------------------------------------
--------------------------------------------------------------------------------------------------------------------------------------------------------------------------------------------------------
--------------------------------------------------------------------------------------------------------------------------------------------------------------------------------------------------------
--------------------------------------------------------------------------------------------------------------------------------------------------------------------------------------------------------
--------------------------------------------------------------------------------------------------------------------------------------------------------------------------------------------------------
--------------------------------------------------------------------------------------------------------------------------------------------------------------------------------------------------------
--------------------------------------------------------------------------------------------------------------------------------------------------------------------------------------------------------
--------------------------------------------------------------------------------------------------------------------------------------------------------------------------------------------------------
--------------------------------------------------------------------oooooSS-----------------------------------------------------------------------ooooSo------------------------------------------------
---------------------------------------------------oSSooo----oSooo--------------------------ooooo----------------------------------------------------------------------oSooo--------------ooSSSo--------
-----------------------------oooSooSo----------------------------------oo-----oooo-----------------------------------------------------------------oooo-------------------------------------------------
----------------------oo---------------------------oooooo---ooo--------y------YR-------------ooooo-------------------------SoSo---------------------r--g--------------oooo-------Soooo--oooooo----------
-------------ooo-----k--------oooo---------XXXXX----k-ky-y----g-g--XXXXXXXXXXXXXXXX-----XXX-y-------XXX------------------------------ooo---------XXXXXXXX---------------gG-------------------YR---------
XXXXXXXXXX--Yg---r-XXXXXXXX------y---------XXXXXXXXXXXXXXXXXXXXXXXXXXXXXXXXXXXXXXXX-----XXXXXXXXXXXXXXX---XXX--rk---------ooooo-XXX-G------------XXXXXXXX-----XXXXXXXXXXXXXXX-ooooo----XXXXXXXXXX-oooo--
XXXXXXXXXXXXXXXXXXXXXXXXXXXXXXXXXXXXXX-----XXXXXXXXXXXXXXXXXXXXXXXXXXXXXXXXXXXXXXXXXXXXXXXXXXXXXXXXXXXXXXXXXXXXXXXXXXXX-Y--K--K-XXXXXXXXXX-------XXXXXXXXXXXXXXXXXXXXXXXXXXXX--K-r-----XXXXXXXXXX--G----
XXXXXXXXXXXXXXXXXXXXXXXXXXXXXXXXXXXXXXXXXXXXXXXXXXXXXXXXXXXXXXXXXXXXXXXXXXXXXXXXXXXXXXXXXXXXXXXXXXXXXXXXXXXXXXXXXXXXXXXXXXXXXXXXXXXXXXXXXXXXXXXXXXXXXXXXXXXXXXXXXXXXXXXXXXXXXXXXXXXXXXXXXXXXXXXXXXXXXXXX

