--------------------------------------------------------------------------------------------------------------------------------------------------------------------------------------------------------
--------------------------------------------------------------------------------------------------------------------------------------------------------------------------------------------------------
--------------------------------------------------------------------------------------------------------------------------------------------------------------------------------------------------------
--------------------------------------------------------------------------------------------------------------------------------------------------------------------------------------------------------
--------------------------------------------------------------------------------------------------------------------------------------------------------------------------------------------------------
--------------------------------------------------------------------------------------------------------------------------------------------------------------------------------------------------------
--------------------------------------------------------------------------------------------------------------------------------------------------------------------------------------------------------
--------------------------------------------------------------------------------------------------------------------------------------------------------------------------------------------------------
--------------------------------------------------------------------------------------------------------------------------------------------------------------------------------------------------------
--------------------------------------------------------------------------------------------------------------------------------------------------------------------------------------------------------
--------------------------------------------------------------------------------------------------------------------------------------------------------------------------------------------------------
--------------------------------------------------------------------------------------------------------------------------------------------------------------------------------------------------------
------------------------------------------------oooS-------------------------------------------oooooS-------------------------------------------------------------------------oSooooo-------------------
---------------------oooo------------------------------------------------------------------------------------------oSooo---------------------------------------------------------------ooS---oooSoooS---
------------------------------oooo-------------oooooo-------------------------------------------ooooo---------------------------------------------------------------------------ooo---------------------
----------------r-------------------------------k--k----------------oSSSo-----------------------K-ry------g----------oo--------------------SooSooo----------------------------yGKG--r-----------oooo----
XXXXXXXXXXXXXXXXXXX---k---XXXXXXXXX--gr-------XXXXXXXXX-Y--------------------------------oo---XXXXXXXXXXXXXXXX-----y-r----------------------------------XX-------------oooo-XXXXXXXXXX-R-Y---y-r--k-----
XXXXXXXXXXXXXXXXXXXXXXXXXXXXXXXXXXXXXXXXX-----XXXXXXXXXXXXXXXXXX----------------y---------g-g-XXXXXXXXXXXXXXXX---XXXXXXXXXXX--------y--------oooo-------XXXXXXXXXX-----Yy---XXXXXXXXXXXXXXXXXXXXXXXXXXX-
XXXXXXXXXXXXXXXXXXXXXXXXXXXXXXXXXXXXXXXXXXXXXXXXXXXXXXXXXXXXXXXX------g--k--XXXXXXXXXXXXXXXXXXXXXXXXXXXXXXXXXX---XXXXXXXXXXX----XXXXXX------r------XXXXXXXXXXXXXXX---XXXXXXXXXXXXXXXXXXXXXXXXXXXXXXXXXXX
XXXXXXXXXXXXXXXXXXXXXXXXXXXXXXXXXXXXXXXXXXXXXXXXXXXXXXXXXXXXXXXXXXXXXXXXXXXXXXXXXXXXXXXXXXXXXXXXXXXXXXXXXXXXXXXXXXXXXXXXXXXXXXXXXXXXXXXXXXXXXXXXXXXXXXXXXXXXXXXXXXXXXXXXXXXXXXXXXXXXXXXXXXXXXXXXXXXXXXXX

