--------------------------------------------------------------------------------------------------------------------------------------------------------------------------------------------------------
--------------------------------------------------------------------------------------------------------------------------------------------------------------------------------------------------------
--------------------------------------------------------------------------------------------------------------------------------------------------------------------------------------------------------
--------------------------------------------------------------------------------------------------------------------------------------------------------------------------------------------------------
--------------------------------------------------------------------------------------------------------------------------------------------------------------------------------------------------------
--------------------------------------------------------------------------------------------------------------------------------------------------------------------------------------------------------
--------------------------------------------------------------------------------------------------------------------------------------------------------------------------------------------------------
--------------------------------------------------------------------------------------------------------------------------------------------------------------------------------------------------------
--------------------------------------------------------------------------------------------------------------------------------------------------------------------------------------------------------
--------------------------------------------------------------------------------------------------------------------------------------------------------------------------------------------------------
--------------------------------------------------------------------------------------------------------------------------------------------------------------------------------------------------------
--------------------------------------------------------------------------------------------------------------------------------------------------------------------------------------------------------
--------------------------------------------------oSSooSoo------------------------------------------------------------------------------------------------------------------------------------oooSoo----
------------------------------------------------------------------------------------------------SoooSSSo--ooooSSo----oooooo-------------------------------oSoooooS--------------------------------------
-----------oSoSSoSoo-------------oSSSSS------------oooooo-----------------------------SSooooo------------------------------------Soo-------oSoo-------------------------------------oSooooo---oooo------
-------------------------ooo-----------------------g-G--K--------oo---------oSS------------------oooooo---ooooooooo----ooo---------------------------------oooooooo-----------------------------k-k-----
XXXXXXXXXX---ooooooo------R-----oooooooo--------XXXXXXXXXXX------krYKk-----------------ooo-----KR-r-G-----G------------g-------ooooo---------------------------k-ry-------------------ooooo--XXXXXXXXXXX
XXXXXXXXXX---gG----k----XXXXXXX---g--Y-Rr----K--XXXXXXXXXXX-----XXXXXXXXXXX--ooooo-------YyR--XXXXXXXXXXXXXXXXXXXXXXXXXXXXXXXX-Gk--------ky-K-r-XXXXX----XXXXXXXXXXX-----------XXX--Ryy------XXXXXXXXXXX
XXXXXXXXXXXXXXXXXXXXXXXXXXXXXXXXXXXXXXXXXXXXXXXXXXXXXXXXXXX-----XXXXXXXXXXX--------XXXXXXXXXXXXXXXXXXXXXXXXXXXXXXXXXXXXXXXXXXXXXXXXXXXXXXXXXXXXXXXXXX----XXXXXXXXXXX--------r--XXXXXXXXXXXXXXXXXXXXXXXXX
XXXXXXXXXXXXXXXXXXXXXXXXXXXXXXXXXXXXXXXXXXXXXXXXXXXXXXXXXXXXXXXXXXXXXXXXXXXXXXXXXXXXXXXXXXXXXXXXXXXXXXXXXXXXXXXXXXXXXXXXXXXXXXXXXXXXXXXXXXXXXXXXXXXXXXXXXXXXXXXXXXXXXXXXXXXXXXXXXXXXXXXXXXXXXXXXXXXXXXXX

