--------------------------------------------------------------------------------------------------------------------------------------------------------------------------------------------------------
--------------------------------------------------------------------------------------------------------------------------------------------------------------------------------------------------------
--------------------------------------------------------------------------------------------------------------------------------------------------------------------------------------------------------
--------------------------------------------------------------------------------------------------------------------------------------------------------------------------------------------------------
--------------------------------------------------------------------------------------------------------------------------------------------------------------------------------------------------------
--------------------------------------------------------------------------------------------------------------------------------------------------------------------------------------------------------
--------------------------------------------------------------------------------------------------------------------------------------------------------------------------------------------------------
--------------------------------------------------------------------------------------------------------------------------------------------------------------------------------------------------------
--------------------------------------------------------------------------------------------------------------------------------------------------------------------------------------------------------
--------------------------------------------------------------------------------------------------------------------------------------------------------------------------------------------------------
--------------------------------------------------------------------------------------------------------------------------------------------------------------------------------------------------------
--------------------------------------------------------------------------------------------------------------------------------------------------------------------------------------------------------
-------------------------------------------------------------------------------------------------oSo------------oooo-------------------oSo--------------------------------------------------------------
-----------------------------------------oooSS--------------oooSooo-------------SSSoooo-----------------------------------------------------------------------------------------------------SSSoS-------
----------------------ooo---------oSooo---------------------------------------------------------oooo----------ooooo---ooSoSoo--------oooooooo----------------------ooooSo-------------------------------
--------------------------------------------ooo--------------oooo--------------ooooo---------------rk-r------R-g-R-----------------------gg-----ooSSo----------------------------Y--r------oooooooo-----
---------------------ooo----------oo--------------XXXXXXX-k-k--rg---XXXX------Y-r-gr-g------oo-XXXXXXXXXXXXXXXXXXXXXX---oo---------XXXXXXXXXXX---------------------ooo----------XXXXXX------Yy-kY-------
XXXXXXXXXXXXX----g---r------------g-y---XXXXXXXXXXXXXXXXXXXXXXXXXXXXXXXX-----XXXXXXXXXXX-Y-r---XXXXXXXXXXXXXXXXXXXXXX-gky-----XXXXXXXXXXXXXXXX----ooo----------------kggG----oo-XXXXXX----XXXXXXXXXX----
XXXXXXXXXXXXXXXXXXXXXXXXXXX---XXXXXXXXXXXXXXXXXXXXXXXXXXXXXXXXXXXXXXXXXXXXXXXXXXXXXXXXXXXXXXXXXXXXXXXXXXXXXXXXXXXXXXXXXXXXXXXXXXXXXXXXXXXXXXXX-R----Y-r--XXXXXXXXXXXXXXXXX-G--K-XXXXXXXXXXXXXXXXXXXXXXXX
XXXXXXXXXXXXXXXXXXXXXXXXXXXXXXXXXXXXXXXXXXXXXXXXXXXXXXXXXXXXXXXXXXXXXXXXXXXXXXXXXXXXXXXXXXXXXXXXXXXXXXXXXXXXXXXXXXXXXXXXXXXXXXXXXXXXXXXXXXXXXXXXXXXXXXXXXXXXXXXXXXXXXXXXXXXXXXXXXXXXXXXXXXXXXXXXXXXXXXXX

