--------------------------------------------------------------------------------------------------------------------------------------------------------------------------------------------------------
--------------------------------------------------------------------------------------------------------------------------------------------------------------------------------------------------------
--------------------------------------------------------------------------------------------------------------------------------------------------------------------------------------------------------
--------------------------------------------------------------------------------------------------------------------------------------------------------------------------------------------------------
--------------------------------------------------------------------------------------------------------------------------------------------------------------------------------------------------------
--------------------------------------------------------------------------------------------------------------------------------------------------------------------------------------------------------
--------------------------------------------------------------------------------------------------------------------------------------------------------------------------------------------------------
--------------------------------------------------------------------------------------------------------------------------------------------------------------------------------------------------------
--------------------------------------------------------------------------------------------------------------------------------------------------------------------------------------------------------
--------------------------------------------------------------------------------------------------------------------------------------------------------------------------------------------------------
--------------------------------------------------------------------------------------------------------------------------------------------------------------------------------------------------------
--------------------------------------------------------------------------------------------------------------------------------------------------------------------------------------------------------
--------------------------------------------------------------------------------------------------------------------------------------------------------Sooooooo---------------------------SSS----------
--------------------------------------Sooo----------------------SSoS----ooooSoo----------ooSooSo------------------oSoSooo-------------------------------------------------------------------------------
-----------------------ooo---ooooo----------------------------------------------------------------------------------------------------------------------ooooooo-----------------oSoooSo----oooooo-------
--------------------------------------ooooo---------------------oooo-------ooooo---y-y---ooooooo-----oooooSo---------ooo----------------------------------k--------ooSooSo----------------g--yK---------
-----------------------ooo--XXXXXXX--G-K--G-------------ooo------yy-----Y----k----XXXXXX--rk---yy---------------------------------------XXXXXXX-------XXXXXXXXXXX--------------oooooo----XXXXXXXXX-rrgG-
XXXXXXXXXXXXXX--ooo---------XXXXXXXXXXXXXXXXXX--------------XXXXXXXXXXXXXXXXXXXXXXXXXXXXXXXXXXXXXXX----ooo-------XXXXXXXXXXX----XXXXX---XXXXXXX-K-----XXXXXXXXXXX---ooooo--XXX--y--k-----XXXXXXXXXXXXXXX
XXXXXXXXXXXXXX----Y-XXXXXXXXXXXXXXXXXXXXXXXXXX------XXXXXXXXXXXXXXXXXXXXXXXXXXXXXXXXXXXXXXXXXXXXXXX-----rg----XXXXXXXXXXXXXX----XXXXXXXXXXXXXXXXXXXXXXXXXXXXXXXXX----g-rk--XXXXXXXXXXXXXXXXXXXXXXXXXXXXX
XXXXXXXXXXXXXXXXXXXXXXXXXXXXXXXXXXXXXXXXXXXXXXXXXXXXXXXXXXXXXXXXXXXXXXXXXXXXXXXXXXXXXXXXXXXXXXXXXXXXXXXXXXXXXXXXXXXXXXXXXXXXXXXXXXXXXXXXXXXXXXXXXXXXXXXXXXXXXXXXXXXXXXXXXXXXXXXXXXXXXXXXXXXXXXXXXXXXXXXX

