--------------------------------------------------------------------------------------------------------------------------------------------------------------------------------------------------------
--------------------------------------------------------------------------------------------------------------------------------------------------------------------------------------------------------
--------------------------------------------------------------------------------------------------------------------------------------------------------------------------------------------------------
--------------------------------------------------------------------------------------------------------------------------------------------------------------------------------------------------------
--------------------------------------------------------------------------------------------------------------------------------------------------------------------------------------------------------
--------------------------------------------------------------------------------------------------------------------------------------------------------------------------------------------------------
--------------------------------------------------------------------------------------------------------------------------------------------------------------------------------------------------------
--------------------------------------------------------------------------------------------------------------------------------------------------------------------------------------------------------
--------------------------------------------------------------------------------------------------------------------------------------------------------------------------------------------------------
--------------------------------------------------------------------------------------------------------------------------------------------------------------------------------------------------------
--------------------------------------------------------------------------------------------------------------------------------------------------------------------------------------------------------
--------------------------------------------------------------------------------------------------------------------------------------------------------------------------------------------------------
-------------oSoSo----------------------------------------------------------------oooo------------------------------------------------------------------------------------------------------------------
----------------------------------oSooo-----ooo---------------------------------------------------------ooo----------------*---------------ooo-------------------ooo------oSoSSS------------------------
-------------ooo-----------------------------------------------------------------ooooo----oo-------------------------------*-------------------------------------------------------ooSo-----------------
-----------r--G---------------------oooo---oooo----oSooS--------------------------k--------yg------------oooo---------*----*--------------ooo---------------------ooooo--ooooooo------------ooo-------y-
----------XXXXXXXXX---oo----G-r--------y-------g------------------------------XXXXXXXXXXXXXXXX----XXXXX---------------*----*-------------------------------XXXX----yg-k-------krY--ooo---XX-------XXXXXX
----------XXXXXXXXX--------XXXXXXXXXXXXXXXXXXXXXX---ooo----XXXXXXXXX----------XXXXXXXXXXXXXXXXXXXXXXXXXXXXXXXX-----XXXXXXXXXXXXXXXXX-----XXXXXXX-----k-r---XXXXXXXXXXXXXXXXXXXXXXX-y--R--XX---ooo-XXXXXX
----------XXXXXXXXXXXXXXXXXXXXXXXXXXXXXXXXXXXXXXX----R-R---XXXXXXXXXXXXXXXXXXXXXXXXXXXXXXXXXXXXXXXXXXXXXXXXXXX-----XXXXXXXXXXXXXXXXXXXXXXXXXXXXX----XXXXXXXXXXXXXXXXXXXXXXXXXXXXXXXXXXXXXXX-----r-XXXXXX
XXXXXXXXXXXXXXXXXXXXXXXXXXXXXXXXXXXXXXXXXXXXXXXXXXXXXXXXXXXXXXXXXXXXXXXXXXXXXXXXXXXXXXXXXXXXXXXXXXXXXXXXXXXXXXXXXXXXXXXXXXXXXXXXXXXXXXXXXXXXXXXXXXXXXXXXXXXXXXXXXXXXXXXXXXXXXXXXXXXXXXXXXXXXXXXXXXXXXXXX

