--------------------------------------------------------------------------------------------------------------------------------------------------------------------------------------------------------
--------------------------------------------------------------------------------------------------------------------------------------------------------------------------------------------------------
--------------------------------------------------------------------------------------------------------------------------------------------------------------------------------------------------------
--------------------------------------------------------------------------------------------------------------------------------------------------------------------------------------------------------
--------------------------------------------------------------------------------------------------------------------------------------------------------------------------------------------------------
--------------------------------------------------------------------------------------------------------------------------------------------------------------------------------------------------------
--------------------------------------------------------------------------------------------------------------------------------------------------------------------------------------------------------
--------------------------------------------------------------------------------------------------------------------------------------------------------------------------------------------------------
--------------------------------------------------------------------------------------------------------------------------------------------------------------------------------------------------------
--------------------------------------------------------------------------------------------------------------------------------------------------------------------------------------------------------
--------------------------------------------------------------------------------------------------------------------------------------------------------------------------------------------------------
--------------------------------------------------------------------------------------------------------------------------------------------------------------------------------------------------------
-----------oSSooo-----------------------------------------------------------ooSooS----SoooSo--------------oSooo---------oSoo------------------------------------------------------------------Sooo------
-------------------------------------------------ooSoooS------------------------------------------------------------------------------------------------------------------------------------------------
-------------ooo-----------------------------------------------------------oooooo-----oooooo---------------oo--------oooo--------------------------------------------oooSSo-------------------ooooo-----
-----------y-rK-----------oo------------------y--oooooooo-----------------y--gg-Gk------K--r--------------r-------------gYkY-------------------------------g-r-------------------------------Y--y-K-----
XXXXXXXXXXXXXXXXXXX-------Y---------------XXXXXX-r-G--g--------XXX-------XXXXXXXXXXXXXXXXXXXXXX---------XXXXXXXXXXXXXXXXXXXXX------------XXXX-------------XXXXXXXXX---ooooo-----------------XXXXXXXXXXXX
XXXXXXXXXXXXXXXXXXX----XXXXXX------XXXXXXXXXXXXXXXXXXXXXXXX----XXX----oo-XXXXXXXXXXXXXXXXXXXXXX---------XXXXXXXXXXXXXXXXXXXXXXXXXXXXXX---XXXX-------------XXXXXXXXX--------------------XXXXXXXXXXXXXXXXX
XXXXXXXXXXXXXXXXXXX----XXXXXXXXXXXXXXXXXXXXXXXXXXXXXXXXXXXXXXXXXXX---y---XXXXXXXXXXXXXXXXXXXXXX----G-y--XXXXXXXXXXXXXXXXXXXXXXXXXXXXXX---XXXX-------------XXXXXXXXXXXXXXXXXXX-yyr---XXXXXXXXXXXXXXXXXXXX
XXXXXXXXXXXXXXXXXXXXXXXXXXXXXXXXXXXXXXXXXXXXXXXXXXXXXXXXXXXXXXXXXXXXXXXXXXXXXXXXXXXXXXXXXXXXXXXXXXXXXXXXXXXXXXXXXXXXXXXXXXXXXXXXXXXXXXXXXXXXXXXXXXXXXXXXXXXXXXXXXXXXXXXXXXXXXXXXXXXXXXXXXXXXXXXXXXXXXXXX

