--------------------------------------------------------------------------------------------------------------------------------------------------------------------------------------------------------
--------------------------------------------------------------------------------------------------------------------------------------------------------------------------------------------------------
--------------------------------------------------------------------------------------------------------------------------------------------------------------------------------------------------------
--------------------------------------------------------------------------------------------------------------------------------------------------------------------------------------------------------
--------------------------------------------------------------------------------------------------------------------------------------------------------------------------------------------------------
--------------------------------------------------------------------------------------------------------------------------------------------------------------------------------------------------------
--------------------------------------------------------------------------------------------------------------------------------------------------------------------------------------------------------
--------------------------------------------------------------------------------------------------------------------------------------------------------------------------------------------------------
--------------------------------------------------------------------------------------------------------------------------------------------------------------------------------------------------------
--------------------------------------------------------------------------------------------------------------------------------------------------------------------------------------------------------
--------------------------------------------------------------------------------------------------------------------------------------------------------------------------------------------------------
--------------------------------------------------------------------------------------------------------------------------------------------------------------------------------------------------------
------------------------------------------------------------------------------------oSo-----------------------------------------------------------------------------------------------------------------
------------------------------------------ooooo--------------------------oSoooo-------------------------------------------------------------------------------------------------------------------------
----------------oSooo-------------------------------------------------------------ooo----ooo----------ooo------oooooSo------------------------------------------------ooo-------------------------------
---------------------------Sooo--------ooooooo-----oo----Sooo----ooSo-----oooo---k-R-----------------y--g---------------oSooooo--oSSSooSSo-----SoSS-----oooo------------------oSooooSoo--oooo-----------
------------------ooo-------------------Gk-ykR----R-r-------------------kr---kG-XXXXXXXXXXXXXX-k-GR-XXXXXXXXXX-oooo------------------------------------k---k--------ooooooo----------------------------X
XXXXXXXXXXX-----R--------oooooo---XXXXXXXXXXXXXXXXXXXX---oooo---ooooo-XXXXXXXXXXXXXXXXXXXXXXXXXXXXXXXXXXXXXXXX-gKy-------oooooo--ooooooooo----ooooo---XXXXXXXXXXXX----Ry-r-k---oooooooo----oooo---r----X
XXXXXXXXXXX---XXXXXXXXXX-k-gKg----XXXXXXXXXXXXXXXXXXXX-G---rY--rgk----XXXXXXXXXXXXXXXXXXXXXXXXXXXXXXXXXXXXXXXXXXXXXXXXX----R-yg----K--Ggk--------y--r-XXXXXXXXXXXXXXXXXXXXXXX-----y-r------G-Yk--XXXXXXX
XXXXXXXXXXXXXXXXXXXXXXXXXXXXXXXXXXXXXXXXXXXXXXXXXXXXXXXXXXXXXXXXXXXXXXXXXXXXXXXXXXXXXXXXXXXXXXXXXXXXXXXXXXXXXXXXXXXXXXXXXXXXXXXXXXXXXXXXXXXXXXXXXXXXXXXXXXXXXXXXXXXXXXXXXXXXXXXXXXXXXXXXXXXXXXXXXXXXXXXX

