--------------------------------------------------------------------------------------------------------------------------------------------------------------------------------------------------------
--------------------------------------------------------------------------------------------------------------------------------------------------------------------------------------------------------
--------------------------------------------------------------------------------------------------------------------------------------------------------------------------------------------------------
--------------------------------------------------------------------------------------------------------------------------------------------------------------------------------------------------------
--------------------------------------------------------------------------------------------------------------------------------------------------------------------------------------------------------
--------------------------------------------------------------------------------------------------------------------------------------------------------------------------------------------------------
--------------------------------------------------------------------------------------------------------------------------------------------------------------------------------------------------------
--------------------------------------------------------------------------------------------------------------------------------------------------------------------------------------------------------
--------------------------------------------------------------------------------------------------------------------------------------------------------------------------------------------------------
--------------------------------------------------------------------------------------------------------------------------------------------------------------------------------------------------------
--------------------------------------------------------------------------------------------------------------------------------------------------------------------------------------------------------
--------------------------------------------------------------------------------------------------------------------------------------------------------------------------------------------------------
------------------------------------oooSooo---------------------------------------------------------------------oooSoooSo-------------ooooooooo---------------------------------------------------------
----------------SSoSS-----------------------------oSSoooo-------------------------------------------------ooS--------------------------------------------------oooo--------oooooo-----------------------
------------------------------------ooooooo----------------------------ooo----oooooo----ooo-----------------------oooo------------------ooooo-----------------------------------------------------------
---------------oooooo---------------kr---g--------ooooo--------oSoS---------------y-----------SoS-----------------r-G--------------------krGkr----------------oooo-----------oooo--oSooo----------------
------------------y----------------XXXXXXXXX------yKy------------------------XXXXXXXXXXXXXXX-----------------g-XXXXXXXXXXX-K----XX---XXXXXXXXXXX-------------r------------------------------------XXXXXX
XXXXXXXXXXXXXXXXXXXXXXX--ooo-XXXXXXXXXXXXXXX----XXXXXXXXXXX---ooooo------rY--XXXXXXXXXXXXXXX-ooooo----XXXXXXXXXXXXXXXXXXXXXXXXXXXXXXXXXXXXXXXXXX-----XXXXXXXXXXXXXXX------XXXXXXXX----ooo--XXXXXXXXXXXXX
XXXXXXXXXXXXXXXXXXXXXXX----y-XXXXXXXXXXXXXXX----XXXXXXXXXXX--R---k----XXXXXXXXXXXXXXXXXXXXXX-----gk---XXXXXXXXXXXXXXXXXXXXXXXXXXXXXXXXXXXXXXXXXX-----XXXXXXXXXXXXXXX----R-XXXXXXXX----r-r--XXXXXXXXXXXXX
XXXXXXXXXXXXXXXXXXXXXXXXXXXXXXXXXXXXXXXXXXXXXXXXXXXXXXXXXXXXXXXXXXXXXXXXXXXXXXXXXXXXXXXXXXXXXXXXXXXXXXXXXXXXXXXXXXXXXXXXXXXXXXXXXXXXXXXXXXXXXXXXXXXXXXXXXXXXXXXXXXXXXXXXXXXXXXXXXXXXXXXXXXXXXXXXXXXXXXXX

