--------------------------------------------------------------------------------------------------------------------------------------------------------------------------------------------------------
--------------------------------------------------------------------------------------------------------------------------------------------------------------------------------------------------------
--------------------------------------------------------------------------------------------------------------------------------------------------------------------------------------------------------
--------------------------------------------------------------------------------------------------------------------------------------------------------------------------------------------------------
--------------------------------------------------------------------------------------------------------------------------------------------------------------------------------------------------------
--------------------------------------------------------------------------------------------------------------------------------------------------------------------------------------------------------
--------------------------------------------------------------------------------------------------------------------------------------------------------------------------------------------------------
--------------------------------------------------------------------------------------------------------------------------------------------------------------------------------------------------------
--------------------------------------------------------------------------------------------------------------------------------------------------------------------------------------------------------
--------------------------------------------------------------------------------------------------------------------------------------------------------------------------------------------------------
--------------------------------------------------------------------------------------------------------------------------------------------------------------------------------------------------------
--------------------------------------------------------------------------------------------------------------------------------------------------------------------------------------------------------
-------------------------------------------------------------------------------------Sooo-----------------------------------------------------------------------------------------------------oooo------
------------ooSo--------------------------------------------------------------ooo--------------------------oSSo-------------------------------------ooooo-----------------------------------------------
---------------------oooSoo----oooo---------------------------------------------------------------------------------------------oooo-----------------------ooo---------------------oSooSoo----ooooo-----
-------------ooooo------------------------------------------------oo---------oooo--gRr--y--------------------------------------------------------------oo------k---------oooo---------------------------
XXXXXXXXXXX-gYyky-k-----oo-------ooo---------------------------------r------RKy-r-XXXXXXXX-----------------RRRk------------oo------------------oo---------XXXXXXX---XX-----K--R------ooooo---XXXXXXX----
XXXXXXXXXXXXXXXXXXXX----k---k---k-----oo--------------oooo--XXXXXXXXXXX---XXXXXXXXXXXXXXXX----------oooo--XXXXXX---------G--y--------XXXXXX------G-XXXXXXXXXXXXXXXXXXXXXXXXXXXXXX-----k----XXXXXXXXX----
XXXXXXXXXXXXXXXXXXXXXXXXXXXXXXXXXXXXX-------XXX-------gyg-R-XXXXXXXXXXX---XXXXXXXXXXXXXXXX--R---XXX-R--r--XXXXXX-------XXXXXXXXXXXXXXXXXXXXXXXXXXXXXXXXXXXXXXXXXXXXXXXXXXXXXXXXXXXXXXXXXXXXXXXXXXXXXXXXX
XXXXXXXXXXXXXXXXXXXXXXXXXXXXXXXXXXXXXXXXXXXXXXXXXXXXXXXXXXXXXXXXXXXXXXXXXXXXXXXXXXXXXXXXXXXXXXXXXXXXXXXXXXXXXXXXXXXXXXXXXXXXXXXXXXXXXXXXXXXXXXXXXXXXXXXXXXXXXXXXXXXXXXXXXXXXXXXXXXXXXXXXXXXXXXXXXXXXXXXX

