--------------------------------------------------------------------------------------------------------------------------------------------------------------------------------------------------------
--------------------------------------------------------------------------------------------------------------------------------------------------------------------------------------------------------
--------------------------------------------------------------------------------------------------------------------------------------------------------------------------------------------------------
--------------------------------------------------------------------------------------------------------------------------------------------------------------------------------------------------------
--------------------------------------------------------------------------------------------------------------------------------------------------------------------------------------------------------
--------------------------------------------------------------------------------------------------------------------------------------------------------------------------------------------------------
--------------------------------------------------------------------------------------------------------------------------------------------------------------------------------------------------------
--------------------------------------------------------------------------------------------------------------------------------------------------------------------------------------------------------
--------------------------------------------------------------------------------------------------------------------------------------------------------------------------------------------------------
--------------------------------------------------------------------------------------------------------------------------------------------------------------------------------------------------------
--------------------------------------------------------------------------------------------------------------------------------------------------------------------------------------------------------
--------------------------------------------------------------------------------------------------------------------------------------------------------------------------------------------------------
-----------------------------------------------------ooSo------------------oooS-------------------------------------------------------------------------------------------------------------------oSSo--
--------------SSo--------------------------------------------------------------------------------------------------------------------SooSoo--------------------------------------Sooo-------------------
-----------------------ooS------------------------oooooo------------------oooo---------------------ooSooS-----------------------------------------ooSS-------------SSoSoo---------------------------oo--
------------oooooo--------------------------------------g------ooooo-------k-kK---------------------------------ooo------oooo---------ooooo------------------------------------ooooo--------------kr-K--
XXXXXXXXXX------k--G------------------ooo---oooo-XXXXXXXXX--------------XXXXXXXXXX-----------------ooooooooo-------------------------yRr--G-------ooo--------------ooo----------------R--oo----XXXXXXXXX
XXXXXXXXXXXXXXXXXXXXX-g---R---ooo--g-------rggK--XXXXXXXXX----XXXXXXX---XXXXXXXXXX-oooo----------------k-Ry-----ooo-----oo--------XXXXXXXXXX------------------------yrg-------XXXXXXXXXX----Gg-XXXXXXXXX
XXXXXXXXXXXXXXXXXXXXXXXXXXXX--gr--XXXXXXXXXXXXXXXXXXXXXXXX----XXXXXXX---XXXXXXXXXX------------XXXXXXXXXXXXXXX--k--------G---------XXXXXXXXXX-----XXXXXXXX-----XXXXXXXXXXXXXX--XXXXXXXXXXXXXXXXXXXXXXXXXX
XXXXXXXXXXXXXXXXXXXXXXXXXXXXXXXXXXXXXXXXXXXXXXXXXXXXXXXXXXXXXXXXXXXXXXXXXXXXXXXXXXXXXXXXXXXXXXXXXXXXXXXXXXXXXXXXXXXXXXXXXXXXXXXXXXXXXXXXXXXXXXXXXXXXXXXXXXXXXXXXXXXXXXXXXXXXXXXXXXXXXXXXXXXXXXXXXXXXXXXX

