--------------------------------------------------------------------------------------------------------------------------------------------------------------------------------------------------------
--------------------------------------------------------------------------------------------------------------------------------------------------------------------------------------------------------
--------------------------------------------------------------------------------------------------------------------------------------------------------------------------------------------------------
--------------------------------------------------------------------------------------------------------------------------------------------------------------------------------------------------------
--------------------------------------------------------------------------------------------------------------------------------------------------------------------------------------------------------
--------------------------------------------------------------------------------------------------------------------------------------------------------------------------------------------------------
--------------------------------------------------------------------------------------------------------------------------------------------------------------------------------------------------------
--------------------------------------------------------------------------------------------------------------------------------------------------------------------------------------------------------
--------------------------------------------------------------------------------------------------------------------------------------------------------------------------------------------------------
--------------------------------------------------------------------------------------------------------------------------------------------------------------------------------------------------------
--------------------------------------------------------------------------------------------------------------------------------------------------------------------------------------------------------
--------------------------------------------------------------------------------------------------------------------------------------------------------------------------------------------------------
-----------------------oSo---------------------------------------------------------------------------------------------------oooo----ooooo---------------------------------------------------ooSoS------
----------------------------oooSoo----------------oooo------------------------------------ooo-----------oooSo-------------------------------------------------------------------------------------------
-----------------------ooo--------------ooo---------------------------------------------------------------------------------ooooo-----oo-------SSoSoS------------ooo--------------------------oo--------
----------------g------y-----ooooo--------Y------ooooo----------------------------Sooo---------------------oo-------------R--ky---------rY------------------------g--Y---------------Sooo--------k------
-------------XXXXXXXXXXXXXX-g-R---k---XXXXXX------k--------oo-XXXX--oo---XXXXX---------------g----------Y-Y---XXXXXXXX---XXXXXXXXXXXXXXXXXXX-ooooooooo----------XXXXXXX---------------------XXXXXXXX----
XXXXXXXXXXXXXXXXXXXXXXXXXXXXXXXXXXXXXXXXXXXX----XXXXXXXX---r--XXXX---G---XXXXX--ooooo----XXXXXXX--oo---XXXXXXXXXXXXXXXXXXXXXXXXXXXXXXXXXXXXX------ykk-----------XXXXXXXXXXXXXX------oooo----XXXXXXXXXXXX
XXXXXXXXXXXXXXXXXXXXXXXXXXXXXXXXXXXXXXXXXXXX----XXXXXXXXXXXXXXXXXXXXXXXXXXXXXX--GgKr-r-XXXXXXXXX-g-y---XXXXXXXXXXXXXXXXXXXXXXXXXXXXXXXXXXXXXXXXXXXXXXXXXXX--y---XXXXXXXXXXXXXXXXXXX--G--r---XXXXXXXXXXXX
XXXXXXXXXXXXXXXXXXXXXXXXXXXXXXXXXXXXXXXXXXXXXXXXXXXXXXXXXXXXXXXXXXXXXXXXXXXXXXXXXXXXXXXXXXXXXXXXXXXXXXXXXXXXXXXXXXXXXXXXXXXXXXXXXXXXXXXXXXXXXXXXXXXXXXXXXXXXXXXXXXXXXXXXXXXXXXXXXXXXXXXXXXXXXXXXXXXXXXXX

