--------------------------------------------------------------------------------------------------------------------------------------------------------------------------------------------------------
--------------------------------------------------------------------------------------------------------------------------------------------------------------------------------------------------------
--------------------------------------------------------------------------------------------------------------------------------------------------------------------------------------------------------
--------------------------------------------------------------------------------------------------------------------------------------------------------------------------------------------------------
--------------------------------------------------------------------------------------------------------------------------------------------------------------------------------------------------------
--------------------------------------------------------------------------------------------------------------------------------------------------------------------------------------------------------
--------------------------------------------------------------------------------------------------------------------------------------------------------------------------------------------------------
--------------------------------------------------------------------------------------------------------------------------------------------------------------------------------------------------------
--------------------------------------------------------------------------------------------------------------------------------------------------------------------------------------------------------
--------------------------------------------------------------------------------------------------------------------------------------------------------------------------------------------------------
--------------------------------------------------------------------------------------------------------------------------------------------------------------------------------------------------------
--------------------------------------------------------------------------------------------------------------------------------------------------------------------------------------------------------
--------------------------------------------------------------------------------------ooo------------------------------------------------SooSoo---SSS----------------------------------------oooSoo-----
---------------------------------------------------------------------------------------------------------------------oSSoS------------------------------------------------------------Soo---------------
---------------------------SSo------------------------oooo------------------------------------oo-------------------------------ooooo--ooooooo----oooo-------oooo-----ooSS-----oooSo----------ooooooo----
---------------------------------------------------------------------------oooooSo-----------------------oooooo-------oo----------Yg-----k---Yg---Y-----------------------------------oo---------yg-----
-------------------gG----ooooo-------k----------XX----oooo------oo-----------------XXXXXXXXXXXXXX-----XX--r--g--------------XXXXXXXXXXXXXXXXXXXXXXXXXXXX-ooooo------oooooo----oooo----k-----XXXXXXXXXX--
------------XXXXXXXXXXX--r----k--XXXXXXX--------XX--k-Yr-k-----------------ooooooo-XXXXXXXXXXXXXXXXXXXXXXXXXXXXXXXXXXXXXXXXXXXXXXXXXXXXXXXXXXXXXXXXXXXXX----g------g-Gkr-R------y---XXXXXXXXXXXXXXXXXX--
------------XXXXXXXXXXXXXXXXXXXXXXXXXXXX-----XXXXXXXXXXXXXXXXXXXXXX---------r-Rk-y-XXXXXXXXXXXXXXXXXXXXXXXXXXXXXXXXXXXXXXXXXXXXXXXXXXXXXXXXXXXXXXXXXXXXXXXXXXXXXXXXXXXXXXXXXXXXXXXXXXXXXXXXXXXXXXXXXXXXX
XXXXXXXXXXXXXXXXXXXXXXXXXXXXXXXXXXXXXXXXXXXXXXXXXXXXXXXXXXXXXXXXXXXXX---XXXXXXXXXXXXXXXXXXXXXXXXXXXXXXXXXXXXXXXXXXXXXXXXXXXXXXXXXXXXXXXXXXXXXXXXXXXXXXXXXXXXXXXXXXXXXXXXXXXXXXXXXXXXXXXXXXXXXXXXXXXXXXXX

