--------------------------------------------------------------------------------------------------------------------------------------------------------------------------------------------------------
--------------------------------------------------------------------------------------------------------------------------------------------------------------------------------------------------------
--------------------------------------------------------------------------------------------------------------------------------------------------------------------------------------------------------
--------------------------------------------------------------------------------------------------------------------------------------------------------------------------------------------------------
--------------------------------------------------------------------------------------------------------------------------------------------------------------------------------------------------------
--------------------------------------------------------------------------------------------------------------------------------------------------------------------------------------------------------
--------------------------------------------------------------------------------------------------------------------------------------------------------------------------------------------------------
--------------------------------------------------------------------------------------------------------------------------------------------------------------------------------------------------------
--------------------------------------------------------------------------------------------------------------------------------------------------------------------------------------------------------
--------------------------------------------------------------------------------------------------------------------------------------------------------------------------------------------------------
--------------------------------------------------------------------------------------------------------------------------------------------------------------------------------------------------------
--------------------------------------------------------------------------------------------------------------------------------------------------------------------------------------------------------
------------------------------------------------------ooSoSoo--------------------oSo-------------------------------------------------------------------------------oooS--------------------SooS---------
-------------------Soooo-----------------------------------------------------------------------------------oSS------oSooo-------------------------------------------------------------------------------
-----------------------------SSo-----------------------oooooo------ooSo----------ooo------------------------------------------------------------------------------oooo--------------------ooo-----------
------------------ooooooo--------------oooSoSo--------r--K------------------------yr----ooooo-------------oo-----oooooooo-----------------------------------------rrR---------------------G-gky---------
--------------XX----k-gg-k---ooooo-------------------XXXXXXXXX---oooo-----------XXXXXXX-Yy----------------kg--------g-Y--------XXX-k--K---k--R-----XXXXX-------XXXXXXXXXX--------------XXXXXXXXXX-------
XXXXXXXXXXXXXXXXXXXXXXXXXXX-----r-g-------ooo--------XXXXXXXXXXX--g---R---ooo---XXXXXXXXXXXXXX-----------XXXXXXXXXXXXXXXXX-----XXXXXXXXXXXXXXXX----XXXXX-------XXXXXXXXXX---------XXXXXXXXXXXXXXX-------
XXXXXXXXXXXXXXXXXXXXXXXXXXXXXXXXXXXXXX---------------XXXXXXXXXXXXXXXXXXX--------XXXXXXXXXXXXXXXXXXX---r--XXXXXXXXXXXXXXXXX-----XXXXXXXXXXXXXXXX----XXXXXXXXXXXXXXXXXXXXXX----XXXXXXXXXXXXXXXXXXXX---k---
XXXXXXXXXXXXXXXXXXXXXXXXXXXXXXXXXXXXXXXXXXXXXXXXXXXXXXXXXXXXXXXXXXXXXXXXXXXXXXXXXXXXXXXXXXXXXXXXXXXXXXXXXXXXXXXXXXXXXXXXXXXXXXXXXXXXXXXXXXXXXXXXXXXXXXXXXXXXXXXXXXXXXXXXXXXXXXXXXXXXXXXXXXXXXXXXXXXXXXXX

