--------------------------------------------------------------------------------------------------------------------------------------------------------------------------------------------------------
--------------------------------------------------------------------------------------------------------------------------------------------------------------------------------------------------------
--------------------------------------------------------------------------------------------------------------------------------------------------------------------------------------------------------
--------------------------------------------------------------------------------------------------------------------------------------------------------------------------------------------------------
--------------------------------------------------------------------------------------------------------------------------------------------------------------------------------------------------------
--------------------------------------------------------------------------------------------------------------------------------------------------------------------------------------------------------
--------------------------------------------------------------------------------------------------------------------------------------------------------------------------------------------------------
--------------------------------------------------------------------------------------------------------------------------------------------------------------------------------------------------------
--------------------------------------------------------------------------------------------------------------------------------------------------------------------------------------------------------
--------------------------------------------------------------------------------------------------------------------------------------------------------------------------------------------------------
--------------------------------------------------------------------------------------------------------------------------------------------------------------------------------------------------------
--------------------------------------------------------------------------------------------------------------------------------------------------------------------------------------------------------
------------------------------------------------------------------------------------------------------------------------------------------------------------ooSSS---------------------------------------
---------------oSSoSoo--------------------------------------------------------------------------------------------------------ooooo---------------------------------------------------------------------
-----------------------------------------ooo-------SSSoo--------------------ooo--------------------------------oo-----ooo------------------------SSSo--------oooooo-------------------------------------
-----------------ooooo---------------------r---------------------ooSoSSo------gR------------------------oo------ygG------k-----oooo-------oSS---------------YG-Y-------------oSSS-----------------------
------------------R-Ry-----------XX----XXXXXXXX-oooooo---------------------XXXXXX--XXXXX-----------------gkr--XXXXXXXXXXXXXX--g---g-------------ooooooo--XXXXXXXXXXX----------------------------G--XXXXX
--------------XXXXXXXXXXXXXX-----XX----XXXXXXXX-y-----ggy--ooo------ooo----XXXXXX--XXXXX-------ooo-----XXXXXXXXXXXXXXXXXXXXXXXXXXXXXXXX--oooo-----rY-g---XXXXXXXXXXX-----XXX---ooooo---ooo-XXXXXXXXXXXXX
XXXXXXXXXXX---XXXXXXXXXXXXXX-----XXXXXXXXXXXXXXXXXXXXXXXXX--Rr-----r-ygG---XXXXXX--XXXXXXXXX-Rg-kR-XXXXXXXXXXXXXXXXXXXXXXXXXXXXXXXXXXXX--------XXXXXXXXXXXXXXXXXXXXXXXXXXXXX--Y--kk----r---XXXXXXXXXXXXX
XXXXXXXXXXXXXXXXXXXXXXXXXXXXXXXXXXXXXXXXXXXXXXXXXXXXXXXXXXXXXXXXXXXXXXXXXXXXXXXXXXXXXXXXXXXXXXXXXXXXXXXXXXXXXXXXXXXXXXXXXXXXXXXXXXXXXXXXXXXXXXXXXXXXXXXXXXXXXXXXXXXXXXXXXXXXXXXXXXXXXXXXXXXXXXXXXXXXXXXX

