--------------------------------------------------------------------------------------------------------------------------------------------------------------------------------------------------------
--------------------------------------------------------------------------------------------------------------------------------------------------------------------------------------------------------
--------------------------------------------------------------------------------------------------------------------------------------------------------------------------------------------------------
--------------------------------------------------------------------------------------------------------------------------------------------------------------------------------------------------------
--------------------------------------------------------------------------------------------------------------------------------------------------------------------------------------------------------
--------------------------------------------------------------------------------------------------------------------------------------------------------------------------------------------------------
--------------------------------------------------------------------------------------------------------------------------------------------------------------------------------------------------------
--------------------------------------------------------------------------------------------------------------------------------------------------------------------------------------------------------
--------------------------------------------------------------------------------------------------------------------------------------------------------------------------------------------------------
--------------------------------------------------------------------------------------------------------------------------------------------------------------------------------------------------------
--------------------------------------------------------------------------------------------------------------------------------------------------------------------------------------------------------
--------------------------------------------------------------------------------------------------------------------------------------------------------------------------------------------------------
----------------------------------------------------ooSo----------------oooS---------------------Soo-------------------------------------------------Sooooo----oooSooo----------------------------------
--------------ooSoSo--------------------------oooo------------------------------------------------------------------------------------------------------------------------------oSo---------------------
----------------------------------------------------------ooooSoo-------------------------------oooo-------------ooo--ooSSSo------------------------oooo------ooooooo-----------------------------------
-------------ooooooo----------------oSooo-----ooo---Y-------------------r-g------------oooo----R----------Soo---g-------------------------------------K-R-----g--kr-G--------ooo-------oSo--------------
----------------Y---g--------XXXXX-------------g-K-XXXXXX----ooooo-----XXXXXXX-----------y---XXXXXXXX---------XXXXXXX----oo--XX------------XXXXX--XXXXXXXXXXXXXXXXXXXXX------K-g--------------------XXXX
------------XXXXXXXXXXXXXXXXXXXXXX--ooooo----XXXXXXXXXXXX---k---gG-----XXXXXXX----oo--XXXXXXXXXXXXXXXXX-------XXXXXXX---k----XX--ooo--XXXXXXXXXXXXXXXXXXXXXXXXXXXXXXXXXXXXXXXXXXXXXX-oooooooo-------XXXX
XXXXXXXXXXXXXXXXXXXXXXXXXXXXXXXXXX---k-------XXXXXXXXXXXXXXXXXXXXXXX---XXXXXXX------y-XXXXXXXXXXXXXXXXX-------XXXXXXXXXXXXXXXXX-y--Ry-XXXXXXXXXXXXXXXXXXXXXXXXXXXXXXXXXXXXXXXXXXXXXX---k----------y-XXXX
XXXXXXXXXXXXXXXXXXXXXXXXXXXXXXXXXXXXXXXXXXXXXXXXXXXXXXXXXXXXXXXXXXXXXXXXXXXXXXXXXXXXXXXXXXXXXXXXXXXXXXXXXXXXXXXXXXXXXXXXXXXXXXXXXXXXXXXXXXXXXXXXXXXXXXXXXXXXXXXXXXXXXXXXXXXXXXXXXXXXXXXXXXXXXXXXXXXXXXXX

