--------------------------------------------------------------------------------------------------------------------------------------------------------------------------------------------------------
--------------------------------------------------------------------------------------------------------------------------------------------------------------------------------------------------------
--------------------------------------------------------------------------------------------------------------------------------------------------------------------------------------------------------
--------------------------------------------------------------------------------------------------------------------------------------------------------------------------------------------------------
--------------------------------------------------------------------------------------------------------------------------------------------------------------------------------------------------------
--------------------------------------------------------------------------------------------------------------------------------------------------------------------------------------------------------
--------------------------------------------------------------------------------------------------------------------------------------------------------------------------------------------------------
--------------------------------------------------------------------------------------------------------------------------------------------------------------------------------------------------------
--------------------------------------------------------------------------------------------------------------------------------------------------------------------------------------------------------
--------------------------------------------------------------------------------------------------------------------------------------------------------------------------------------------------------
--------------------------------------------------------------------------------------------------------------------------------------------------------------------------------------------------------
--------------------------------------------------------------------------------------------------------------------------------------------------------------------------------------------------------
--------------------------------------------------------------------ooSSS-------------------------oSoSS-----------------------------------------------------------------oooS-----ooSoSoo-----------ooo--
-----------------------------------------------------------------------------SSoo----------oSoo------------oSSoo---oSS----------Soooo----------------oooooSSoo------------------------------------------
-------------------------------------------------oooSSoSo--------------------------------------------ooo----------------------------------------------------------------oooo-----oooooo-----------------
---------------------------------------------------------------------KY---------------------oo-------rgg----ooo----oo---------oooooooo------------------ooo----------------G-------g-rrr-----oooo----r--
XXXXXXXXXXXX----------------------XXXXXXXXXXX-------oooooo-XXX-----XXXXXXXX--K-y------XXXX-----y-XXXXXXXX----k-y------r-----------------XX-----------r--Yg-----------XXXXXXXXXXXXXXXXXXXXX--------XXXXXX
XXXXXXXXXXXX---RR-XXX-oooo--------XXXXXXXXXXXXXX------k-R--XXX-----XXXXXXXXXXXXXXXXXXXXXXXXXXXXXXXXXXXXXXXXXXXXXXXXXXXXX-----XXXXXXXXXXXXX----------XXXXXXXXXXX-Yg---XXXXXXXXXXXXXXXXXXXXX----oo--XXXXXX
XXXXXXXXXXXXXXXXXXXXX----yky-XXXXXXXXXXXXXXXXXXXXXXXXXXXXXXXXXXXXXXXXXXXXXXXXXXXXXXXXXXXXXXXXXXXXXXXXXXXXXXXXXXXXXXXXXXXXXXXXXXXXXXXXXXXXX------g---XXXXXXXXXXXXXXXXXXXXXXXXXXXXXXXXXXXXXX---r-gg-XXXXXX
XXXXXXXXXXXXXXXXXXXXXXXXXXXXXXXXXXXXXXXXXXXXXXXXXXXXXXXXXXXXXXXXXXXXXXXXXXXXXXXXXXXXXXXXXXXXXXXXXXXXXXXXXXXXXXXXXXXXXXXXXXXXXXXXXXXXXXXXXXXXXXXXXXXXXXXXXXXXXXXXXXXXXXXXXXXXXXXXXXXXXXXXXXXXXXXXXXXXXXXX

