--------------------------------------------------------------------------------------------------------------------------------------------------------------------------------------------------------
--------------------------------------------------------------------------------------------------------------------------------------------------------------------------------------------------------
--------------------------------------------------------------------------------------------------------------------------------------------------------------------------------------------------------
--------------------------------------------------------------------------------------------------------------------------------------------------------------------------------------------------------
--------------------------------------------------------------------------------------------------------------------------------------------------------------------------------------------------------
--------------------------------------------------------------------------------------------------------------------------------------------------------------------------------------------------------
--------------------------------------------------------------------------------------------------------------------------------------------------------------------------------------------------------
--------------------------------------------------------------------------------------------------------------------------------------------------------------------------------------------------------
--------------------------------------------------------------------------------------------------------------------------------------------------------------------------------------------------------
--------------------------------------------------------------------------------------------------------------------------------------------------------------------------------------------------------
--------------------------------------------------------------------------------------------------------------------------------------------------------------------------------------------------------
--------------------------------------------------------------------------------------------------------------------------------------------------------------------------------------------------------
---------------------------------------oooo-------------------------------------------ooS-------------------------ooooo----------------------------------oooSo------------------------------------------
-----------------------------------------------------Sooo---oSo---------oSSo-----------------------------------------------------------------------------------------------------oooooo-----------------
---------------------------------------oooo-------------------------------------------oooooo------------ooo-----oooooo-------------------------------------oo-------------ooSo--------------------------
-------------------------------------k----k---------ooo----ooo-----ooo-----------R-----g--g---oSSooo---------------R---------------------oSoo-----------------k---ooo-----------ooooooooo-----oSoooSo---
---------------------------------XXXXXXXXXXX----------r-y---R--r--K--r----r--XXXXXXXXXXXXXXXX-------------ooo--XXXXXXXXX-------XX-----------------Y-----XXXXXXXX-K--k---------------K-G-----------------
--------------XXXXXXXXXXXXXXXXX--XXXXXXXXXXXXXXXXXXXXXXXXXXXXXXXXXXXXXXXXXXXXXXXXXXXXXXXXXXXX----oo---------k--XXXXXXXXX-------XXXX------oooooo--XXXXXXXXXXXXXXXXXXXXX-yr--y---XXXXXXXXXXX-------ooo----
--------------XXXXXXXXXXXXXXXXX--XXXXXXXXXXXXXXXXXXXXXXXXXXXXXXXXXXXXXXXXXXXXXXXXXXXXXXXXXXXX--K-r----XXXXXXXXXXXXXXXXXXXXXXXXXXXXXXXXXX-g-k-RG--XXXXXXXXXXXXXXXXXXXXXXXXXXXXXXXXXXXXXXXXXXXX-----------
XXXXXXXXXXXXXXXXXXXXXXXXXXXXXXXXXXXXXXXXXXXXXXXXXXXXXXXXXXXXXXXXXXXXXXXXXXXXXXXXXXXXXXXXXXXXXXXXXXXXXXXXXXXXXXXXXXXXXXXXXXXXXXXXXXXXXXXXXXXXXXXXXXXXXXXXXXXXXXXXXXXXXXXXXXXXXXXXXXXXXXXXXXXXXXXXXXXXXXXX

