--------------------------------------------------------------------------------------------------------------------------------------------------------------------------------------------------------
--------------------------------------------------------------------------------------------------------------------------------------------------------------------------------------------------------
--------------------------------------------------------------------------------------------------------------------------------------------------------------------------------------------------------
--------------------------------------------------------------------------------------------------------------------------------------------------------------------------------------------------------
--------------------------------------------------------------------------------------------------------------------------------------------------------------------------------------------------------
--------------------------------------------------------------------------------------------------------------------------------------------------------------------------------------------------------
--------------------------------------------------------------------------------------------------------------------------------------------------------------------------------------------------------
--------------------------------------------------------------------------------------------------------------------------------------------------------------------------------------------------------
--------------------------------------------------------------------------------------------------------------------------------------------------------------------------------------------------------
--------------------------------------------------------------------------------------------------------------------------------------------------------------------------------------------------------
--------------------------------------------------------------------------------------------------------------------------------------------------------------------------------------------------------
--------------------------------------------------------------------------------------------------------------------------------------------------------------------------------------------------------
-------------------------oSoSSooo-----------------------------------------------------------------------------------------------------------------------------------------------------------------------
--------------------------------------------------------------------------------------------------------------------------------------------------------------------------------------------------------
----------------------------ooooo-------------------------------------------------------------ooS----------Soo----------oSo-----------------------------------------------------------------------------
-------------------------k--k-g-g----------------------------------------ooo----ooSS------------------------------------------------ooSSSoSoo----------oSooS-----------------------oooo-----------------
-------------------ooo--XXXXXXXXXXX-----------------------------------------------------------ooo--XX---ooooooooo---XXX--oo-----XXX---------------XXX------------------------------g------------XXXXX---
----------XXXXXX-g-y----XXXXXXXXXXX--k----XX----------XX---------oooo---------ooooooo-XXXXX---gY---XXXX-g---yk------XXX-k-------XXX----ooooo------XXX--ooo----XXX---ooooo-XXXXXXXXXXXXXX--ooooo-XXXXX---
----------XXXXXXXXXXXXXXXXXXXXXXXXXXXXXXXXXX-----XXXXXXX--XXXXX--G--k-----y-----rK----XXXXXXXXXXXXXXXXXXXXXXXXXXXX--XXXXXXXXXXXXXXX--r-r--y-------XXX-Y--kGyK-XXX---G-----XXXXXXXXXXXXXX--------XXXXX---
XXXXXXXXXXXXXXXXXXXXXXXXXXXXXXXXXXXXXXXXXXXXXXXXXXXXXXXXXXXXXXXXXXXXXXXXXXXXXXXXXXXXXXXXXXXXXXXXXXXXXXXXXXXXXXXXXXXXXXXXXXXXXXXXXXXXXXXXXXXXXXXXXXXXXXXXXXXXXXXXXXXXXXXXXXXXXXXXXXXXXXXXXXXXXXXXXXXXXXXX

