--------------------------------------------------------------------------------------------------------------------------------------------------------------------------------------------------------
--------------------------------------------------------------------------------------------------------------------------------------------------------------------------------------------------------
--------------------------------------------------------------------------------------------------------------------------------------------------------------------------------------------------------
--------------------------------------------------------------------------------------------------------------------------------------------------------------------------------------------------------
--------------------------------------------------------------------------------------------------------------------------------------------------------------------------------------------------------
--------------------------------------------------------------------------------------------------------------------------------------------------------------------------------------------------------
--------------------------------------------------------------------------------------------------------------------------------------------------------------------------------------------------------
--------------------------------------------------------------------------------------------------------------------------------------------------------------------------------------------------------
--------------------------------------------------------------------------------------------------------------------------------------------------------------------------------------------------------
--------------------------------------------------------------------------------------------------------------------------------------------------------------------------------------------------------
--------------------------------------------------------------------------------------------------------------------------------------------------------------------------------------------------------
--------------------------------------------------------------------------------------------------------------------------------------------------------------------------------------------------------
-----------------------------------------------------------------------------------------------------------SSoSo----------------------------------------------------------------------------------------
-----------------------ooS-----------------------------------------------------------------------------------------------------------SoSSoS--------------------------------oSo--------------------------
--------------------------------------------------oSSo----------oooo---------------------------------------ooo-----------------------------------oSoSo-------------------------------oooooo-------------
------------------Soo-----------------ooooooo--------------------g------------------ooooo----oooo--------------Y--------oSooo-------ooooooo----------------------oooSo----------------------------------
-----------------------K---------------kg--k---ooooooo---------XXXXXX---XXXXXX-------------------------XXXXXXXXXX--XXX--------------gK----------ooo----XXX------------------Gr-------oooooo-----XXXXX---
-----------------ooo--XXXXXXX-------XXXXXXXXXX-k---y---XXXXXXXXXXXXXXXXXXXXXXX--------------oooooo-----XXXXXXXXXX--XXX-ooooo------XXXXXXXXXXX-y--------XXX-------oooooooo-XXXXXX-----g-y--------XXXXX---
----------------Gg-rk-XXXXXXXXX-----XXXXXXXXXXXXXXXXXXXXXXXXXXXXXXXXXXXXXXXXXX-------Y-kr--g---y--g-XXXXXXXXXXXXXXXXXX-k------XXXXXXXXXXXXXXXXXXXXXXXXXXXXXXXX------g-k---XXXXXXXXXXXXXXXXXXXXXXXXXXX---
XXXXXXXXXXXXXXXXXXXXXXXXXXXXXXXXXXXXXXXXXXXXXXXXXXXXXXXXXXXXXXXXXXXXXXXXXXXXXXXXXXXXXXXXXXXXXXXXXXXXXXXXXXXXXXXXXXXXXXXXXXXXXXXXXXXXXXXXXXXXXXXXXXXXXXXXXXXXXXXXXXXXXXXXXXXXXXXXXXXXXXXXXXXXXXXXXXXXXXXX

