--------------------------------------------------------------------------------------------------------------------------------------------------------------------------------------------------------
--------------------------------------------------------------------------------------------------------------------------------------------------------------------------------------------------------
--------------------------------------------------------------------------------------------------------------------------------------------------------------------------------------------------------
--------------------------------------------------------------------------------------------------------------------------------------------------------------------------------------------------------
--------------------------------------------------------------------------------------------------------------------------------------------------------------------------------------------------------
--------------------------------------------------------------------------------------------------------------------------------------------------------------------------------------------------------
--------------------------------------------------------------------------------------------------------------------------------------------------------------------------------------------------------
--------------------------------------------------------------------------------------------------------------------------------------------------------------------------------------------------------
--------------------------------------------------------------------------------------------------------------------------------------------------------------------------------------------------------
--------------------------------------------------------------------------------------------------------------------------------------------------------------------------------------------------------
--------------------------------------------------------------------------------------------------------------------------------------------------------------------------------------------------------
--------------------------------------------------------------------------------------------------------------------------------------------------------------------------------------------------------
------------------------oSS------------------------------------------------------oooooo---------------------------------------------------------------oooSooo----------Soo------------------------------
-------------------------------------------------------------Sooooo-------------------------------------------------------------------------------------------------------------------------------------
-------------------------oooo----oSo--------------------------------------------oooooo---ooo-----------------------------------oooSo-----ooSo--------ooooo-------------oooo----oooSo-----SSSoo----------
--------------------------r-y----------------------ooSS------ooo-------------------rG-------------------oSoo--r-Kk----------------------------------k------------------k-y------------------------------
XXXXXXXXXXXXXXXX-------XXXXXXX--ooooo-----------------------K--KrR----ooo--XXXXXXXXXXXXX---------------------XXXXXX----------ooooooo-----oooo------XXXXXXXXXXXXXXXXXXXXXXXXX----oooo--ooooooo-----------
XXXXXXXXXXXXXXXX-------XXXXXXX------y-XXXX-k--y----ooooo--XXXXXXXXXX-------XXXXXXXXXXXXX-----g-----r----oo---XXXXXX---XX----Gr-kg-y----------------XXXXXXXXXXXXXXXXXXXXXXXXX--g----r---y--y-gY----------
XXXXXXXXXXXXXXXX-------XXXXXXXXXXXXXXXXXXXXXXXXXX-k--rk---XXXXXXXXXXXXXXXXXXXXXXXXXXXXXXXXXXXXXXXXXXXXX--RK--XXXXXXXXXXX---XXXXXXXXXXXXXXXXXXX-----XXXXXXXXXXXXXXXXXXXXXXXXXXXXXXXXXXXXXXXXXXXXX--k---XX
XXXXXXXXXXXXXXXXXXXXXXXXXXXXXXXXXXXXXXXXXXXXXXXXXXXXXXXXXXXXXXXXXXXXXXXXXXXXXXXXXXXXXXXXXXXXXXXXXXXXXXXXXXXXXXXXXXXXXXXXXXXXXXXXXXXXXXXXXXXXXXXXXXXXXXXXXXXXXXXXXXXXXXXXXXXXXXXXXXXXXXXXXXXXXXXXXXXXXXXX

