--------------------------------------------------------------------------------------------------------------------------------------------------------------------------------------------------------
--------------------------------------------------------------------------------------------------------------------------------------------------------------------------------------------------------
--------------------------------------------------------------------------------------------------------------------------------------------------------------------------------------------------------
--------------------------------------------------------------------------------------------------------------------------------------------------------------------------------------------------------
--------------------------------------------------------------------------------------------------------------------------------------------------------------------------------------------------------
--------------------------------------------------------------------------------------------------------------------------------------------------------------------------------------------------------
--------------------------------------------------------------------------------------------------------------------------------------------------------------------------------------------------------
--------------------------------------------------------------------------------------------------------------------------------------------------------------------------------------------------------
--------------------------------------------------------------------------------------------------------------------------------------------------------------------------------------------------------
--------------------------------------------------------------------------------------------------------------------------------------------------------------------------------------------------------
--------------------------------------------------------------------------------------------------------------------------------------------------------------------------------------------------------
--------------------------------------------------------------------------------------------------------------------------------------------------------------------------------------------------------
---------------------------------------------------Soooo-----------------oSSSoSoo------------------------------------------------------------------------------------ooSooo-----------------------------
-----------------------ooSo------------------------------------------------------------------------oooooS------ooo--------------------------------------------------------------------------------------
---------------------------------------------------ooo--------------------ooooo----------------------------------------------------------oooSS------------------------ooooo-----------------------------
----------------------oooooo------------kK--------y--Gk-----ooSooS--------GrGG-k---------------------oooo-----ooooo----oSoSo-----r-----------------------------G--------ykY-----------------------------
-----------XX---------y-K--K--XXXXX----XXXXXX---XXXXXXXXX-----------XXXXXXXXXXXXXX----------oo---------g-r------g-K-Y---------XXXXXX-----ooooooo-------------XXXXXXXXXXXXXXXXX------XX-----ooooo-XXXXX--
-----------XX----Gr--XXXXXXXXXXXXXXXXXXXXXXXX---XXXXXXXXX--ooooooo--XXXXXXXXXXXXXXXXX-ryYK---r---XXXXXXXXXXXXXXXXXXXXX-oooo---XXXXXX------g---gG-------------XXXXXXXXXXXXXXXXX-oooo-XXXXX----k---XXXXXXX
XXXXXXXXXXXXXXXXXXXXXXXXXXXXXXXXXXXXXXXXXXXXXXXXXXXXXXXXX-yG--gky---XXXXXXXXXXXXXXXXXXXXXXXXXXXXXXXXXXXXXXXXXXXXXXXXXX-y------XXXXXXXXXXXXXXXXXXXX-k---------XXXXXXXXXXXXXXXXX--k-y-XXXXXXXXXXXXXXXXXXXX
XXXXXXXXXXXXXXXXXXXXXXXXXXXXXXXXXXXXXXXXXXXXXXXXXXXXXXXXXXXXXXXXXXXXXXXXXXXXXXXXXXXXXXXXXXXXXXXXXXXXXXXXXXXXXXXXXXXXXXXXXXXXXXXXXXXXXXXXXXXXXXXXXXXXXXXXXXXXXXXXXXXXXXXXXXXXXXXXXXXXXXXXXXXXXXXXXXXXXXXX

