--------------------------------------------------------------------------------------------------------------------------------------------------------------------------------------------------------
--------------------------------------------------------------------------------------------------------------------------------------------------------------------------------------------------------
--------------------------------------------------------------------------------------------------------------------------------------------------------------------------------------------------------
--------------------------------------------------------------------------------------------------------------------------------------------------------------------------------------------------------
--------------------------------------------------------------------------------------------------------------------------------------------------------------------------------------------------------
--------------------------------------------------------------------------------------------------------------------------------------------------------------------------------------------------------
--------------------------------------------------------------------------------------------------------------------------------------------------------------------------------------------------------
--------------------------------------------------------------------------------------------------------------------------------------------------------------------------------------------------------
--------------------------------------------------------------------------------------------------------------------------------------------------------------------------------------------------------
--------------------------------------------------------------------------------------------------------------------------------------------------------------------------------------------------------
--------------------------------------------------------------------------------------------------------------------------------------------------------------------------------------------------------
--------------------------------------------------------------------------------------------------------------------------------------------------------------------------------------------------------
--------------------------------------------------------------------------------------------------------------------------------------------------------------------------------------------------------
---------------------------------------------------------------------------------------------------------------------------------------------------------------------------------------oSSSoo--oSoooo---
---------------------------------SoSSo------oooo-----oSSooSo--------------------------------oSooSo---------------------------------------ooo-----------------SSoSoo-----oooo----------------------------
----------------------------------------------r--------------------------------SoS---------------------ooSoo------------SoooS----ooooo-----Kr------ooooooo---------------------------oooooo----oooooooo-
--------------oo----------------oooooo-----XXXXXXXXX-oooooooo--------------------------------------------------ooo-----------------yRR-XXXXXXXX----------------ooo------ooo---------k-----kk-----rg-----
XXXXXXXXXXXXX-------------kg---Gk--G-------XXXXXXXXX--K---YRy---XXXXX-oo-------ooooo--------rkK-------oooo-----g---XXX--oooo----XXXXXXXXXXXXXXXXX--ooooo-----Rrrry-y------Gg-Y-XXXXXXXXXXXXXXXXXXXXXXXXX
XXXXXXXXXXXXXXXXXXX-----XXXXXXXXXXXXXXXX---XXXXXXXXXXXXXXXXXXX--XXXXX---g-------kk----XXXXXXXXXXXXX-----kR-g-XXXXXXXXX-ry-----y-XXXXXXXXXXXXXXXXX-K-rk---k-XXXXXXXXXXXXXXXXXXXXXXXXXXXXXXXXXXXXXXXXXXXXX
XXXXXXXXXXXXXXXXXXXXXXXXXXXXXXXXXXXXXXXXXXXXXXXXXXXXXXXXXXXXXXXXXXXXXXXXXXXXXXXXXXXXXXXXXXXXXXXXXXXXXXXXXXXXXXXXXXXXXXXXXXXXXXXXXXXXXXXXXXXXXXXXXXXXXXXXXXXXXXXXXXXXXXXXXXXXXXXXXXXXXXXXXXXXXXXXXXXXXXXX

