--------------------------------------------------------------------------------------------------------------------------------------------------------------------------------------------------------
--------------------------------------------------------------------------------------------------------------------------------------------------------------------------------------------------------
--------------------------------------------------------------------------------------------------------------------------------------------------------------------------------------------------------
--------------------------------------------------------------------------------------------------------------------------------------------------------------------------------------------------------
--------------------------------------------------------------------------------------------------------------------------------------------------------------------------------------------------------
--------------------------------------------------------------------------------------------------------------------------------------------------------------------------------------------------------
--------------------------------------------------------------------------------------------------------------------------------------------------------------------------------------------------------
--------------------------------------------------------------------------------------------------------------------------------------------------------------------------------------------------------
--------------------------------------------------------------------------------------------------------------------------------------------------------------------------------------------------------
--------------------------------------------------------------------------------------------------------------------------------------------------------------------------------------------------------
--------------------------------------------------------------------------------------------------------------------------------------------------------------------------------------------------------
--------------------------------------------------------------------------------------------------------------------------------------------------------------------------------------------------------
--------------------------------------------------ooSoooSo--------------------------------SoSo-----------------------------------------------------ooooS------------------------------------------------
-------------------------------------------------------------------------------------------------------------------------------------------------------------------------------ooSoo--------------------
----------------ooSS-----------------oooo-----------oooooo-----------ooSSooo-------------ooooo------------------------------------oooo-------------oooooo----------oo-----------------------------------
-------------------------SoooS------gk----------------gr-G--------------------oSSoSSo---kGr----G------------oo-------------ooo----g--K-y-----------------r--------g-R---------ooooo-----Soooo--oooSooSo-
-----------------ooooo------------XXXXXXXX-------XXXXXXXXXXXX-----XX--ooo-------------XXXXXXXXXXXXXXXX----g-Y--------------------XXXXXXXXX--------XXXXXXXXXXX---XXXXXXX-------G--kGk--------------------
XXXXXXXXXXXXXX-kk--Y-----oooooooo-XXXXXXXX-ooooo-XXXXXXXXXXXXXXXXXXX--gK---r---oooooo-XXXXXXXXXXXXXXXXXXXXXXXXXXXXX------oooooo--XXXXXXXXX-oooo---XXXXXXXXXXX---XXXXXXXXXXXXXXXXXXXXX---ooo-------ooooo-
XXXXXXXXXXXXXXXXXXXXXXX-----gkkg--XXXXXXXX----Y--XXXXXXXXXXXXXXXXXXXXXXXXXXXX---------XXXXXXXXXXXXXXXXXXXXXXXXXXXXXXXXXX----yy---XXXXXXXXX------XXXXXXXXXXXXX---XXXXXXXXXXXXXXXXXXXXX--r---G---y--g--y--
XXXXXXXXXXXXXXXXXXXXXXXXXXXXXXXXXXXXXXXXXXXXXXXXXXXXXXXXXXXXXXXXXXXXXXXXXXXXXXXXXXXXXXXXXXXXXXXXXXXXXXXXXXXXXXXXXXXXXXXXXXXXXXXXXXXXXXXXXXXXXXXXXXXXXXXXXXXXXXXXXXXXXXXXXXXXXXXXXXXXXXXXXXXXXXXXXXXXXXXX

