--------------------------------------------------------------------------------------------------------------------------------------------------------------------------------------------------------
--------------------------------------------------------------------------------------------------------------------------------------------------------------------------------------------------------
--------------------------------------------------------------------------------------------------------------------------------------------------------------------------------------------------------
--------------------------------------------------------------------------------------------------------------------------------------------------------------------------------------------------------
--------------------------------------------------------------------------------------------------------------------------------------------------------------------------------------------------------
--------------------------------------------------------------------------------------------------------------------------------------------------------------------------------------------------------
--------------------------------------------------------------------------------------------------------------------------------------------------------------------------------------------------------
--------------------------------------------------------------------------------------------------------------------------------------------------------------------------------------------------------
--------------------------------------------------------------------------------------------------------------------------------------------------------------------------------------------------------
--------------------------------------------------------------------------------------------------------------------------------------------------------------------------------------------------------
--------------------------------------------------------------------------------------------------------------------------------------------------------------------------------------------------------
--------------------------------------------------------------------------------------------------------------------------------------------------------------------------------------------------------
--------------------------------------------oSS------SSoS--------------------------------ooooo--------------oSS------------------------------------oooo--------------------------------ooo----oSS-------
--------------------------------------------------------------------------------------------------------------------------------------------------------------------------------------------------------
----------------------------ooo-------------ooooo----oooo---------------------oooo-------ooooooo---------oooooooo------Sooo---------------ooo------ooooo--------------oooSo-----------------oooooo------
---------------------------------------------kYkk---rG-rK----oo-----oSSooSo---------------K--yg-----------yg-Y--------------------Sooo------------g----r-g---SSoS-------------ooooo---kg------R---------
XXXXXXXXXXXXXX----XXXXX----XXXXXXXX-G------XXXXXXXXXXXXXXXX----k--------------oooo-XXXXXXXXXXXXXX-------XXXXXXXXXXXXX---oooo------------ooooo---XXXXXXXXXXX-------------------kY--r-XXXXXXXXXXXXXXXX----
XXXXXXXXXXXXXXXXXXXXXXXXXXXXXXXXXXXXXXXXXXXXXXXXXXXXXXXXXXXXXXXXX--oooooo----yg----XXXXXXXXXXXXXX-----y-XXXXXXXXXXXXX--k-r-r------------r----Y--XXXXXXXXXXX---ooo----yr--K--XXXXXXXXXXXXXXXXXXXXXXXX----
XXXXXXXXXXXXXXXXXXXXXXXXXXXXXXXXXXXXXXXXXXXXXXXXXXXXXXXXXXXXXXXXX----k------XXXXXXXXXXXXXXXXXXXXXXXXXXXXXXXXXXXXXXXXXXXXXXXXXX--k-k----XXXXXXXXXXXXXXXXXXXX-Y-----R-XXXXXXXXXXXXXXXXXXXXXXXXXXXXXXXX----
XXXXXXXXXXXXXXXXXXXXXXXXXXXXXXXXXXXXXXXXXXXXXXXXXXXXXXXXXXXXXXXXXXXXXXXXXXXXXXXXXXXXXXXXXXXXXXXXXXXXXXXXXXXXXXXXXXXXXXXXXXXXXXXXXXXXXXXXXXXXXXXXXXXXXXXXXXXXXXXXXXXXXXXXXXXXXXXXXXXXXXXXXXXXXXXXXXXXXXXX

