--------------------------------------------------------------------------------------------------------------------------------------------------------------------------------------------------------
--------------------------------------------------------------------------------------------------------------------------------------------------------------------------------------------------------
--------------------------------------------------------------------------------------------------------------------------------------------------------------------------------------------------------
--------------------------------------------------------------------------------------------------------------------------------------------------------------------------------------------------------
--------------------------------------------------------------------------------------------------------------------------------------------------------------------------------------------------------
--------------------------------------------------------------------------------------------------------------------------------------------------------------------------------------------------------
--------------------------------------------------------------------------------------------------------------------------------------------------------------------------------------------------------
--------------------------------------------------------------------------------------------------------------------------------------------------------------------------------------------------------
--------------------------------------------------------------------------------------------------------------------------------------------------------------------------------------------------------
--------------------------------------------------------------------------------------------------------------------------------------------------------------------------------------------------------
--------------------------------------------------------------------------------------------------------------------------------------------------------------------------------------------------------
--------------------------------------------------------------------------------------------------------------------------------------------------------------------------------------------------------
-------------------------------------------------------------------------------------------------------------------------oSSoo--------------------------------oooSooo-----------------------------------
-------------------------------------------------------------oSoooSo------------------------------------------ooS---------------------oooo-------------------------------------------ooSSS--------------
---------------ooooo--ooo-----ooo-----------------------------------------------------------------------------------------ooo----------------------------ooo-----ooo------------------------------------
-------------------------------KKk-----------------ooSo------oooooooo---oSo-------Soooo---------ooo---------oooo---------Rg-----------oooo----------------------gK-k-----ooo----------oooooo------------
---------------oo-----ooo---XXXXXXXX---------ooo---------------R-g--------------------------k----r------------R-----XXXXXXXXXXXX--------------------XXXXXXXXXXXXXXXXXXX-k-yk----------r-k----XXXXX------
XXXXXXXXXXX--RKg---g--k-r-G-XXXXXXXX--oo------g-------------XXXXXXXXXX--ooo-------ooooo-XXXXXXXXXXXX---oo-XXXXXXXXXXXXXXXXXXXXXX----XXXXXXX-----XXXXXXXXXXXXXXXXXXXXXXXXXXXXXXXXXXXXXXXXXXXXXXXXXX------
XXXXXXXXXXXXXXXXXXXXXXXXXXXXXXXXXXXX------XXXXXXXX--Yyrk--XXXXXXXXXXXX-------y------ykg-XXXXXXXXXXXX--Kg--XXXXXXXXXXXXXXXXXXXXXX----XXXXXXX-----XXXXXXXXXXXXXXXXXXXXXXXXXXXXXXXXXXXXXXXXXXXXXXXXXX----r-
XXXXXXXXXXXXXXXXXXXXXXXXXXXXXXXXXXXXXXXXXXXXXXXXXXXXXXXXXXXXXXXXXXXXXXXXXXXXXXXXXXXXXXXXXXXXXXXXXXXXXXXXXXXXXXXXXXXXXXXXXXXXXXXXXXXXXXXXXXXXXXXXXXXXXXXXXXXXXXXXXXXXXXXXXXXXXXXXXXXXXXXXXXXXXXXXXXXXXXXX

