--------------------------------------------------------------------------------------------------------------------------------------------------------------------------------------------------------
--------------------------------------------------------------------------------------------------------------------------------------------------------------------------------------------------------
--------------------------------------------------------------------------------------------------------------------------------------------------------------------------------------------------------
--------------------------------------------------------------------------------------------------------------------------------------------------------------------------------------------------------
--------------------------------------------------------------------------------------------------------------------------------------------------------------------------------------------------------
--------------------------------------------------------------------------------------------------------------------------------------------------------------------------------------------------------
--------------------------------------------------------------------------------------------------------------------------------------------------------------------------------------------------------
--------------------------------------------------------------------------------------------------------------------------------------------------------------------------------------------------------
--------------------------------------------------------------------------------------------------------------------------------------------------------------------------------------------------------
--------------------------------------------------------------------------------------------------------------------------------------------------------------------------------------------------------
--------------------------------------------------------------------------------------------------------------------------------------------------------------------------------------------------------
--------------------------------------------------------------------------------------------------------------------------------------------------------------------------------------------------------
-------------------------------------------------------SooooSo-------------------oooSoSoo-------------------------------------------------ooo-------------------------------------------ooooooo---------
--------------------------------------oooo--------------------------------------------------------------------------------------------------------------------------------------------------------------
-------------------------------------------------------ooooo------------------------ooo-----------------ooSoSS---ooSo-----ooooo---------ooooo-------oo---ooo----------------------------oooooo------Soo-
-------------------------------------ooo--------ooo--------ygg---------oSoooooo---rr---------------------------------------------oSooo--Rk----k--k-------------------ooooooo--oooo----------yY----------
---------------------------ooooooo---kyk-y----G----k-XXXXXXXXXXX----------------XXXXXXXXXXX-oooooo------ooooooo----------oooo----------XXXXXXXXXXXXXXXX-oo----------------------------XXXXXXXXXX-ooo----
---------------------oo------R---g-XXXXXXXXXXXXXXXXXXXXXXXXXXXXX--------oooo----XXXXXXXXXXX---K--------------kk----g-k------k-y---oo---XXXXXXXXXXXXXXXX-K---Y--------oooo------oo---XXXXXXXXXXXX--r-----
--------------------------XXXXXXXXXXXXXXXXXXXXXXXXXXXXXXXXXXXXXXXX----yY-rk-----XXXXXXXXXXXXXXXXXXXX---XXXXXXXXXXXXXXXXXXXXXXXXX--r----XXXXXXXXXXXXXXXXXXXXXXX------r-rk-------r----XXXXXXXXXXXXXXXXXXXX
XXXXXXXXXXXXXXXXXXXXXXXXXXXXXXXXXXXXXXXXXXXXXXXXXXXXXXXXXXXXXXXXXXXXXXXXXXXXXXXXXXXXXXXXXXXXXXXXXXXXXXXXXXXXXXXXXXXXXXXXXXXXXXXXXXXXXXXXXXXXXXXXXXXXXXXXXXXXXXXXXXXXXXXXXXXXXXXXXXXXXXXXXXXXXXXXXXXXXXXX

