--------------------------------------------------------------------------------------------------------------------------------------------------------------------------------------------------------
--------------------------------------------------------------------------------------------------------------------------------------------------------------------------------------------------------
--------------------------------------------------------------------------------------------------------------------------------------------------------------------------------------------------------
--------------------------------------------------------------------------------------------------------------------------------------------------------------------------------------------------------
--------------------------------------------------------------------------------------------------------------------------------------------------------------------------------------------------------
--------------------------------------------------------------------------------------------------------------------------------------------------------------------------------------------------------
--------------------------------------------------------------------------------------------------------------------------------------------------------------------------------------------------------
--------------------------------------------------------------------------------------------------------------------------------------------------------------------------------------------------------
--------------------------------------------------------------------------------------------------------------------------------------------------------------------------------------------------------
--------------------------------------------------------------------------------------------------------------------------------------------------------------------------------------------------------
--------------------------------------------------------------------------------------------------------------------------------------------------------------------------------------------------------
--------------------------------------------------------------------------------------------------------------------------------------------------------------------------------------------------------
---------------SoSooSo-----------------ooooSo---------------------------------------SoS---------------------------------------------oSoSoSo-------------------------------------------------------------
-----------------------------------------------------------------------ooSo-----------------------------------------------------------------------------------------------------------------------------
---------------ooooooo-----------------oooo----------------------------------------ooooo-------------------ooooo-----------------------ooooo----Soo-----------------------------------------------------
--------------G------yy--ooooooo---------y--ky------------------oSo----ooo----------------------------------y---gg--oSooooo-------------Yk-k------------oSooo-------------------------------------------
-------------XXXXXXXXXXX-----------XXXXXXXXXXXX------------XXXX--------g---------XXXXXXXXXX--g-k----------XXXXXXXXX----------XX----XXXXXXXXXX-oooo----------------------------------------------ooo-----
-------------XXXXXXXXXXX--oooooooo-XXXXXXXXXXXX--------ooo-XXXX---oo--XXXXXXX----XXXXXXXXXXXXXXXX---------XXXXXXXXX--ooooooo-XX----XXXXXXXXXX---y-g-----ooooo-----------XXXXXXXXX--------oo----ryy------
XXXXXXXXXXXXXXXXXXXXXXXX----yGygr--XXXXXXXXXXXX--------kr--XXXX--ryg--XXXXXXXXXXXXXXXXXXXXXXXXXXXXXXXXXXXXXXXXXXXXX---r----g-XXXXXXXXXXXXXXXXXXXXXXX-RG-ygR---XXXXXXX---XXXXXXXXX------R-k---XXXXXXX----
XXXXXXXXXXXXXXXXXXXXXXXXXXXXXXXXXXXXXXXXXXXXXXXXXXXXXXXXXXXXXXXXXXXXXXXXXXXXXXXXXXXXXXXXXXXXXXXXXXXXXXXXXXXXXXXXXXXXXXXXXXXXXXXXXXXXXXXXXXXXXXXXXXXXXXXXXXXXXXXXXXXXXXXXXXXXXXXXXXXXXXXXXXXXXXXXXXXXXXXX

