--------------------------------------------------------------------------------------------------------------------------------------------------------------------------------------------------------
--------------------------------------------------------------------------------------------------------------------------------------------------------------------------------------------------------
--------------------------------------------------------------------------------------------------------------------------------------------------------------------------------------------------------
--------------------------------------------------------------------------------------------------------------------------------------------------------------------------------------------------------
--------------------------------------------------------------------------------------------------------------------------------------------------------------------------------------------------------
--------------------------------------------------------------------------------------------------------------------------------------------------------------------------------------------------------
--------------------------------------------------------------------------------------------------------------------------------------------------------------------------------------------------------
--------------------------------------------------------------------------------------------------------------------------------------------------------------------------------------------------------
--------------------------------------------------------------------------------------------------------------------------------------------------------------------------------------------------------
--------------------------------------------------------------------------------------------------------------------------------------------------------------------------------------------------------
--------------------------------------------------------------------------------------------------------------------------------------------------------------------------------------------------------
--------------------------------------------------------------------------------------------------------------------------------------------------------------------------------------------------------
------------------------------------------------------------------------------------oooSSoS-------------------------------------------------------------------------------------------------------------
--------------------------------------------------------------------------oSoSoooo----------------------Soo---------------oSoSo-----ooSo-----------------oSoo-------------------------oSo---------------
-------------------------------------oSooo---------------------------------------------oo-------oSS------------------------------------------------------------ooo--------------------------------SSSo--
----------------------ooSoooo--------------------SoSSo--oooo----------------oooooo----R-----------------oooo-------*----oooooo-----------------ooSooooo-----------------------------oooo----------------
XXXXXXXXXXXX----XX-------------------ooooooo--------------K--XXXXX------------G----XXXXXXXXXX----------K-----------*----g-ky--g-------k--XXXXX------------yg-----------oooo--------g-------XXXXX---oooo-
XXXXXXXXXXXX----XX---ooooooooo-----ygK---y-----ooooooo-XXXXXXXXXXX-------XXXXXXXXXXXXXXXXXXXX--------XXXXXXXXXX----*--XXXXXXXXXX--XXXXXXXXXXXX--oooo----XXXXXX----y--K---y--------XXXXXXXXXXXXXX----y---
XXXXXXXXXXXX----XX-------------XXXXXXXXXXXXXX-Y---rYG--XXXXXXXXXXX----XXXXXXXXXXXXXXXXXXXXXXXXXXXXXXXXXXXXXXXXXXXXXXXXXXXXXXXXXXXXXXXXXXXXXXXX-------G--XXXXXXXXXXXXXXXXXXXXXXXXXXXXXXXXXXXXXXXXXXXXXXXX
XXXXXXXXXXXXXXXXXXXXXXXXXXXXXXXXXXXXXXXXXXXXXXXXXXXXXXXXXXXXXXXXXXXXXXXXXXXXXXXXXXXXXXXXXXXXXXXXXXXXXXXXXXXXXXXXXXXXXXXXXXXXXXXXXXXXXXXXXXXXXXXXXXXXXXXXXXXXXXXXXXXXXXXXXXXXXXXXXXXXXXXXXXXXXXXXXXXXXXXX

