--------------------------------------------------------------------------------------------------------------------------------------------------------------------------------------------------------
--------------------------------------------------------------------------------------------------------------------------------------------------------------------------------------------------------
--------------------------------------------------------------------------------------------------------------------------------------------------------------------------------------------------------
--------------------------------------------------------------------------------------------------------------------------------------------------------------------------------------------------------
--------------------------------------------------------------------------------------------------------------------------------------------------------------------------------------------------------
--------------------------------------------------------------------------------------------------------------------------------------------------------------------------------------------------------
--------------------------------------------------------------------------------------------------------------------------------------------------------------------------------------------------------
--------------------------------------------------------------------------------------------------------------------------------------------------------------------------------------------------------
--------------------------------------------------------------------------------------------------------------------------------------------------------------------------------------------------------
--------------------------------------------------------------------------------------------------------------------------------------------------------------------------------------------------------
--------------------------------------------------------------------------------------------------------------------------------------------------------------------------------------------------------
--------------------------------------------------------------------------------------------------------------------------------------------------------------------------------------------------------
-------------ooSooo----ooo----------------------------------------------------------------SSoo-------------------------------------------------------------------------------------------oooo-----------
--------------------------------------------------------------------------------------------------------------------------------------------------------------------oSo---------------------------------
-------------oooooo--------------------------------------------------------------oooo-----ooo-----------------------------------------------oSo------------oooo---------------ooSSoooo--ooooooo---------
-------------Rkr-----g---r-----------ooo-------------------------------------------y----------r----------------------------------------------------------------------ooo-----------------k-r------------
XXXXXXXXXXXXXXXXXXXXXXXXXXX---XXXX-------------------------------XXXXXXXX------XXXXXXXXXXXXXXXXX-oo--------------------XXXXXXXX-----------oo-------------ooooooooo---ygk---------oo----XXXXXXXXX--------
XXXXXXXXXXXXXXXXXXXXXXXXXXX---XXXX-ooooo-------------------------XXXXXXXX------XXXXXXXXXXXXXXXXX--kK---XXXXX-----------XXXXXXXX------ooo-----G-------------kg---r--XXXXXXX-------gY-yy-XXXXXXXXX--------
XXXXXXXXXXXXXXXXXXXXXXXXXXX---XXXX--------XXXX-K-----Y-----------XXXXXXXX----g-XXXXXXXXXXXXXXXXXXXXXXXXXXXXX-----------XXXXXXXXXXX---r-y-XXXXXXX--XX----XXXXXXXXXXXXXXXXXX---XXXXXXXXXXXXXXXXXXX--------
XXXXXXXXXXXXXXXXXXXXXXXXXXXXXXXXXXXXXXXXXXXXXXXXXXXXXXXXXXXXXXXXXXXXXXXXXXXXXXXXXXXXXXXXXXXXXXXXXXXXXXXXXXXXXXXXXXXXXXXXXXXXXXXXXXXXXXXXXXXXXXXXXXXXXXXXXXXXXXXXXXXXXXXXXXXXXXXXXXXXXXXXXXXXXXXXXXXXXXXX

