--------------------------------------------------------------------------------------------------------------------------------------------------------------------------------------------------------
--------------------------------------------------------------------------------------------------------------------------------------------------------------------------------------------------------
--------------------------------------------------------------------------------------------------------------------------------------------------------------------------------------------------------
--------------------------------------------------------------------------------------------------------------------------------------------------------------------------------------------------------
--------------------------------------------------------------------------------------------------------------------------------------------------------------------------------------------------------
--------------------------------------------------------------------------------------------------------------------------------------------------------------------------------------------------------
--------------------------------------------------------------------------------------------------------------------------------------------------------------------------------------------------------
--------------------------------------------------------------------------------------------------------------------------------------------------------------------------------------------------------
--------------------------------------------------------------------------------------------------------------------------------------------------------------------------------------------------------
--------------------------------------------------------------------------------------------------------------------------------------------------------------------------------------------------------
--------------------------------------------------------------------------------------------------------------------------------------------------------------------------------------------------------
--------------------------------------------------------------------------------------------------------------------------------------------------------------------------------------------------------
----------------------------------------SSoooo------------------------------------------------------------------------------------------------------oooSo-----------------------------------------------
------------------------------------------------------ooooo------oSooSoS-------------------oSSo-----------------------oSooooS------ooo----------------------------------------------------oSooooo-------
--------------oSoo---------------------oooo----------------------------------------------------------ooS-------------------------------------oo------------------------Soo------------------------------
-------------------------oooo-----rY------g-------------oooo-------ooo-----------------------oo------------oSoooS--------ooooo----ooooo------yy-------R-Gy-----------------------------------oooo-------
-------------------------------XXXXXXXXXXXXXXXX--------r-y--r------r--r---XXX--------XXXXX-------k---ooo--------------gr-R--y----r----------XXXXXXXXXXXXXXX---------ooooo------------------YY-----------
-------------yY--k----oooooo---XXXXXXXXXXXXXXXX------XXXXXXXXXXXXXXXXXXXXXXXXXXXXXXXXXXXXXXXXXXXXXX-Y-------ooooo----XXXXXXXXXXXXXXXXXXXXXXXXXXXXXXXXXXXXXXXXXXXXXX------k------oo-------XXXXXXXXXXXXXXX
-----------XXXXXXXXXX---r------XXXXXXXXXXXXXXXX--XXXXXXXXXXXXXXXXXXXXXXXXXXXXXXXXXXXXXXXXXXXXXXXXXXXXXXXXX-K--yK-----XXXXXXXXXXXXXXXXXXXXXXXXXXXXXXXXXXXXXXXXXXXXXXXXXXXXXXXX--R-k--XX---XXXXXXXXXXXXXXX
XXXXXXXXXXXXXXXXXXXXXXXXXXXXXXXXXXXXXXXXXXXXXXXXXXXXXXXXXXXXXXXXXXXXXXXXXXXXXXXXXXXXXXXXXXXXXXXXXXXXXXXXXXXXXXXXXXXXXXXXXXXXXXXXXXXXXXXXXXXXXXXXXXXXXXXXXXXXXXXXXXXXXXXXXXXXXXXXXXXXXXXXXXXXXXXXXXXXXXXX

