--------------------------------------------------------------------------------------------------------------------------------------------------------------------------------------------------------
--------------------------------------------------------------------------------------------------------------------------------------------------------------------------------------------------------
--------------------------------------------------------------------------------------------------------------------------------------------------------------------------------------------------------
--------------------------------------------------------------------------------------------------------------------------------------------------------------------------------------------------------
--------------------------------------------------------------------------------------------------------------------------------------------------------------------------------------------------------
--------------------------------------------------------------------------------------------------------------------------------------------------------------------------------------------------------
--------------------------------------------------------------------------------------------------------------------------------------------------------------------------------------------------------
--------------------------------------------------------------------------------------------------------------------------------------------------------------------------------------------------------
--------------------------------------------------------------------------------------------------------------------------------------------------------------------------------------------------------
--------------------------------------------------------------------------------------------------------------------------------------------------------------------------------------------------------
--------------------------------------------------------------------------------------------------------------------------------------------------------------------------------------------------------
--------------------------------------------------------------------------------------------------------------------------------------------------------------------------------------------------------
-------------------------------ooo-----------ooooSoo----------------------------------------------------------------------------------------------------------------------------------------------------
--------------oooSoo---------------------------------------------------------------------------oSoooooo-----oooSoo---------------------------------------------------oooSooSo---------------------------
-------------------------------ooooo----------ooo-----oooooooSo----------SoSoo----------------------------------------------------------------oSoS------------------------------------------------------
--------------oooooooo---------K----r--------r--k--r-----------------------------ooooo---------oooooo------ooooo----oooooooSo----------------------------------------oooooo-----------------------------
XXXXXXXXXXXXX--g--------XXXXXXXXXXXXXX-----XXXXXXXXXX----ooo----------oooooooo-----k-g-XXXXXXX-g------r--GK--r-y--------------------------------------r---------XXX---Yg--------------------------oo----
XXXXXXXXXXXXXXXXXXXXXXXXXXXXXXXXXXXXXX-----XXXXXXXXXX-------------------K-R--r-XXXXXXXXXXXXXXXXXXXXXXXXXXXXXXXXXXXX-ooooooooo-XXX-Gry-g-XXX---R------XXXXXXXXXXXXXXXXXXXXXXXXX----oo----ooooo-------Y---
XXXXXXXXXXXXXXXXXXXXXXXXXXXXXXXXXXXXXXXXXXXXXXXXXXXXXXXXXXXXXXXX-----XXXXXXXXXXXXXXXXXXXXXXXXXXXXXXXXXXXXXXXXXXXXXX-----------XXXXXXXXXXXXX--XXXXXXXXXXXXXXXXXXXXXXXXXXXXXXXXXXX-gk-------gK-----XXXXXXX
XXXXXXXXXXXXXXXXXXXXXXXXXXXXXXXXXXXXXXXXXXXXXXXXXXXXXXXXXXXXXXXXXXXXXXXXXXXXXXXXXXXXXXXXXXXXXXXXXXXXXXXXXXXXXXXXXXXXXXXXXXXXXXXXXXXXXXXXXXXXXXXXXXXXXXXXXXXXXXXXXXXXXXXXXXXXXXXXXXXXXXXXXXXXXXXXXXXXXXXX

