--------------------------------------------------------------------------------------------------------------------------------------------------------------------------------------------------------
--------------------------------------------------------------------------------------------------------------------------------------------------------------------------------------------------------
--------------------------------------------------------------------------------------------------------------------------------------------------------------------------------------------------------
--------------------------------------------------------------------------------------------------------------------------------------------------------------------------------------------------------
--------------------------------------------------------------------------------------------------------------------------------------------------------------------------------------------------------
--------------------------------------------------------------------------------------------------------------------------------------------------------------------------------------------------------
--------------------------------------------------------------------------------------------------------------------------------------------------------------------------------------------------------
--------------------------------------------------------------------------------------------------------------------------------------------------------------------------------------------------------
--------------------------------------------------------------------------------------------------------------------------------------------------------------------------------------------------------
--------------------------------------------------------------------------------------------------------------------------------------------------------------------------------------------------------
--------------------------------------------------------------------------------------------------------------------------------------------------------------------------------------------------------
--------------------------------------------------------------------------------------------------------------------------------------------------------------------------------------------------------
--------------------------SoS------------oSo------------------------------------------------------------------------------------------------------------------------------------------------------------
-------------------------------------------------------------------oooo---------------------------------------------------------------------------------------------------------------------------------
-----------------------oooooooo-----------------------------------------------------oooooo--------------------------------------------------------------------------------------------------------------
----------------ooo-----Yr-K--------------R-g-----rg---------------oooo-----------------------oooo------------SSSo----------------------oSSSooo---------------oooo--------------------------------------
----------------------XXXXXXXXXX--------XXXXXXXXXXXXXXX-oooo----------g-------------------------------XXXX-----------XX---XXXXXXXXXX-----------------oooo--------------Tt--Tt-----------------XXXXXX----
----------------oo----XXXXXXXXXX--------XXXXXXXXXXXXXXX---y-g-----XXXXXX-----ooooo---Ryk--g--------XXXXXXX--oooooo---XX---XXXXXXXXXXXXX-ooooo----XX-g--k------ooooo----Tt--Tt-----------R-----XXXXXX----
----------------Rk----XXXXXXXXXX----XXXXXXXXXXXXXXXXXXXXXXXXXXXXXXXXXXXXXXX-y---Yr-XXXXXXXXX---Yg--XXXXXXX---y-K-r-g-XX---XXXXXXXXXXXXX------K---XXXXXXXXXX--r---------Tt--Tt---------XXXXXXXXXXXXXX----
XXXXXXXXXXXXXXXXXXXXXXXXXXXXXXXXXXXXXXXXXXXXXXXXXXXXXXXXXXXXXXXXXXXXXXXXXXXXXXXXXXXXXXXXXXXXXXXXXXXXXXXXXXXXXXXXXXXXXXXXXXXXXXXXXXXXXXXXXXXXXXXXXXXXXXXXXXXXXXXXXXXXXXXXXXXXXXXXXXXXXXXXXXXXXXXXXXXXXXXX

