--------------------------------------------------------------------------------------------------------------------------------------------------------------------------------------------------------
--------------------------------------------------------------------------------------------------------------------------------------------------------------------------------------------------------
--------------------------------------------------------------------------------------------------------------------------------------------------------------------------------------------------------
--------------------------------------------------------------------------------------------------------------------------------------------------------------------------------------------------------
--------------------------------------------------------------------------------------------------------------------------------------------------------------------------------------------------------
--------------------------------------------------------------------------------------------------------------------------------------------------------------------------------------------------------
--------------------------------------------------------------------------------------------------------------------------------------------------------------------------------------------------------
--------------------------------------------------------------------------------------------------------------------------------------------------------------------------------------------------------
--------------------------------------------------------------------------------------------------------------------------------------------------------------------------------------------------------
--------------------------------------------------------------------------------------------------------------------------------------------------------------------------------------------------------
--------------------------------------------------------------------------------------------------------------------------------------------------------------------------------------------------------
--------------------------------------------------------------------------------------------------------------------------------------------------------------------------------------------------------
--------------------------------------------------------Soooo----------------------------------oooooo-----------ooSooo----------------ooo----------oSoSooo---------ooooo---oooo-------------------------
-------------------------------------------------------------------------------------ooooSSSo-----------------------------------------------------------------------------------------------------------
--------------------------------------------------------ooooo-----------oo---------------------ooooo-------------oooo---------------ooooo----------ooooo--------------------ooooo--------------oooo-----
---------------------------------------------------------G------------kr-r-----oSo-----oooo------k---G----ooo--y-y---YG-------------r---G----------k-Y-r-----oSo-----r--------G-------------------------
----------XXXXXXX--------XX----ooooo----oo----oo----XXXXXXXXXX------XXXXXXXXX-------------K-r-XXXXXXXXX-------XXXXXXXXXX-r-y-------XXXXXXXX-------XXXXXXXXX------XXXXXXXXXXXXXXXXXX------kr-y---ooooo---
XXXXXXXXXXXXXXXXX--------XX----G--k-----r------y-k--XXXXXXXXXX--y---XXXXXXXXX---ooo-XXXXXXXXXXXXXXXXXXX-oo----XXXXXXXXXXXXXXXX-----XXXXXXXX-------XXXXXXXXX------XXXXXXXXXXXXXXXXXX-----XXXXXX--r---Gg-X
XXXXXXXXXXXXXXXXX---Y--r-XXXXXXXXXXXXXXXXXX--XXXXXXXXXXXXXXXXXXXXXXXXXXXXXXXX-----Y-XXXXXXXXXXXXXXXXXXX--g--Y-XXXXXXXXXXXXXXXX-----XXXXXXXXXXX----XXXXXXXXX--Y---XXXXXXXXXXXXXXXXXX-----XXXXXXXXXXXXXXXX
XXXXXXXXXXXXXXXXXXXXXXXXXXXXXXXXXXXXXXXXXXXXXXXXXXXXXXXXXXXXXXXXXXXXXXXXXXXXXXXXXXXXXXXXXXXXXXXXXXXXXXXXXXXXXXXXXXXXXXXXXXXXXXXXXXXXXXXXXXXXXXXXXXXXXXXXXXXXXXXXXXXXXXXXXXXXXXXXXXXXXXXXXXXXXXXXXXXXXXXX

