--------------------------------------------------------------------------------------------------------------------------------------------------------------------------------------------------------
--------------------------------------------------------------------------------------------------------------------------------------------------------------------------------------------------------
--------------------------------------------------------------------------------------------------------------------------------------------------------------------------------------------------------
--------------------------------------------------------------------------------------------------------------------------------------------------------------------------------------------------------
--------------------------------------------------------------------------------------------------------------------------------------------------------------------------------------------------------
--------------------------------------------------------------------------------------------------------------------------------------------------------------------------------------------------------
--------------------------------------------------------------------------------------------------------------------------------------------------------------------------------------------------------
--------------------------------------------------------------------------------------------------------------------------------------------------------------------------------------------------------
--------------------------------------------------------------------------------------------------------------------------------------------------------------------------------------------------------
--------------------------------------------------------------------------------------------------------------------------------------------------------------------------------------------------------
--------------------------------------------------------------------------------------------------------------------------------------------------------------------------------------------------------
--------------------------------------------------------------------------------------------------------------------------------------------------------------------------------------------------------
----------------------------------------------oooooSooo-----------------------------------------------------------------oSooS---------------------------------------------------------------------------
----------------------------------------------------------------SoooSo------------------------------------------------------------------------------------------------------oSSoo-----------------------
-----------------------------Soo---ooooooSo------ooo------------------------------------------------------SoSo-----------oooooo---------------------------------------oo--------------------------------
------------------------------------------------kG---------------ooooooo-------ooooo---------oSoo--------------------Y-----k---g---------------Soo---------------------Y---oooooo-------SSoo----r-------
XXXXXXXXXXXXX----------XX--oooooo----oooooo--XXXXXXXXXXX--oo----g--y-G---XXXXX-y--r----------------------------XXXXXXXXXXXXXXXXXX----------------------------------XXXXXXX-r--y----------------XXXXXX---
XXXXXXXXXXXXX---kGy----XX------------kk------XXXXXXXXXXX------XXXXXXXXXXXXXXXXXXXXXXXX--------oo--------g--kG--XXXXXXXXXXXXXXXXXX-----R-------oooo-----------------XXXXXXXXXXXXXXXXXX---oooo---XXXXXX--X
XXXXXXXXXXXXXXXXXXXXX--XXXXXXXXXXXXXXXXXXXXXXXXXXXXXXXXXXXXXXXXXXXXXXXXXXXXXXXXXXXXXXX----------Y------XXXXXXXXXXXXXXXXXXXXXXXXXX---XXXXXXX---rR-------g--r-XXXXXXXXXXXXXXXXXXXXXXXXX-----R----XXXXXX--X
XXXXXXXXXXXXXXXXXXXXXXXXXXXXXXXXXXXXXXXXXXXXXXXXXXXXXXXXXXXXXXXXXXXXXXXXXXXXXXXXXXXXXXXXXXXXXXXXXXXXXXXXXXXXXXXXXXXXXXXXXXXXXXXXXXXXXXXXXXXXXXXXXXXXXXXXXXXXXXXXXXXXXXXXXXXXXXXXXXXXXXXXXXXXXXXXXXXXXXXX

