--------------------------------------------------------------------------------------------------------------------------------------------------------------------------------------------------------
--------------------------------------------------------------------------------------------------------------------------------------------------------------------------------------------------------
--------------------------------------------------------------------------------------------------------------------------------------------------------------------------------------------------------
--------------------------------------------------------------------------------------------------------------------------------------------------------------------------------------------------------
--------------------------------------------------------------------------------------------------------------------------------------------------------------------------------------------------------
--------------------------------------------------------------------------------------------------------------------------------------------------------------------------------------------------------
--------------------------------------------------------------------------------------------------------------------------------------------------------------------------------------------------------
--------------------------------------------------------------------------------------------------------------------------------------------------------------------------------------------------------
--------------------------------------------------------------------------------------------------------------------------------------------------------------------------------------------------------
--------------------------------------------------------------------------------------------------------------------------------------------------------------------------------------------------------
--------------------------------------------------------------------------------------------------------------------------------------------------------------------------------------------------------
--------------------------------------------------------------------------------------------------------------------------------------------------------------------------------------------------------
-----------------------------oSSoo-------------------------------------------ooooSoo--------oooSooSo----------------------------------------------------------------------------------------------------
------------------------------------ooS-----------------------oooo-------------------------------------------------oSooSo-------------------------------------------------------------------oSSooo------
----------------------------oooo---------------------------------------------ooooooo---------ooooo---------------------------------------------------------------------SSoSSo---------------------------
-----------------------Soo----y--------oo------------------ooooooo------------y-------------G---K---------------------oooooo-------g--Y------SSooSoo---------oo----------------------Sooo----ooooo------
XXXXXXXXXXXXX--------------XXXXXXXX-k-k-k--XXXXXXXXXX---------------XXXXX---XXXXXXXXX------XXXXXXXXXX---------------YRg----------XXXXXXXX-------------Ry----k-y--------ooooooo---------------K--r-------
XXXXXXXXXXXXX----XX-oooooo-XXXXXXXXXXXXXXXXXXXXXXXXXXXXXXXXXXXXXXXXXXXXXXXXXXXXXXXXXX------XXXXXXXXXX---XX-----XXXXXXXXXXXXXX----XXXXXXXX----ooooo---XXXXXXXXXXXX------r---Rr-g-------oo---XXXXXXXX-----
XXXXXXXXXXXXXXXXXXX----gK--XXXXXXXXXXXXXXXXXXXXXXXXXXXXXXXXXXXXXXXXXXXXXXXXXXXXXXXXXX--y---XXXXXXXXXXXXXXXXXXXXXXXXXXXXXXXXXX----XXXXXXXX------------XXXXXXXXXXXXXXXXXXXXXXXXXXXXX--k---kY-XXXXXXXX---XX
XXXXXXXXXXXXXXXXXXXXXXXXXXXXXXXXXXXXXXXXXXXXXXXXXXXXXXXXXXXXXXXXXXXXXXXXXXXXXXXXXXXXXXXXXXXXXXXXXXXXXXXXXXXXXXXXXXXXXXXXXXXXXXXXXXXXXXXXXXXXXXXXXXXXXXXXXXXXXXXXXXXXXXXXXXXXXXXXXXXXXXXXXXXXXXXXXXXXXXXX

