--------------------------------------------------------------------------------------------------------------------------------------------------------------------------------------------------------
--------------------------------------------------------------------------------------------------------------------------------------------------------------------------------------------------------
--------------------------------------------------------------------------------------------------------------------------------------------------------------------------------------------------------
--------------------------------------------------------------------------------------------------------------------------------------------------------------------------------------------------------
--------------------------------------------------------------------------------------------------------------------------------------------------------------------------------------------------------
--------------------------------------------------------------------------------------------------------------------------------------------------------------------------------------------------------
--------------------------------------------------------------------------------------------------------------------------------------------------------------------------------------------------------
--------------------------------------------------------------------------------------------------------------------------------------------------------------------------------------------------------
--------------------------------------------------------------------------------------------------------------------------------------------------------------------------------------------------------
--------------------------------------------------------------------------------------------------------------------------------------------------------------------------------------------------------
--------------------------------------------------------------------------------------------------------------------------------------------------------------------------------------------------------
--------------------------------------------------------------------------------------------------------------------------------------------------------------------------------------------------------
------------------------------------------------------------------------------------------------------------------------------------------------------------------------------oooo----------------------
--------------------------------------------------------------------ooSoSoo-----------------------------------------------------------------------------------------------------------------------------
---------------------------------------------------------oSoSo------------------------------------ooSSoS------------------------SSoo------------oo--------oSSooo---------------oooo---------------------
-----------------------------ooooS--------ooo---ooSSo------------------ooooo-------------SSoS---------------------Sooo------------------------rY------------------------------Yyr-k--------ooS----------
------------------ooo---XXXX----------------g----------oooo---------Ky---k-k-------------------------ooooo---------------XXX---ooo-----------XXXXXXXXXXXX----ooo-----oooooo--XXXXXXX------------XXXXX---
------------oo-------g--XXXX--ooooo-----XXXXXXX---ooo-------G--XXXXXXXXXXXXXXX---XXXXX----oooooo------g----------oooo----XXX-------R-------XXXXXXXXXXXXXX---g-----y--yG---G--XXXXXXXXXXX----oo--XXXXX---
------------y----XXXXXXXXXXX-rG-G-kyy---XXXXXXX-r-----XXXXXXXXXXXXXXXXXXXXXXXX---XXXXX-r-Yr----r-XXXXXXXXXXX---rR---k----XXXXXXXXXXXX--y---XXXXXXXXXXXXXXXXXXXXXXXXXXXXXXXXXXXXXXXXXXXXX------y-XXXXXXXX
XXXXXXXXXXXXXXXXXXXXXXXXXXXXXXXXXXXXXXXXXXXXXXXXXXXXXXXXXXXXXXXXXXXXXXXXXXXXXXXXXXXXXXXXXXXXXXXXXXXXXXXXXXXXXXXXXXXXXXXXXXXXXXXXXXXXXXXXXXXXXXXXXXXXXXXXXXXXXXXXXXXXXXXXXXXXXXXXXXXXXXXXXXXXXXXXXXXXXXXX

