--------------------------------------------------------------------------------------------------------------------------------------------------------------------------------------------------------
--------------------------------------------------------------------------------------------------------------------------------------------------------------------------------------------------------
--------------------------------------------------------------------------------------------------------------------------------------------------------------------------------------------------------
--------------------------------------------------------------------------------------------------------------------------------------------------------------------------------------------------------
--------------------------------------------------------------------------------------------------------------------------------------------------------------------------------------------------------
--------------------------------------------------------------------------------------------------------------------------------------------------------------------------------------------------------
--------------------------------------------------------------------------------------------------------------------------------------------------------------------------------------------------------
--------------------------------------------------------------------------------------------------------------------------------------------------------------------------------------------------------
--------------------------------------------------------------------------------------------------------------------------------------------------------------------------------------------------------
--------------------------------------------------------------------------------------------------------------------------------------------------------------------------------------------------------
--------------------------------------------------------------------------------------------------------------------------------------------------------------------------------------------------------
--------------------------------------------------------------------------------------------------------------------------------------------------------------------------------------------------------
-----------------------------------------------------------------------------------------------------------------------------------ooS------------------------------------------------------------------
------------------------------------------------------------------------------------------------------------------SSo--------------------------------------ooSoo-----------------SSo--------------------
-------------------------------------------------------------------ooooo-------------------------------------------------------------------------------------------------------------------------oSooo--
-----------------------------------oSSooo---------oo-----------------------------------------------------k-------oo-----------------g-r--------------------ooo---------ooSoS----ooo-----SoS-------------
----------------ooooo---------------------------k--Y---------------ooo----Rry--------------------------XXXXXXXX-kr--y-XXXX--oooo--XXXXXXXXXXXXXXXX--------r------XXX-----------kk-k--------------ooo----
---------------y-y---------kk-y---oooooooo-----XXXXXX---ooooo---Y---GKr--XXXXXX------------------------XXXXXXXXXXXXXXXXXXX-Y---k--XXXXXXXXXXXXXXXX--oooo-XXXXXXXXXXXXX-ooo----XXXXXXX---oo------rgg-----
--------------XXXXXXXX----XXXXXXX--y-------XXXXXXXXXX-g----y---XXXXXXXXXXXXXXXX--Y------Gk-Y-XXXXXXXXXXXXXXXXXXXXXXXXXXXXXXXXXXXXXXXXXXXXXXXXXXXXX----r--XXXXXXXXXXXXX--yY----XXXXXXX--YRkrR--XXXXXXXXX-
XXXXXXXXXXXXXXXXXXXXXXXXXXXXXXXXXXXXXXXXXXXXXXXXXXXXXXXXXXXXXXXXXXXXXXXXXXXXXXXXXXXXXXXXXXXXXXXXXXXXXXXXXXXXXXXXXXXXXXXXXXXXXXXXXXXXXXXXXXXXXXXXXXXXXXXXXXXXXXXXXXXXXXXXXXXXXXXXXXXXXXXXXXXXXXXXXXXXXXXX

