--------------------------------------------------------------------------------------------------------------------------------------------------------------------------------------------------------
--------------------------------------------------------------------------------------------------------------------------------------------------------------------------------------------------------
--------------------------------------------------------------------------------------------------------------------------------------------------------------------------------------------------------
--------------------------------------------------------------------------------------------------------------------------------------------------------------------------------------------------------
--------------------------------------------------------------------------------------------------------------------------------------------------------------------------------------------------------
--------------------------------------------------------------------------------------------------------------------------------------------------------------------------------------------------------
--------------------------------------------------------------------------------------------------------------------------------------------------------------------------------------------------------
--------------------------------------------------------------------------------------------------------------------------------------------------------------------------------------------------------
--------------------------------------------------------------------------------------------------------------------------------------------------------------------------------------------------------
--------------------------------------------------------------------------------------------------------------------------------------------------------------------------------------------------------
--------------------------------------------------------------------------------------------------------------------------------------------------------------------------------------------------------
--------------------------------------------------------------------------------------------------------------------------------------------------------------------------------------------------------
------------------------------------------------------------------oSSo------ooo-------------------------------oooo--------------------Sooo----------------------------------------Soo-------------------
--------------------------------------------------------------------------------------------------------------------------------------------------------------------SoSSo-------------------------------
-------------ooo----------------------ooo----------------oSSSo-----ooo------oooo--ooooo-------------------------ooooo--------ooooo----ooo------------oSoo-------------------------oo--------------------
------------k--y-----------------------k-r--ooSoo---------------r----y-y---g--------------------oSSo---oooo------------ooo---Y--------------------------------------oooooo----------y--------ooSSo------
----------XXXXXXXX--XXX----------XXXXXXXXXX------------oooooo--XXXXXXXXXXXXXXXXXXXXXXXXX--------------k-r-g-XXXXXXXXXX--K---XXXXXXXXXXXXXXX----------ooooo--------g-k--r--------XXXXXXXXXX--------------
----------XXXXXXXX--XXX----------XXXXXXXXXX---ooooo-----yY-gk--XXXXXXXXXXXXXXXXXXXXXXXXX-----ooooo---XXXXXXXXXXXXXXXXXXXXXXXXXXXXXXXXXXXXXXXXXXXXXXX--r---Y-XXXXXXXXXXXXXXX-----XXXXXXXXXX-oooo---------
XXXXXXXXXXXXXXXXXXXXXXX-r--------XXXXXXXXXX-yr-y-y-g-XXXXXXXXXXXXXXXXXXXXXXXXXXXXXXXXXXX-------------XXXXXXXXXXXXXXXXXXXXXXXXXXXXXXXXXXXXXXXXXXXXXXXXXXXXXXXXXXXXXXXXXXXXXX-----XXXXXXXXXX--Y----y-----X
XXXXXXXXXXXXXXXXXXXXXXXXXXXXXXXXXXXXXXXXXXXXXXXXXXXXXXXXXXXXXXXXXXXXXXXXXXXXXXXXXXXXXXXXXXXXXXXXXXXXXXXXXXXXXXXXXXXXXXXXXXXXXXXXXXXXXXXXXXXXXXXXXXXXXXXXXXXXXXXXXXXXXXXXXXXXXXXXXXXXXXXXXXXXXXXXXXXXXXXX

