--------------------------------------------------------------------------------------------------------------------------------------------------------------------------------------------------------
--------------------------------------------------------------------------------------------------------------------------------------------------------------------------------------------------------
--------------------------------------------------------------------------------------------------------------------------------------------------------------------------------------------------------
--------------------------------------------------------------------------------------------------------------------------------------------------------------------------------------------------------
--------------------------------------------------------------------------------------------------------------------------------------------------------------------------------------------------------
--------------------------------------------------------------------------------------------------------------------------------------------------------------------------------------------------------
--------------------------------------------------------------------------------------------------------------------------------------------------------------------------------------------------------
--------------------------------------------------------------------------------------------------------------------------------------------------------------------------------------------------------
--------------------------------------------------------------------------------------------------------------------------------------------------------------------------------------------------------
--------------------------------------------------------------------------------------------------------------------------------------------------------------------------------------------------------
--------------------------------------------------------------------------------------------------------------------------------------------------------------------------------------------------------
--------------------------------------------------------------------------------------------------------------------------------------------------------------------------------------------------------
-------------------------------------------------------------------------oooS------------------------------------------------------------------------------------------ooSS-----------------------------
--------------------------------------------------------------------------------oSoS----------------------------SSSo----oSSo----------------------------------------------------------------------------
------------------------------------------------------------------------ooooo----------------------------------------------------------------------------oooSo----------oooo----ooooSooo----------------
-------------------------oSooSoS------oooo----ooo----------------------------G----oooo------oooo---Soo------------oooo----ooo-------r------ooo--------------------------r--R---------------ooSSSoS------
XXXXXXXXXXXXX------oooo------------------------R--k------------------XXXXXXXXXX---k------y--YG-G-------------------R-k--y-G-----XXXXXXXX----------------------------XXXXXXXXX----oooooo-------------XXXX
XXXXXXXXXXXXX---G-----r--ooooooooo-----ooooo-XXXXXXX---------oo------XXXXXXXXXXXXXXXXXXXXXXXXXXXX----oo-------XXXXXXXXXXXXXXXXXXXXXXXXXX--XXXXXXX---XXXX--gY--------XXXXXXXXX---g-kK----R-----oooo--XXXX
XXXXXXXXXXXXX--XXXXXXXXX--Y---K------y-k--R--XXXXXXX-G-y-------------XXXXXXXXXXXXXXXXXXXXXXXXXXXX-----rg------XXXXXXXXXXXXXXXXXXXXXXXXXXXXXXXXXXXXXXXXXXXXXXXXXXXXXXXXXXXXXXX--XXXXXXXXXXX--ryG-----XXXX
XXXXXXXXXXXXXXXXXXXXXXXXXXXXXXXXXXXXXXXXXXXXXXXXXXXXXXXXXXXXXXXXXXXXXXXXXXXXXXXXXXXXXXXXXXXXXXXXXXXXXXXXXXXXXXXXXXXXXXXXXXXXXXXXXXXXXXXXXXXXXXXXXXXXXXXXXXXXXXXXXXXXXXXXXXXXXXXXXXXXXXXXXXXXXXXXXXXXXXXX

