--------------------------------------------------------------------------------------------------------------------------------------------------------------------------------------------------------
--------------------------------------------------------------------------------------------------------------------------------------------------------------------------------------------------------
--------------------------------------------------------------------------------------------------------------------------------------------------------------------------------------------------------
--------------------------------------------------------------------------------------------------------------------------------------------------------------------------------------------------------
--------------------------------------------------------------------------------------------------------------------------------------------------------------------------------------------------------
--------------------------------------------------------------------------------------------------------------------------------------------------------------------------------------------------------
--------------------------------------------------------------------------------------------------------------------------------------------------------------------------------------------------------
--------------------------------------------------------------------------------------------------------------------------------------------------------------------------------------------------------
--------------------------------------------------------------------------------------------------------------------------------------------------------------------------------------------------------
--------------------------------------------------------------------------------------------------------------------------------------------------------------------------------------------------------
--------------------------------------------------------------------------------------------------------------------------------------------------------------------------------------------------------
--------------------------------------------------------------------------------------------------------------------------------------------------------------------------------------------------------
-----------------------------------------------------------------------------oooooS--------------------------SSoSooo------------------------------------------------------------------------------------
--------------------------------------------------oooooooo-----------------------------------------------------------------------------ooooooooo--------------------------------------------------------
-----------------------oooSoo----ooo-------------------------oooo-------------ooooooo-----------------ooo--ooooooooo------------------------------------------------------SSoSo-------------------------
--------------oSoo--------------------------------oooooooo---------ooSoS-----G---y-k------SSo---------------kgk-r-g-----------------------oooo------------------*---------------------------------------
----------------------ooooooo-XXXXXXX-ooo----------g-k--rg-XXXXXXX----------XXXXXXXXXX---------------oo---XXXXXXXXXXX----------XXXXXXX--Gyk-----------XX---XX---*----*-----oo---------------------------
XXXXXXXXXXX---ooo----g---y----XXXXXXX---g---XXXXXXXXXXXXXXXXXXXXXX-oooooo---XXXXXXXXXX---ooooo---------K--XXXXXXXXXXXXXXXXXXX--XXXXXXXXXXXXXXXXXXXXXXXXX---XXXXXXXXXXXXX---y------oooo---oo-------------
XXXXXXXXXXX-------R-XXXXXXXXXXXXXXXXXXXXXXXXXXXXXXXXXXXXXXXXXXXXXX---g--k-k-XXXXXXXXXX---r------XXXXXXXXXXXXXXXXXXXXXXXXXXXXXXXXXXXXXXXXXXXXXXXXXXXXXXXX---XXXXXXXXXXXXXXXXXXXXX-g------y----XXXXXXXXXXX
XXXXXXXXXXXXXXXXXXXXXXXXXXXXXXXXXXXXXXXXXXXXXXXXXXXXXXXXXXXXXXXXXXXXXXXXXXXXXXXXXXXXXXXXXXXXXXXXXXXXXXXXXXXXXXXXXXXXXXXXXXXXXXXXXXXXXXXXXXXXXXXXXXXXXXXX---XXXXXXXXXXXXXXXXXXXXXXXXXXXXXXXXXXXXXXXXXXXXX

