--------------------------------------------------------------------------------------------------------------------------------------------------------------------------------------------------------
--------------------------------------------------------------------------------------------------------------------------------------------------------------------------------------------------------
--------------------------------------------------------------------------------------------------------------------------------------------------------------------------------------------------------
--------------------------------------------------------------------------------------------------------------------------------------------------------------------------------------------------------
--------------------------------------------------------------------------------------------------------------------------------------------------------------------------------------------------------
--------------------------------------------------------------------------------------------------------------------------------------------------------------------------------------------------------
--------------------------------------------------------------------------------------------------------------------------------------------------------------------------------------------------------
--------------------------------------------------------------------------------------------------------------------------------------------------------------------------------------------------------
--------------------------------------------------------------------------------------------------------------------------------------------------------------------------------------------------------
--------------------------------------------------------------------------------------------------------------------------------------------------------------------------------------------------------
--------------------------------------------------------------------------------------------------------------------------------------------------------------------------------------------------------
--------------------------------------------------------------------------------------------------------------------------------------------------------------------------------------------------------
----------------------------------------------------------------------------------------------------oooSoo----------------------------------------------------------------------------------------------
---------------------------------------Soooo--------------oSSo------------------------------------------------------------------------------------------------------------ooooS--------SSo--------------
----------------------------ooSS--------------oooo---------------------------------------------------ooooooo--oooSSS----------------------------ooo---------------ooo-----------------------------------
------------------------oo-------------ooooo--g-----------ooooo--------------------------k--r--------G--y-ry-------------------------------------g--g--oooo-----------------ooo--------ooo--------------
XXXXXXXXXXX----------r--------ooo---rYR------XXXXXX-----gr-----y--------------------yg--XXXXXXXXXXXXXXXXXXXXX-ooooooo-------------ooo--XXX-----XXXXXXX--yGk-XX--ooooooo---rY---GYg-----k-k---------oo---
XXXXXXXXXXX---------XXXXXXX-r---G--XXXXXXXXXXXXXXXX----XXXXXXXXXX--------R---oooo-XXXXXXXXXXXXXXXXXXXXXXXXXXX-ky-R-k-G----XXXXX----r-Y-XXX-----XXXXXXXXXXXXXXX----k-Y--r-XXXXXXXXXXXXXXXXXXXXXXXX-------
XXXXXXXXXXX--ky---XXXXXXXXXXXXXXXXXXXXXXXXXXXXXXXXX----XXXXXXXXXX-----XXXXXX-k--r-XXXXXXXXXXXXXXXXXXXXXXXXXXXXXXXXXXXXXXXXXXXXXXXXXXXXXXXX-----XXXXXXXXXXXXXXXXXXXXXXXXXXXXXXXXXXXXXXXXXXXXXXXXXXXXXXXXX
XXXXXXXXXXXXXXXXXXXXXXXXXXXXXXXXXXXXXXXXXXXXXXXXXXXXXXXXXXXXXXXXXXXXXXXXXXXXXXXXXXXXXXXXXXXXXXXXXXXXXXXXXXXXXXXXXXXXXXXXXXXXXXXXXXXXXXXXXXXXXXXXXXXXXXXXXXXXXXXXXXXXXXXXXXXXXXXXXXXXXXXXXXXXXXXXXXXXXXXX

