--------------------------------------------------------------------------------------------------------------------------------------------------------------------------------------------------------
--------------------------------------------------------------------------------------------------------------------------------------------------------------------------------------------------------
--------------------------------------------------------------------------------------------------------------------------------------------------------------------------------------------------------
--------------------------------------------------------------------------------------------------------------------------------------------------------------------------------------------------------
--------------------------------------------------------------------------------------------------------------------------------------------------------------------------------------------------------
--------------------------------------------------------------------------------------------------------------------------------------------------------------------------------------------------------
--------------------------------------------------------------------------------------------------------------------------------------------------------------------------------------------------------
--------------------------------------------------------------------------------------------------------------------------------------------------------------------------------------------------------
--------------------------------------------------------------------------------------------------------------------------------------------------------------------------------------------------------
--------------------------------------------------------------------------------------------------------------------------------------------------------------------------------------------------------
--------------------------------------------------------------------------------------------------------------------------------------------------------------------------------------------------------
--------------------------------------------------------------------------------------------------------------------------------------------------------------------------------------------------------
---------------ooS-----------------------------------ooS-----------------------------------oSoooS-------------------------------------------------------------------Sooo---------------ooSo-------------
---------------------------------------------------------------------SoSoooo--oooo-----------------------------oooo---------------------------------ooSoo-----------------------------------------------
---------------ooo---------------------------SoS-------------------------------------------oooooo-----ooo----------------------------------------------------------oooooo--------------oo---------------
-----------------R------ooo--------------------------k-y------------oooooo-------oooo------g--g-rg-------------oooo------oSoSS----ooooo-----------------------------kKg--y-----------R--------SoooSoo---
-----------XXXXXXXXXX----------------------oooooooo-XXXXXX----------ykY-------------------XXXXXXXXX----oooo---k---g----------------------XXXXX-------------------XXXXXXXXXXX-------XXXXXXXXX----------XX
XXXXXXXXXXXXXXXXXXXXX---ooo----------XXXXX-rY--k----XXXXXX--------XXXXXXXXXXXXXXXXXXXXXXXXXXXXXXXXX-g-g-r--G-XXXXXXXXXX-ooooo------ooooo-XXXXXXXXXXXXXXXXX-oo----XXXXXXXXXXX----XXXXXXXXXXXX---oooooo-XX
XXXXXXXXXXXXXXXXXXXXX-r----g---RggKg-XXXXXXXXXXXXXXXXXXXXX--XXXXXXXXXXXXXXXXXXXXXXXXXXXXXXXXXXXXXXXXXXXXXXXXXXXXXXXXXXX-----g-yR----R----XXXXXXXXXXXXXXXXX----rR-XXXXXXXXXXXXXXXXXXXXXXXXXXX--Y--y-r--XX
XXXXXXXXXXXXXXXXXXXXXXXXXXXXXXXXXXXXXXXXXXXXXXXXXXXXXXXXXXXXXXXXXXXXXXXXXXXXXXXXXXXXXXXXXXXXXXXXXXXXXXXXXXXXXXXXXXXXXXXXXXXXXXXXXXXXXXXXXXXXXXXXXXXXXXXXXXXXXXXXXXXXXXXXXXXXXXXXXXXXXXXXXXXXXXXXXXXXXXXX

