--------------------------------------------------------------------------------------------------------------------------------------------------------------------------------------------------------
--------------------------------------------------------------------------------------------------------------------------------------------------------------------------------------------------------
--------------------------------------------------------------------------------------------------------------------------------------------------------------------------------------------------------
--------------------------------------------------------------------------------------------------------------------------------------------------------------------------------------------------------
--------------------------------------------------------------------------------------------------------------------------------------------------------------------------------------------------------
--------------------------------------------------------------------------------------------------------------------------------------------------------------------------------------------------------
--------------------------------------------------------------------------------------------------------------------------------------------------------------------------------------------------------
--------------------------------------------------------------------------------------------------------------------------------------------------------------------------------------------------------
--------------------------------------------------------------------------------------------------------------------------------------------------------------------------------------------------------
--------------------------------------------------------------------------------------------------------------------------------------------------------------------------------------------------------
--------------------------------------------------------------------------------------------------------------------------------------------------------------------------------------------------------
--------------------------------------------------------------------------------------------------------------------------------------------------------------------------------------------------------
-------------------ooooooSo----------------ooS-----------------------------------------------------------------------oSSoo------------------------------------------------------------------------------
----------------------------------------------------------------oSSo------------------------------------------------------------------------------------------------------------------------------------
----------------------oooooo-------------ooooo------------------------------oo----------------------------------------------------oSoSo----X---X-----------------------------ooSo-----------------------
--------------------r--y------yk------------rg-----------------oooo----------yr------yy----oSSoSo----------------------r------------------XX---XX----------------------------------ooooooo--------------
XXXXXXXXXXXXXXXX--XXXXXXXXXXXXXXXXX----XXXXXXXXX---------------R-kkky-----XXXXXXXXXXXXXXXX-----------------------K--XXXXXXXXX-----ooo---XXXX---XXXX-g----g---------------------oo----r-GGg------XXXXXXXX
XXXXXXXXXXXXXXXX--XXXXXXXXXXXXXXXXX--XXXXXXXXXXX------------XXXXXXXXXX----XXXXXXXXXXXXXXXX---ooo----------XXXXXXXXXXXXXXXXXXXXX----g--G-XXXX---XXXXXXXXXXXXXXXX----XXXXXXXX--k-R--XXXXXXXXX-----XXXXXXXX
XXXXXXXXXXXXXXXX--XXXXXXXXXXXXXXXXX--XXXXXXXXXXXXXXX--g-k---XXXXXXXXXX----XXXXXXXXXXXXXXXX---y------G--rR-XXXXXXXXXXXXXXXXXXXXXXXXXXXXXXXXXX---XXXXXXXXXXXXXXXXXXXXXXXXXXXXXXXXXXXXXXXXXXXXXX---XXXXXXXX
XXXXXXXXXXXXXXXXXXXXXXXXXXXXXXXXXXXXXXXXXXXXXXXXXXXXXXXXXXXXXXXXXXXXXXXXXXXXXXXXXXXXXXXXXXXXXXXXXXXXXXXXXXXXXXXXXXXXXXXXXXXXXXXXXXXXXXXXXXXX---XXXXXXXXXXXXXXXXXXXXXXXXXXXXXXXXXXXXXXXXXXXXXXXXXXXXXXXXX

