--------------------------------------------------------------------------------------------------------------------------------------------------------------------------------------------------------
--------------------------------------------------------------------------------------------------------------------------------------------------------------------------------------------------------
--------------------------------------------------------------------------------------------------------------------------------------------------------------------------------------------------------
--------------------------------------------------------------------------------------------------------------------------------------------------------------------------------------------------------
--------------------------------------------------------------------------------------------------------------------------------------------------------------------------------------------------------
--------------------------------------------------------------------------------------------------------------------------------------------------------------------------------------------------------
--------------------------------------------------------------------------------------------------------------------------------------------------------------------------------------------------------
--------------------------------------------------------------------------------------------------------------------------------------------------------------------------------------------------------
--------------------------------------------------------------------------------------------------------------------------------------------------------------------------------------------------------
--------------------------------------------------------------------------------------------------------------------------------------------------------------------------------------------------------
--------------------------------------------------------------------------------------------------------------------------------------------------------------------------------------------------------
--------------------------------------------------------------------------------------------------------------------------------------------------------------------------------------------------------
------------------SSSooo----------------ooSo-------------------------------------------------------------------------oSSoo------------------------------oSSoo---------------------SoSoo-----------------
----------------------------------------------------------------------------------------------------------------------------------oooooo--------Soo-----------------------------------------------------
------------------oooooo-------SooSoo----------SSo---ooo--------------------------------ooooo----------------------ooooooo-------------------------------oo----------ooooo--------ooooo-----------------
----------------Rg-g----------------------k-------------k------------------------ooo----ry--y----------ky--k-----------yg---------oooo----------oooooo-----rG--------Y-----------k-grk-r----------Y--g--
-----------XXXXXXXXXXXXXX-------oooooo-XXXXXX-------XXXXXX-------k-------------yg----XXXXXXXXX--G-K---XXXXXXXXXXXXXXXXXXXXXXXXXX-k---gk---XXX----Yg----XXXXXXX-----XXXXXXXX-----XXXXXXXXX--------XXXXXXX
XXXXXXXXXXXXXXXXXXXXXXXXXXXXX--g---K---XXXXXX-g--K--XXXXXX----XXXXXXXXXXXX---XXXXXXXXXXXXXXXXXXXXXXX--XXXXXXXXXXXXXXXXXXXXXXXXXXXXXXXXXXXXXXXXXXXXXXXXXXXXXXXX-----XXXXXXXX-----XXXXXXXXX-g-y-k--XXXXXXX
XXXXXXXXXXXXXXXXXXXXXXXXXXXXXXXXXXXXXXXXXXXXXXXXXXXXXXXXXXXX--XXXXXXXXXXXX---XXXXXXXXXXXXXXXXXXXXXXX--XXXXXXXXXXXXXXXXXXXXXXXXXXXXXXXXXXXXXXXXXXXXXXXXXXXXXXXX-----XXXXXXXX-----XXXXXXXXXXXXXXXXXXXXXXXX
XXXXXXXXXXXXXXXXXXXXXXXXXXXXXXXXXXXXXXXXXXXXXXXXXXXXXXXXXXXXXXXXXXXXXXXXXXXXXXXXXXXXXXXXXXXXXXXXXXXXXXXXXXXXXXXXXXXXXXXXXXXXXXXXXXXXXXXXXXXXXXXXXXXXXXXXXXXXXXXXXXXXXXXXXXXXXXXXXXXXXXXXXXXXXXXXXXXXXXXX

