--------------------------------------------------------------------------------------------------------------------------------------------------------------------------------------------------------
--------------------------------------------------------------------------------------------------------------------------------------------------------------------------------------------------------
--------------------------------------------------------------------------------------------------------------------------------------------------------------------------------------------------------
--------------------------------------------------------------------------------------------------------------------------------------------------------------------------------------------------------
--------------------------------------------------------------------------------------------------------------------------------------------------------------------------------------------------------
--------------------------------------------------------------------------------------------------------------------------------------------------------------------------------------------------------
--------------------------------------------------------------------------------------------------------------------------------------------------------------------------------------------------------
--------------------------------------------------------------------------------------------------------------------------------------------------------------------------------------------------------
--------------------------------------------------------------------------------------------------------------------------------------------------------------------------------------------------------
--------------------------------------------------------------------------------------------------------------------------------------------------------------------------------------------------------
--------------------------------------------------------------------------------------------------------------------------------------------------------------------------------------------------------
--------------------------------------------------------------------------------------------------------------------------------------------------------------------------------------------------------
---------------------------oSoo---------------------------------------oSSooooo-------------------Soo--------------------------------ooo-----------------------------------------------------------------
----------------------------------------oooS-----------------------------------------------------------------------------oSSoo--------------------------------------------------------------------------
--------------------------oooo------------------------------------------oooo---------------------oo------oSo---------------------oooo---------------------------------------------------ooo------ooo----
------------------SSSo---R-kygr------------oooo----------------------rkK-r--rg--ooooo------------k-----------------------oooo---------------------------------------oooSSS-----oooS-------G----Y--k-----
-----------------------XXXXXXXXX---------G--y-y---------XXXXXXXXXXXXXXXXXXXXXXX--------XXX-----XXXXXX--ooooo-XXXXX----XX-----k--XXXXXXXXXXXXXXX--------XXXXX--------------------------XXXXXXXXXXXXXXX---
-----------------ooo---XXXXXXXXXXXXXX--XXXXXXXXXXXXXXXXXXXXXXXXXXXXXXXXXXXXXXXXXXXXXXXXXXX-----XXXXXX-yy-----XXXXX----XXXXXXXXXXXXXXXXXXXXXXXXXXX--ooo-XXXXXXX-----ooooo----XX-ooooo--XXXXXXXXXXXXXXX---
----------------K--R-k-XXXXXXXXXXXXXXXXXXXXXXXXXXXXXXXXXXXXXXXXXXXXXXXXXXXXXXXXXXXXXXXXXXX-----XXXXXXXXXXXXXXXXXXXXX--XXXXXXXXXXXXXXXXXXXXXXXXXXX-gr---XXXXXXX------k-----K-XX--r---k-XXXXXXXXXXXXXXX---
XXXXXXXXXXXXXXXXXXXXXXXXXXXXXXXXXXXXXXXXXXXXXXXXXXXXXXXXXXXXXXXXXXXXXXXXXXXXXXXXXXXXXXXXXXXXXXXXXXXXXXXXXXXXXXXXXXXXXXXXXXXXXXXXXXXXXXXXXXXXXXXXXXXXXXXXXXXXXXXXXXXXXXXXXXXXXXXXXXXXXXXXXXXXXXXXXXXXXXXX

