--------------------------------------------------------------------------------------------------------------------------------------------------------------------------------------------------------
--------------------------------------------------------------------------------------------------------------------------------------------------------------------------------------------------------
--------------------------------------------------------------------------------------------------------------------------------------------------------------------------------------------------------
--------------------------------------------------------------------------------------------------------------------------------------------------------------------------------------------------------
--------------------------------------------------------------------------------------------------------------------------------------------------------------------------------------------------------
--------------------------------------------------------------------------------------------------------------------------------------------------------------------------------------------------------
--------------------------------------------------------------------------------------------------------------------------------------------------------------------------------------------------------
--------------------------------------------------------------------------------------------------------------------------------------------------------------------------------------------------------
--------------------------------------------------------------------------------------------------------------------------------------------------------------------------------------------------------
--------------------------------------------------------------------------------------------------------------------------------------------------------------------------------------------------------
--------------------------------------------------------------------------------------------------------------------------------------------------------------------------------------------------------
--------------------------------------------------------------------------------------------------------------------------------------------------------------------------------------------------------
-------------------------------------SoS-------------------------------------------------------------------------------------------------------------ooSoS------------------------oSSoo-----------------
--------------------------------------------------------------------------------------------------------------------ooooo-------------------------------------------------------------------------------
-----------------ooo---------------ooooo---------------------------------------ooo------------------oSSooo-----------------------------oooS----------ooooo---oooooo-----------------oo------------------
------------------r----------------kR----------------------------Soooooo-------------------SoSSoo----------------oooooo--------rr-------------------G-----g------------------------k-y------oooooo------
-----------XXXXXXXXXX--ooo--XXX--XXXXXXXXXXX--oo-----------------------------------------------------ooooo---------ry-g-gy-XXXXXXXXX--oooooooo----XXXXXXXXXX----oooo---------XXXXXXXXXXX-------g-k------
-----------XXXXXXXXXX----y--XXX--XXXXXXXXXXX---g--XXXXX---------oooooo---XXXXX--G---XXXX----oooo--------g-------XXXXXXXXXXXXXXXXXXXX----k--g-r-XXXXXXXXXXXXX-y-r-g-----------XXXXXXXXXXXXXXXXXXXXXXXXXXX
-----------XXXXXXXXXXXXXXXXXXXX--XXXXXXXXXXXXXXXXXXXXXX----g------y--g---XXXXXXXXXXXXXXX--------R--XXXXXXXXXXXXXXXXXXXXXXXXXXXXXXXXXXXXXXXXXXXXXXXXXXXXXXXXXXXXXXXXXXXXXXXXXXXXXXXXXXXXXXXXXXXXXXXXXXXXX
XXXXXXXXXXXXXXXXXXXXXXXXXXXXXXXXXXXXXXXXXXXXXXXXXXXXXXXXXXXXXXXXXXXXXXXXXXXXXXXXXXXXXXXXXXXXXXXXXXXXXXXXXXXXXXXXXXXXXXXXXXXXXXXXXXXXXXXXXXXXXXXXXXXXXXXXXXXXXXXXXXXXXXXXXXXXXXXXXXXXXXXXXXXXXXXXXXXXXXXX

