--------------------------------------------------------------------------------------------------------------------------------------------------------------------------------------------------------
--------------------------------------------------------------------------------------------------------------------------------------------------------------------------------------------------------
--------------------------------------------------------------------------------------------------------------------------------------------------------------------------------------------------------
--------------------------------------------------------------------------------------------------------------------------------------------------------------------------------------------------------
--------------------------------------------------------------------------------------------------------------------------------------------------------------------------------------------------------
--------------------------------------------------------------------------------------------------------------------------------------------------------------------------------------------------------
--------------------------------------------------------------------------------------------------------------------------------------------------------------------------------------------------------
--------------------------------------------------------------------------------------------------------------------------------------------------------------------------------------------------------
--------------------------------------------------------------------------------------------------------------------------------------------------------------------------------------------------------
--------------------------------------------------------------------------------------------------------------------------------------------------------------------------------------------------------
--------------------------------------------------------------------------------------------------------------------------------------------------------------------------------------------------------
--------------------------------------------------------------------------------------------------------------------------------------------------------------------------------------------------------
---------------------------------------ooooo----------------------------------------------------------------------------SoooSo-------------------oSSS-------------------------------------------SSoo----
-------------------oSoSSoSo--------------------------------------------------------------------------------------------------------------------------------------ooSoooo--ooSoSo------------------------
------------------------------oSSo-------oooo-------oooo----------------------------------------ooo-----------------------oooo-----------------ooooooo--ooSooo--------------------oSo-----------oooooo--
----------------------oooo-------------ygG---r------R-------oSooo----------------oSoo------------Rgg--ooo---------------ggr-----------Sooo----G--Kk-KG------------ooo------ooo-----------------Y----yy--
--------------k-----G-k--------ooo--XXXXXXXXXXX----XXXXXX---------------------------------XXXXXXXXXXX-R----k----------XXXXXXXXX--------------XXXXXXXXXX--oo--------Grg-----g-----------------XXXXXXXXXXX
-----------XXXXXXXXXXXXXXXXXX--rr-y-XXXXXXXXXXX----XXXXXX---ooooo------ooo------ooo-------XXXXXXXXXXXXXXXXXXX----oo---XXXXXXXXXXXXXX--oooooo-XXXXXXXXXX--rgK---XXXXXXXXXXXXXXXXXX-----ry-----XXXXXXXXXXX
XXXXXXXXXXXXXXXXXXXXXXXXXXXXXXXXXXXXXXXXXXXXXXX----XXXXXX-y--R-rYG--K--Yk-k-------ky--XXXXXXXXXXXXXXXXXXXXXXX--K----XXXXXXXXXXXXXXXX---------XXXXXXXXXXXXXXXXXXXXXXXXXXXXXXXXXXXXXXXXXXXXXXXXXXXXXXXXXXX
XXXXXXXXXXXXXXXXXXXXXXXXXXXXXXXXXXXXXXXXXXXXXXXXXXXXXXXXXXXXXXXXXXXXXXXXXXXXXXXXXXXXXXXXXXXXXXXXXXXXXXXXXXXXXXXXXXXXXXXXXXXXXXXXXXXXXXXXXXXXXXXXXXXXXXXXXXXXXXXXXXXXXXXXXXXXXXXXXXXXXXXXXXXXXXXXXXXXXXXX

