--------------------------------------------------------------------------------------------------------------------------------------------------------------------------------------------------------
--------------------------------------------------------------------------------------------------------------------------------------------------------------------------------------------------------
--------------------------------------------------------------------------------------------------------------------------------------------------------------------------------------------------------
--------------------------------------------------------------------------------------------------------------------------------------------------------------------------------------------------------
--------------------------------------------------------------------------------------------------------------------------------------------------------------------------------------------------------
--------------------------------------------------------------------------------------------------------------------------------------------------------------------------------------------------------
--------------------------------------------------------------------------------------------------------------------------------------------------------------------------------------------------------
--------------------------------------------------------------------------------------------------------------------------------------------------------------------------------------------------------
--------------------------------------------------------------------------------------------------------------------------------------------------------------------------------------------------------
--------------------------------------------------------------------------------------------------------------------------------------------------------------------------------------------------------
--------------------------------------------------------------------------------------------------------------------------------------------------------------------------------------------------------
--------------------------------------------------------------------------------------------------------------------------------------------------------------------------------------------------------
-------------------------------------------------------------------------------------------------------------------oSoooo------ooSooo------------------------------------ooSSoo---------------oooo------
----------------------------------------------------------------------------------------Soo----ooSooSo--------------------------------------------------------------------------------------------------
--------------------------------ooo------------------------------------------oSoSoS------------------------------oooooo-----------oo---oSoooSSS---oooSo------------------ooooo-------oSSoooo------------
--------------------oSooSo-----Y-------------SSoSooo-----oooS---------------------------oo-----ooooo-------------rygK--yr---------y------------------------------------------r-----------------g--------
----------------------------XXXXXXXX-----------------------------------------ooooooo---y--Yy----k-------XXXX---XXXXXXXXXXXXXXXXXXXXXXX----oooo----ooooooo--oooooo--XXXXXXXXXXXXXXX-oooooo----XXXXXX-----
XXXXXXXXXX-oooooo-----oo----XXXXXXXXXXXXX---ooooooo-------ooooo----------XXX-r--g----XXXXXXXXXXXXXXXXXXXXXXX---XXXXXXXXXXXXXXXXXXXXXXX--r--K-r----------k----------XXXXXXXXXXXXXXX-g-Y-ry--K-XXXXXX-----
XXXXXXXXXX-Y--------gy-R----XXXXXXXXXXXXXXX--k---R------rYy---------XXXXXXXXXXXXXXXXXXXXXXXXXXXXXXXXXXXXXXXX---XXXXXXXXXXXXXXXXXXXXXXXXXXXXXXXXXXXXXXXXXXXXXXXXXXXXXXXXXXXXXXXXXXXXXXXXXXXXXXXXXXXXXXXX-
XXXXXXXXXXXXXXXXXXXXXXXXXXXXXXXXXXXXXXXXXXXXXXXXXXXXXXXXXXXXXXXXXXXXXXXXXXXXXXXXXXXXXXXXXXXXXXXXXXXXXXXXXXXXXXXXXXXXXXXXXXXXXXXXXXXXXXXXXXXXXXXXXXXXXXXXXXXXXXXXXXXXXXXXXXXXXXXXXXXXXXXXXXXXXXXXXXXXXXXX

