--------------------------------------------------------------------------------------------------------------------------------------------------------------------------------------------------------
--------------------------------------------------------------------------------------------------------------------------------------------------------------------------------------------------------
--------------------------------------------------------------------------------------------------------------------------------------------------------------------------------------------------------
--------------------------------------------------------------------------------------------------------------------------------------------------------------------------------------------------------
--------------------------------------------------------------------------------------------------------------------------------------------------------------------------------------------------------
--------------------------------------------------------------------------------------------------------------------------------------------------------------------------------------------------------
--------------------------------------------------------------------------------------------------------------------------------------------------------------------------------------------------------
--------------------------------------------------------------------------------------------------------------------------------------------------------------------------------------------------------
--------------------------------------------------------------------------------------------------------------------------------------------------------------------------------------------------------
--------------------------------------------------------------------------------------------------------------------------------------------------------------------------------------------------------
--------------------------------------------------------------------------------------------------------------------------------------------------------------------------------------------------------
--------------------------------------------------------------------------------------------------------------------------------------------------------------------------------------------------------
-------------oooSo-------------------------------------------------------------------------------------ooSS---------------------------------------------------------------------------oooo--------------
-----------------------------------------------------------------------SoSS-------oSo------------------------------------oSo----------------------------------oooo-------ooo----------------------------
--------------oo-----------------------SoSo-----------------ooSoooS-------------------------------------ooo---------------------------------------------------------------------------------------------
---------------------------ooooo---------------------------------------------------------oo-----------K--y--g-------------------oooSSSo----------------------------------ooo-----------R-Y--------------
XXXXXXXXXXXXXXXXXXXX--------------------oo---ooooooo--oo-----ooooo----kgY---------r-k-----y-r-------XXXXXXXXXX--oooo------gg-g-------------ooooooo-----ooo-----r-Y-XXX--yk----------XXXXXXXX-------ooo--
XXXXXXXXXXXXXXXXXXXX-ooo---ooooooo---G--ggr---R---kr--rY----k-k------XXXXXXXX----XXXXXXXXXXXXXX-----XXXXXXXXXX----G-k--XXXXXXXX----ooooo----Y-------k------XXXXXXXXXXXXXXXXXXXXX----XXXXXXXX------------
XXXXXXXXXXXXXXXXXXXX-G----------k-g-XXXXXXXXXXXXXXXXXXXXXXXXXXXXXXXXXXXXXXXXX----XXXXXXXXXXXXXXXXXXXXXXXXXXXXXXXXXXXXXXXXXXXXXX----k----y-XXXXXXXXXXXXXXXXXXXXXXXXXXXXXXXXXXXXXXXXXXXXXXXXXX------XXXXXX
XXXXXXXXXXXXXXXXXXXXXXXXXXXXXXXXXXXXXXXXXXXXXXXXXXXXXXXXXXXXXXXXXXXXXXXXXXXXXXXXXXXXXXXXXXXXXXXXXXXXXXXXXXXXXXXXXXXXXXXXXXXXXXXXXXXXXXXXXXXXXXXXXXXXXXXXXXXXXXXXXXXXXXXXXXXXXXXXXXXXXXXXXXXXXXXXXXXXXXXX

