--------------------------------------------------------------------------------------------------------------------------------------------------------------------------------------------------------
--------------------------------------------------------------------------------------------------------------------------------------------------------------------------------------------------------
--------------------------------------------------------------------------------------------------------------------------------------------------------------------------------------------------------
--------------------------------------------------------------------------------------------------------------------------------------------------------------------------------------------------------
--------------------------------------------------------------------------------------------------------------------------------------------------------------------------------------------------------
--------------------------------------------------------------------------------------------------------------------------------------------------------------------------------------------------------
--------------------------------------------------------------------------------------------------------------------------------------------------------------------------------------------------------
--------------------------------------------------------------------------------------------------------------------------------------------------------------------------------------------------------
--------------------------------------------------------------------------------------------------------------------------------------------------------------------------------------------------------
--------------------------------------------------------------------------------------------------------------------------------------------------------------------------------------------------------
--------------------------------------------------------------------------------------------------------------------------------------------------------------------------------------------------------
--------------------------------------------------------------------------------------------------------------------------------------------------------------------------------------------------------
-------------------------------------------------------------------------oSSo---------------------------------------------oooooSo----------ooSo------------------------oooooSo--------------------------
------------------------------------------------oooS----------------------------------------------------------------------------------------------ooSooooo------------------------ooo-------------------
------------------------------------ooooSoo----------------------ooo--oooooo--------------------------------------oSooo-----oooo----------------------------------------ooo---------------ooSo----------
-----------------------oo----------------------oooo-------------------R---gg----ooo----------------------------------------yy--------------gR----oooooo----------------K-rgYy----oooooo-----------------
--------------XXXXXXXX-Gg-----------oooooo-----r-gk------------------XXXXXXXXX-K-gg-k-XXXXX---XX-----------------oooo----XXXXXXXXX------XXXXXXXX-----Kkk-------------XXXXXXXXXX-rK---yk-----------------
XXXXXXXXXXXXXXXXXXXXXXXXXXXXX--------yk--ky--XXXXXXXXXX--------------XXXXXXXXXXXXXXXXXXXXXX---XX-----------------------Y-XXXXXXXXX---g--XXXXXXXXXXXXXXXXXXX----------XXXXXXXXXXXXXXXXXXXX---G--XXXXXX---
XXXXXXXXXXXXXXXXXXXXXXXXXXXXXXXXXXXXXXXXXXXXXXXXXXXXXXX---G----XXXXXXXXXXXXXXXXXXXXXXXXXXXXXXXXX--g-y---XXXXXXXXXXXXXXXXXXXXXXXXXXXXXXXXXXXXXXXXXXXXXXXXXXX------KY--XXXXXXXXXXXXXXXXXXXXXXXXXXXXXXXXXXX
XXXXXXXXXXXXXXXXXXXXXXXXXXXXXXXXXXXXXXXXXXXXXXXXXXXXXXXXXXXXXXXXXXXXXXXXXXXXXXXXXXXXXXXXXXXXXXXXXXXXXXXXXXXXXXXXXXXXXXXXXXXXXXXXXXXXXXXXXXXXXXXXXXXXXXXXXXXXXXXXXXXXXXXXXXXXXXXXXXXXXXXXXXXXXXXXXXXXXXXX

