--------------------------------------------------------------------------------------------------------------------------------------------------------------------------------------------------------
--------------------------------------------------------------------------------------------------------------------------------------------------------------------------------------------------------
--------------------------------------------------------------------------------------------------------------------------------------------------------------------------------------------------------
--------------------------------------------------------------------------------------------------------------------------------------------------------------------------------------------------------
--------------------------------------------------------------------------------------------------------------------------------------------------------------------------------------------------------
--------------------------------------------------------------------------------------------------------------------------------------------------------------------------------------------------------
--------------------------------------------------------------------------------------------------------------------------------------------------------------------------------------------------------
--------------------------------------------------------------------------------------------------------------------------------------------------------------------------------------------------------
--------------------------------------------------------------------------------------------------------------------------------------------------------------------------------------------------------
--------------------------------------------------------------------------------------------------------------------------------------------------------------------------------------------------------
--------------------------------------------------------------------------------------------------------------------------------------------------------------------------------------------------------
--------------------------------------------------------------------------------------------------------------------------------------------------------------------------------------------------------
---------------oSooo------oooo--------------------------------------------------------------------------------------------------ooS-----oooo------------------------------------------------------------
-----------------------------------------------------------------------------------------SSo------------------------------------------------------------------------------------------------------------
-----------------oooo-----ooo------ooo-----------oooo---oooooo---------oooSoo----------------------------oooooSoo---oSo------------------ooooo----------------------------------------------------------
----------------k--------ry-------------ooooo--y--ky-------g-----Soo-------------------oooooo----------------------------------yY--G---k---R----ooooooSoo--------------ooo------------ooo-----oo--------
-------------XXXXXXXXXXXXXXXXXX--ooooo--------XXXXXXXXXXXXXXXXX----------oooo----------K-k---y-------------oooooo----ooo------XXXXXXXXXXXXXXXXX-----------------------------XX---------------k--R-------
XXXXXXXXXXXXXXXXXXXXXXXXXXXXXXX---y-GK----oo--XXXXXXXXXXXXXXXXX-------rGRgk--R-------XXXXXXXXXXXXXXXX-----r-g--ry---G-rg-XXXXXXXXXXXXXXXXXXXXXX-ooooooo------ooo------XXXXXXXX--------------XXXXXXXXXXXX
XXXXXXXXXXXXXXXXXXXXXXXXXXXXXXXXXXXXXXX---kkK-XXXXXXXXXXXXXXXXX-GY---XXXXXXXXXXXXXXXXXXXXXXXXXXXXXXXX---XXXXXXXXXXXXXXXXXXXXXXXXXXXXXXXXXXXXXXX--y------k---y--R-XXXXXXXXXXXXX---y----k---y-XXXXXXXXXXXX
XXXXXXXXXXXXXXXXXXXXXXXXXXXXXXXXXXXXXXXXXXXXXXXXXXXXXXXXXXXXXXXXXXXXXXXXXXXXXXXXXXXXXXXXXXXXXXXXXXXXXXXXXXXXXXXXXXXXXXXXXXXXXXXXXXXXXXXXXXXXXXXXXXXXXXXXXXXXXXXXXXXXXXXXXXXXXXXXXXXXXXXXXXXXXXXXXXXXXXXX

