--------------------------------------------------------------------------------------------------------------------------------------------------------------------------------------------------------
--------------------------------------------------------------------------------------------------------------------------------------------------------------------------------------------------------
--------------------------------------------------------------------------------------------------------------------------------------------------------------------------------------------------------
--------------------------------------------------------------------------------------------------------------------------------------------------------------------------------------------------------
--------------------------------------------------------------------------------------------------------------------------------------------------------------------------------------------------------
--------------------------------------------------------------------------------------------------------------------------------------------------------------------------------------------------------
--------------------------------------------------------------------------------------------------------------------------------------------------------------------------------------------------------
--------------------------------------------------------------------------------------------------------------------------------------------------------------------------------------------------------
--------------------------------------------------------------------------------------------------------------------------------------------------------------------------------------------------------
--------------------------------------------------------------------------------------------------------------------------------------------------------------------------------------------------------
--------------------------------------------------------------------------------------------------------------------------------------------------------------------------------------------------------
--------------------------------------------------------------------------------------------------------------------------------------------------------------------------------------------------------
-----------------------SSoS---oooooo-----------ooSSSSo------------------------------ooo------------------oooS-----------------SoSo----------------------------------------------------------------------
---------------------------------------------------------------------ooSoo---------------------------------------------------------------------------------------------------------SooSSoo--------------
-------------------------oo----ooooo-----------ooooooo----------------------------oooooo-------oSSSoo----oooo-------oSooo-------------------------------------------------------------------------------
-------------------r--gr--Ry--g------------------gg-----------ooo------oooooo--------k---------------------r---g-------------yr-----------------------ooSoSS-----------Sooo--------oooooooo-------oooo--
XXXXXXXXXXXXXXXXXXXXXXXXXXXXXXXXXXXXXXXXXX----XXXXXXXXXX-----y--y---------k------XXXXXXXXXXXXX--ooooooo-XXXXXXXXX-ooooooo--XXXXXXXX----rgr----------------------------------------g---kkr--------k------
XXXXXXXXXXXXXXXXXXXXXXXXXXXXXXXXXXXXXXXXXXXXXXXXXXXXXXXX---XXXXXXX--XXXXXXXXXXXXXXXXXXXXXXXXXX--r---y---XXXXXXXXX----gk----XXXXXXXX---XXXXXX------------oooooo--------oooooo-----XXXXXXXXXXXXXXXXXXXXXX-
XXXXXXXXXXXXXXXXXXXXXXXXXXXXXXXXXXXXXXXXXXXXXXXXXXXXXXXX---XXXXXXXXXXXXXXXXXXXXXXXXXXXXXXXXXXXXXXXXXXXXXXXXXXXXXXXXXXXXXXXXXXXXXXXXXXXXXXXXX-Yr------r---k-rr-----XXX-K--G-----XXXXXXXXXXXXXXXXXXXXXXXX-
XXXXXXXXXXXXXXXXXXXXXXXXXXXXXXXXXXXXXXXXXXXXXXXXXXXXXXXXXXXXXXXXXXXXXXXXXXXXXXXXXXXXXXXXXXXXXXXXXXXXXXXXXXXXXXXXXXXXXXXXXXXXXXXXXXXXXXXXXXXXXXXXXXXXXXXXXXXXXXXXXXXXXXXXXXXXXXXXXXXXXXXXXXXXXXXXXXXXXXXX

