--------------------------------------------------------------------------------------------------------------------------------------------------------------------------------------------------------
--------------------------------------------------------------------------------------------------------------------------------------------------------------------------------------------------------
--------------------------------------------------------------------------------------------------------------------------------------------------------------------------------------------------------
--------------------------------------------------------------------------------------------------------------------------------------------------------------------------------------------------------
--------------------------------------------------------------------------------------------------------------------------------------------------------------------------------------------------------
--------------------------------------------------------------------------------------------------------------------------------------------------------------------------------------------------------
--------------------------------------------------------------------------------------------------------------------------------------------------------------------------------------------------------
--------------------------------------------------------------------------------------------------------------------------------------------------------------------------------------------------------
--------------------------------------------------------------------------------------------------------------------------------------------------------------------------------------------------------
--------------------------------------------------------------------------------------------------------------------------------------------------------------------------------------------------------
--------------------------------------------------------------------------------------------------------------------------------------------------------------------------------------------------------
--------------------------------------------------------------------------------------------------------------------------------------------------------------------------------------------------------
-----------------------------------------------------------------------------ooSSooo---------------------------------------------------------SSS-----------------------------oSo------------------------
---------------------------------------------------------------------------------------------------------------------------------------------------oooo-------------------------------------------------
-------------------ooo------------------------------------ooo----------------ooooooo------------------------------------------------------oooo-----------------------------ooooooo----------------------
----------------------------g----ooooSo-----oooo----------yky----------------------k-----Soo------oo----------------------------------------gG-ry----oooo---ooooo-----------y---K---oo------oSo----ooo--
------------------ooooooo-XXXXXX-------------G-k--------XXXXXXXXX---------XXXXXXXXXXX-----------Rg-Kk-----XXXX-------------XX-------XXXXXXXXXXXXXX-y---------------XXXXXXXXXXXXXXXX---r-----------------
XXXXXXXXXX----------r--y--XXXXXX---oooo---XXXXXXXXX-----XXXXXXXXX---------XXXXXXXXXXX-oooooo---XXXXXXXXXXXXXXX--XXXX-------XX-------XXXXXXXXXXXXXXXXXXXXXXX----ooo-XXXXXXXXXXXXXXXXXXXXXXX--------------
XXXXXXXXXX----XXXXXXXXXXXXXXXXXX-k--------XXXXXXXXX-----XXXXXXXXX---------XXXXXXXXXXX-K---r----XXXXXXXXXXXXXXXXXXXXX-------XXXXXXXXXXXXXXXXXXXXXXXXXXXXXXXX--G-----XXXXXXXXXXXXXXXXXXXXXXX---y---------X
XXXXXXXXXXXXXXXXXXXXXXXXXXXXXXXXXXXXXXXXXXXXXXXXXXXXXXXXXXXXXXXXXXXXXXXXXXXXXXXXXXXXXXXXXXXXXXXXXXXXXXXXXXXXXXXXXXXXXXXXXXXXXXXXXXXXXXXXXXXXXXXXXXXXXXXXXXXXXXXXXXXXXXXXXXXXXXXXXXXXXXXXXXXXXXXXXXXXXXXX

