--------------------------------------------------------------------------------------------------------------------------------------------------------------------------------------------------------
--------------------------------------------------------------------------------------------------------------------------------------------------------------------------------------------------------
--------------------------------------------------------------------------------------------------------------------------------------------------------------------------------------------------------
--------------------------------------------------------------------------------------------------------------------------------------------------------------------------------------------------------
--------------------------------------------------------------------------------------------------------------------------------------------------------------------------------------------------------
--------------------------------------------------------------------------------------------------------------------------------------------------------------------------------------------------------
--------------------------------------------------------------------------------------------------------------------------------------------------------------------------------------------------------
--------------------------------------------------------------------------------------------------------------------------------------------------------------------------------------------------------
--------------------------------------------------------------------------------------------------------------------------------------------------------------------------------------------------------
--------------------------------------------------------------------------------------------------------------------------------------------------------------------------------------------------------
--------------------------------------------------------------------------------------------------------------------------------------------------------------------------------------------------------
--------------------------------------------------------------------------------------------------------------------------------------------------------------------------------------------------------
--------------------------------------oooo-------------oSoSo----------------------------------------------------------oSooo-----------------------------------------------------------------------------
---------------------oSoo------------------------------------------------------------------------------------------------------------------------------------------ooSS---------------------------------
--------------------------------------oo---------------ooo--------------------------------------oooo---SoSS---------ooooooo-------oo--------------Soo---------------------------------------------------
---------------------oooo------------R-r------Soo------r-----------------Sooo------oSooSS--------------------------k-RyGrkr--------r------ooS---------------r-------oo-----------------------------ooo--
------------------------g---XX------XXXXXXXX---------XXXXXXXXX-------------------------------ooooo-------ooo------XXXXXXXXXX-----XXXXXX-----------ooo-----XXXXXX--r--k-----------------XXXXXXXXX--------
---------------oooo-XXXXXX--XX----XXXXXXXXXX---ooooo-XXXXXXXXX-----XXXX--ooooooo---ooooooo-------------yggG-------XXXXXXXXXX-----XXXXXX---ooo-------r-XXXXXXXXXXXXXXXXXXX---ooo--------XXXXXXXXX--------
-------------r------XXXXXX--XXXXXXXXXXXXXXXX---ry-gK-XXXXXXXXX-----XXXX-k--gr------k------k-XXXXXXXXXXXXXXXXXXXXXXXXXXXXXXXX-----XXXXXX-k-rr---XXXXXXXXXXXXXXXXXXXXXXXXXX------k--XXXXXXXXXXXXXX--G-gK--
XXXXXXXXXXXXXXXXXXXXXXXXXXXXXXXXXXXXXXXXXXXXXXXXXXXXXXXXXXXXXXXXXXXXXXXXXXXXXXXXXXXXXXXXXXXXXXXXXXXXXXXXXXXXXXXXXXXXXXXXXXXXXXXXXXXXXXXXXXXXXXXXXXXXXXXXXXXXXXXXXXXXXXXXXXXXXXXXXXXXXXXXXXXXXXXXXXXXXXXX

