--------------------------------------------------------------------------------------------------------------------------------------------------------------------------------------------------------
--------------------------------------------------------------------------------------------------------------------------------------------------------------------------------------------------------
--------------------------------------------------------------------------------------------------------------------------------------------------------------------------------------------------------
--------------------------------------------------------------------------------------------------------------------------------------------------------------------------------------------------------
--------------------------------------------------------------------------------------------------------------------------------------------------------------------------------------------------------
--------------------------------------------------------------------------------------------------------------------------------------------------------------------------------------------------------
--------------------------------------------------------------------------------------------------------------------------------------------------------------------------------------------------------
--------------------------------------------------------------------------------------------------------------------------------------------------------------------------------------------------------
--------------------------------------------------------------------------------------------------------------------------------------------------------------------------------------------------------
--------------------------------------------------------------------------------------------------------------------------------------------------------------------------------------------------------
--------------------------------------------------------------------------------------------------------------------------------------------------------------------------------------------------------
--------------------------------------------------------------------------------------------------------------------------------------------------------------------------------------------------------
----------------------------------------------------------------------------------------------------------------------------oooSoSo------------------ooSS-------------------oooS------------------------
------------------------------------------ooSSSo--------------------------------------------------------------------------------------------------------------------------------------------------------
----------------------------ooooo------------------------------ooSSoo----------ooSoo-----------------------------------------ooooo-----------oo----oooooo-----------------------------------------------
------------------SoSoo----R-r--r--------ooooooo---------------------------------------------------SSo---------------------Y-----gy----------Y------------g-------------------r-k---------------oSS-----
-------------------------XXXXXXXXX-----R-------r-XXXXXXXXXX-------oooo------oooooo----XXXXXXXXX-----------------oo--------XXXXXXXXXXXX-----XXXXXXXXXXXXXXXXXX-oooo---------XXXXXXX----------------------
-----------------ooooooo-XXXXXXXXX----XXXXXXXXXXXXXXXXXXXXX-----GGgk--g------g---Ygr--XXXXXXXXX---ooo--XXXX------------XXXXXXXXXXXXXXXXXXXXXXXXXXXXXXXXXXXXXX-----------XXXXXXXXXX-----XX---------------
XXXXXXXXXXXXXX-------rk--XXXXXXXXXXXXXXXXXXXXXXXXXXXXXXXXXX---XXXXXXXXXX---XXXXXXXXXXXXXXXXXXXX--Y--yg-XXXX---XXXXXX---XXXXXXXXXXXXXXXXXXXXXXXXXXXXXXXXXXXXXXXXXXXXXXXXXXXXXXXXXXX-----XX-y-------------
XXXXXXXXXXXXXXXXXXXXXXXXXXXXXXXXXXXXXXXXXXXXXXXXXXXXXXXXXXXXXXXXXXXXXXXXXXXXXXXXXXXXXXXXXXXXXXXXXXXXXXXXXXXXXXXXXXXXXXXXXXXXXXXXXXXXXXXXXXXXXXXXXXXXXXXXXXXXXXXXXXXXXXXXXXXXXXXXXXXXXXXXXXXXXXXXXXXXXXXX

