--------------------------------------------------------------------------------------------------------------------------------------------------------------------------------------------------------
--------------------------------------------------------------------------------------------------------------------------------------------------------------------------------------------------------
--------------------------------------------------------------------------------------------------------------------------------------------------------------------------------------------------------
--------------------------------------------------------------------------------------------------------------------------------------------------------------------------------------------------------
--------------------------------------------------------------------------------------------------------------------------------------------------------------------------------------------------------
--------------------------------------------------------------------------------------------------------------------------------------------------------------------------------------------------------
--------------------------------------------------------------------------------------------------------------------------------------------------------------------------------------------------------
--------------------------------------------------------------------------------------------------------------------------------------------------------------------------------------------------------
--------------------------------------------------------------------------------------------------------------------------------------------------------------------------------------------------------
--------------------------------------------------------------------------------------------------------------------------------------------------------------------------------------------------------
--------------------------------------------------------------------------------------------------------------------------------------------------------------------------------------------------------
--------------------------------------------------------------------------------------------------------------------------------------------------------------------------------------------------------
---------------------------------------oSSoSSo----------------------------------------------------------------------------------------------------------------------------------------------------------
----------------------------------------------------------------------------------------------------ooooooo---------------------------------------------------ooooS-------------------------------------
-----------------------------------------oo-------------------------------------ooo---------------------------------------------------------------------------------------------------------------------
----------------oo-----------------------ggK---------ooSoo-----------oooooo-------------ooo---ooSo---oooooo------------oSSoo-----------Soo--------------oo----oooo--------------------------------------
--------------y-kk-------------------XXXXXXXXXXXXXXX------------Kr-----------ooooo---r----r-----------y-Y-K--------------------XXXXX--------------oo--gy-----yr-g--------XX--------------gy----XXX------
------------XXXXXXX-------oo-XXXXXXXXXXXXXXXXXXXXXXX-ooooo---XXXXXX---oo------k-ryg-XXXXXXXX---oo--XXXXXXXXXXX----------oo---XXXXXXX-ooooooo----r----XXXXXXXXXXXXXXXXXXXXXX------------XXXXXXXXXXX--r---
------------XXXXXXX-----g----XXXXXXXXXXXXXXXXXXXXXXX-r-yyKr--XXXXXX--Y-k----XXXXXXXXXXXXXXXX---Gr--XXXXXXXXXXX---Gk---rR--g--XXXXXXX--G----r--XXXXXXXXXXXXXXXXXXXXXXXXXXXXX---XXX---XXXXXXXXXXXXXXXXXXXX
XXXXXXXXXXXXXXXXXXXXXXXXXXXXXXXXXXXXXXXXXXXXXXXXXXXXXXXXXXXXXXXXXXXXXXXXXXXXXXXXXXXXXXXXXXXXXXXXXXXXXXXXXXXXXXXXXXXXXXXXXXXXXXXXXXXXXXXXXXXXXXXXXXXXXXXXXXXXXXXXXXXXXXXXXXXXXXXXXXXXXXXXXXXXXXXXXXXXXXXX

