--------------------------------------------------------------------------------------------------------------------------------------------------------------------------------------------------------
--------------------------------------------------------------------------------------------------------------------------------------------------------------------------------------------------------
--------------------------------------------------------------------------------------------------------------------------------------------------------------------------------------------------------
--------------------------------------------------------------------------------------------------------------------------------------------------------------------------------------------------------
--------------------------------------------------------------------------------------------------------------------------------------------------------------------------------------------------------
--------------------------------------------------------------------------------------------------------------------------------------------------------------------------------------------------------
--------------------------------------------------------------------------------------------------------------------------------------------------------------------------------------------------------
--------------------------------------------------------------------------------------------------------------------------------------------------------------------------------------------------------
--------------------------------------------------------------------------------------------------------------------------------------------------------------------------------------------------------
--------------------------------------------------------------------------------------------------------------------------------------------------------------------------------------------------------
--------------------------------------------------------------------------------------------------------------------------------------------------------------------------------------------------------
--------------------------------------------------------------------------------------------------------------------------------------------------------------------------------------------------------
------------------------------------------------------oSo---------oSoSSS--------------------------------oooo-----ooo------------------------SooS-----------------------------------Sooo-----------------
--------------------SooS-------------------------------------------------------------------------------------------------------------------------------------------------------------------SSooS--------
------------------------------------------ooooSoo---ooo------------oooo----------------oo-----ooo------ooooo--oooo------ooSoSoo--ooooo------oooooo-----oo--------------------------oo-------------------
------------------oooooooo-----------------------------r----------k-kY--g----------------r------ry-G------K---K-Y-r------------------------k-----yg----g---------------------------YY-------------------
--------------------G--r--y------------r----oooooo-XXXXXXX-------XXXXXXXXX------------XXXXXXXXXXXXXXXXXXXXXXXXXXXXXXX--ooooo--------ooooo-XXXXXXXXXXXXXXXX----------------------XXXXXXXXX---------------
XXXXXXXXXXXXX----XXXXXXXXXXXXX----XXXXXXX-ky--G----XXXXXXX-------XXXXXXXXX-------oo---XXXXXXXXXXXXXXXXXXXXXXXXXXXXXXX--ry----y---Y--k-k-Y-XXXXXXXXXXXXXXXXXXX-----------oooo----XXXXXXXXXXXXXXXXXX------
XXXXXXXXXXXXX----XXXXXXXXXXXXX----XXXXXXXXXXXXXXXXXXXXXXXX-y-rkg-XXXXXXXXXXXXXX--g--r-XXXXXXXXXXXXXXXXXXXXXXXXXXXXXXXXXXXXXXXXXXXXXXXXXXXXXXXXXXXXXXXXXXXXXXX-----------G-ry-XXXXXXXXXXXXXXXXXXXXXXXXXX-
XXXXXXXXXXXXXXXXXXXXXXXXXXXXXXXXXXXXXXXXXXXXXXXXXXXXXXXXXXXXXXXXXXXXXXXXXXXXXXXXXXXXXXXXXXXXXXXXXXXXXXXXXXXXXXXXXXXXXXXXXXXXXXXXXXXXXXXXXXXXXXXXXXXXXXXXXXXXXXXXXXXXXXXXXXXXXXXXXXXXXXXXXXXXXXXXXXXXXXXX

