--------------------------------------------------------------------------------------------------------------------------------------------------------------------------------------------------------
--------------------------------------------------------------------------------------------------------------------------------------------------------------------------------------------------------
--------------------------------------------------------------------------------------------------------------------------------------------------------------------------------------------------------
--------------------------------------------------------------------------------------------------------------------------------------------------------------------------------------------------------
--------------------------------------------------------------------------------------------------------------------------------------------------------------------------------------------------------
--------------------------------------------------------------------------------------------------------------------------------------------------------------------------------------------------------
--------------------------------------------------------------------------------------------------------------------------------------------------------------------------------------------------------
--------------------------------------------------------------------------------------------------------------------------------------------------------------------------------------------------------
--------------------------------------------------------------------------------------------------------------------------------------------------------------------------------------------------------
--------------------------------------------------------------------------------------------------------------------------------------------------------------------------------------------------------
--------------------------------------------------------------------------------------------------------------------------------------------------------------------------------------------------------
--------------------------------------------------------------------------------------------------------------------------------------------------------------------------------------------------------
---------------------------oSoo-------------------------------------------------------------------------------------------------------------------------------------------------------------------------
-----------------------------------------ooSoo-------------oSo------------------------------------------------------------------------------------------------------------------------------------------
----------------------------oo----------------------------------------------ooo-------------------------oooooSo--------------------------------------------Soo----------------------oSSooo--------ooooo-
----------------------------r---y-------ooooo----------------oo-------------------------------oSoSoooo--------------------------------------------------------------------------------------------------
----------XX-oooooo------XXXXXXXXXXXXXX-y----G--------r-----gK-r-------XXXX---oo--------------------------oooooo-----------XXX-----XXXXX-----------oo---ooooooo----------XXXXXXXX----oooooo----oooooo---
XXXXXXXXXXXX-----gG-XXXXXXXXXXXXXXXXXXXXXXXXXXXXXXXXXXXXXXXXXXXXXXXXXXXXXXX---------XXXXXXXX----ooooo---Y-g----r-------XXXXXXX-----XXXXX-----------G------ry--rK------XXXXXXXXXXX---G-----Ggg--G-gR---y-
XXXXXXXXXXXXXXXXXXXXXXXXXXXXXXXXXXXXXXXXXXXXXXXXXXXXXXXXXXXXXXXXXXXXXXXXXXXXXXXXXXXXXXXXXXXX-G------r--XXXXXXXXXXX-----XXXXXXX-----XXXXX---y-----XXXXXXXXXXXXXXXXXXXXXXXXXXXXXXXX--XXXXXXXXXXXXXXXXXXXXX
XXXXXXXXXXXXXXXXXXXXXXXXXXXXXXXXXXXXXXXXXXXXXXXXXXXXXXXXXXXXXXXXXXXXXXXXXXXXXXXXXXXXXXXXXXXXXXXXXXXXXXXXXXXXXXXXXXXXXXXXXXXXXXXXXXXXXXXXXXXXXXXXXXXXXXXXXXXXXXXXXXXXXXXXXXXXXXXXXXXXXXXXXXXXXXXXXXXXXXXX

