--------------------------------------------------------------------------------------------------------------------------------------------------------------------------------------------------------
--------------------------------------------------------------------------------------------------------------------------------------------------------------------------------------------------------
--------------------------------------------------------------------------------------------------------------------------------------------------------------------------------------------------------
--------------------------------------------------------------------------------------------------------------------------------------------------------------------------------------------------------
--------------------------------------------------------------------------------------------------------------------------------------------------------------------------------------------------------
--------------------------------------------------------------------------------------------------------------------------------------------------------------------------------------------------------
--------------------------------------------------------------------------------------------------------------------------------------------------------------------------------------------------------
--------------------------------------------------------------------------------------------------------------------------------------------------------------------------------------------------------
--------------------------------------------------------------------------------------------------------------------------------------------------------------------------------------------------------
--------------------------------------------------------------------------------------------------------------------------------------------------------------------------------------------------------
--------------------------------------------------------------------------------------------------------------------------------------------------------------------------------------------------------
--------------------------------------------------------------------------------------------------------------------------------------------------------------------------------------------------------
-----------oSoo---------------------------------------oooSo--ooo------------------SoSoSo-------------------------------------------------------------oSSSoo--------------oooo---------------------------
-----------------------ooo--------------------------------------------SoooSoS------------------------------------------------------------------------------------Soo------------------------------------
-------------oo-----------------------------------------ooo----oooo----------------ooo-----------------oooo---------------------------------------------oooo-------------oo-----ooo---------------oo----
-------------g-------oooooo----------------------------R-------ry----ooooooooo--------------oo-----------g-------------oooS------------------------------yg-R-----oo--G---y---------------------K-------
----------XXXXXX-------------------------------------XXXXXXXXXXXXXXX--Y----r-r-XXXXXXXXXX--G-K----XXXXXXXXXX-------------------------------------YG-XXXXXXXXXX--y----XXXXXXXXX---------oooo---XXXXXXXXXX
----------XXXXXX---XXXXXXXXX-----XXXX----------ooooo-XXXXXXXXXXXXXXXXXXXXXXXXXXXXXXXXXXXXXXXXXX---XXXXXXXXXX---------oooooo------oo----------XXXXXXXXXXXXXXXXXXXXXXXXXXXXXXXXX----g------gg---XXXXXXXXXX
----------XXXXXXXXXXXXXXXXXX-----XXXX---XXXXX--------XXXXXXXXXXXXXXXXXXXXXXXXXXXXXXXXXXXXXXXXXXXXXXXXXXXXXXX----XXXX------k-----Y--------XXXXXXXXXXXXXXXXXXXXXXXXXXXXXXXXXXXXXXXXXXXXXXXXXXXXXXXXXXXXXXX
XXXXXXXXXXXXXXXXXXXXXXXXXXXXXXXXXXXXXXXXXXXXXXXXXXXXXXXXXXXXXXXXXXXXXXXXXXXXXXXXXXXXXXXXXXXXXXXXXXXXXXXXXXXXXXXXXXXXXXXXXXXXXXXXXXXXXXXXXXXXXXXXXXXXXXXXXXXXXXXXXXXXXXXXXXXXXXXXXXXXXXXXXXXXXXXXXXXXXXXX

