--------------------------------------------------------------------------------------------------------------------------------------------------------------------------------------------------------
--------------------------------------------------------------------------------------------------------------------------------------------------------------------------------------------------------
--------------------------------------------------------------------------------------------------------------------------------------------------------------------------------------------------------
--------------------------------------------------------------------------------------------------------------------------------------------------------------------------------------------------------
--------------------------------------------------------------------------------------------------------------------------------------------------------------------------------------------------------
--------------------------------------------------------------------------------------------------------------------------------------------------------------------------------------------------------
--------------------------------------------------------------------------------------------------------------------------------------------------------------------------------------------------------
--------------------------------------------------------------------------------------------------------------------------------------------------------------------------------------------------------
--------------------------------------------------------------------------------------------------------------------------------------------------------------------------------------------------------
--------------------------------------------------------------------------------------------------------------------------------------------------------------------------------------------------------
--------------------------------------------------------------------------------------------------------------------------------------------------------------------------------------------------------
--------------------------------------------------------------------------------------------------------------------------------------------------------------------------------------------------------
--------------------------------------oooooo----------------------ooSSS------------------------------------------------------------------------------------------------------oooo-----------------------
--------------ooSo------------------------------------------------------------------------------------------------------oooSoo--------ooSS--------------------------------------------------------------
----------------------------------------ooooo----------------------oooooo---------------------------------oooo---------------------------------------Soooooo----------------ooooo--ooooo--ooSooSo-------
--------------ooooo----oooSSo--------g-kgr-gR-----------------------Y-----------------------------oo-----------------ooooooooo------oooooooo------------------------oooo---Kk--r---y--------------------
------------gk---k-k-----------ooo--XXXXXXXXXXX-----------r------XXXXXXXXXX---------------------K---y-y-----oo-------kG--------XXX--y-k-gR---XX-----oooooo----oooo----kyk-XXXXXXXXXXXXXXX---ooooo-------
-----------XXXXXXXXXX--ooo-----kYy--XXXXXXXXXXX--------%%%%------XXXXXXXXXX------XXXXX-------XXXXXXXXXXX-G----Gy-XXXXXXXXXXXXXXXXXXXXXXXXXXXXXXXXXX-k----yr---k----XXXXXXXXXXXXXXXXXXXXXX--g--y---------
XXXXXXXXXXXXXXXXXXXXX-----yK--XXXXXXXXXXXXXXXXX--------||R|---XXXXXXXXXXXXX----XXXXXXX-k-----XXXXXXXXXXXXXXXXXXXXXXXXXXXXXXXXXXXXXXXXXXXXXXXXXXXXXXXXXXXXXXXXXXXXXXXXXXXXXXXXXXXXXXXXXXXXXXXXXXXXXXXXXXX
XXXXXXXXXXXXXXXXXXXXXXXXXXXXXXXXXXXXXXXXXXXXXXXXXXXXXXXXXXXXXXXXXXXXXXXXXXXXXXXXXXXXXXXXXXXXXXXXXXXXXXXXXXXXXXXXXXXXXXXXXXXXXXXXXXXXXXXXXXXXXXXXXXXXXXXXXXXXXXXXXXXXXXXXXXXXXXXXXXXXXXXXXXXXXXXXXXXXXXXX

