--------------------------------------------------------------------------------------------------------------------------------------------------------------------------------------------------------
--------------------------------------------------------------------------------------------------------------------------------------------------------------------------------------------------------
--------------------------------------------------------------------------------------------------------------------------------------------------------------------------------------------------------
--------------------------------------------------------------------------------------------------------------------------------------------------------------------------------------------------------
--------------------------------------------------------------------------------------------------------------------------------------------------------------------------------------------------------
--------------------------------------------------------------------------------------------------------------------------------------------------------------------------------------------------------
--------------------------------------------------------------------------------------------------------------------------------------------------------------------------------------------------------
--------------------------------------------------------------------------------------------------------------------------------------------------------------------------------------------------------
--------------------------------------------------------------------------------------------------------------------------------------------------------------------------------------------------------
--------------------------------------------------------------------------------------------------------------------------------------------------------------------------------------------------------
--------------------------------------------------------------------------------------------------------------------------------------------------------------------------------------------------------
--------------------------------------------------------------------------------------------------------------------------------------------------------------------------------------------------------
----------------------------------------------------------------------SoSo---------oooSooSo----------------------oSooooS--------------------------------------------------------------------------------
-------------------oooo-------------------------------------------------------------------------------------------------------------------------------oooSo----------------------oSooo------------------
------------------------------------------------------oooS------------oooooo----------oooooo-----ooSo------SSo--oooooooo-----------------oooSooo--------------------------------------------------------
------------------ooooo--oooooo----------------------------------------k---------------r-g-------------------------G----------------------------------oooo-------------ooS------oooo-------------oSSoo--
------------------G-K------------------------XXXXX-oooooooo---oo----XXXXXXXXXXXX--XXXXXXXXXXX--oooooo---oooooo-XXXXXXXXXXX---oo----------oooooooo--gr--r-Kr----------------------k--yr-----------------X
XXXXXXXXXXXXXXXXXXXXXXXX--ooooo-XXXXX-----XXXXXXXX----gK-r----y-y---XXXXXXXXXXXX--XXXXXXXXXXX-g-g--------gk--G-XXXXXXXXXXX--y-R--yg--K--r-Y-k-----XXXXXXXXXX------------ooo---XXXXXXXXX---------ooooo--X
XXXXXXXXXXXXXXXXXXXXXXXX---yY---XXXXX-----XXXXXXXXXXXXXXXXXXXXXXXXXXXXXXXXXXXXXX--XXXXXXXXXXXXXXXXXXXXXXXXXXXXXXXXXXXXXXXXXXXXXXXXXXXXXXXXXXXXXXXXXXXXXXXXXX---R-----k-y--r---XXXXXXXXX---------y---g--X
XXXXXXXXXXXXXXXXXXXXXXXXXXXXXXXXXXXXXXXXXXXXXXXXXXXXXXXXXXXXXXXXXXXXXXXXXXXXXXXXXXXXXXXXXXXXXXXXXXXXXXXXXXXXXXXXXXXXXXXXXXXXXXXXXXXXXXXXXXXXXXXXXXXXXXXXXXXXXXXXXXXXXXXXXXXXXXXXXXXXXXXXXXXXXXXXXXXXXXXX

