--------------------------------------------------------------------------------------------------------------------------------------------------------------------------------------------------------
--------------------------------------------------------------------------------------------------------------------------------------------------------------------------------------------------------
--------------------------------------------------------------------------------------------------------------------------------------------------------------------------------------------------------
--------------------------------------------------------------------------------------------------------------------------------------------------------------------------------------------------------
--------------------------------------------------------------------------------------------------------------------------------------------------------------------------------------------------------
--------------------------------------------------------------------------------------------------------------------------------------------------------------------------------------------------------
--------------------------------------------------------------------------------------------------------------------------------------------------------------------------------------------------------
--------------------------------------------------------------------------------------------------------------------------------------------------------------------------------------------------------
--------------------------------------------------------------------------------------------------------------------------------------------------------------------------------------------------------
--------------------------------------------------------------------------------------------------------------------------------------------------------------------------------------------------------
--------------------------------------------------------------------------------------------------------------------------------------------------------------------------------------------------------
--------------------------------------------------------------------------------------------------------------------------------------------------------------------------------------------------------
--------------------------oSSoSoo--------------------------------------------------------------------------------------------------------------------------------------------------------oSo------------
----------------------------------------------oooo--------ooSo-------ooo----------------------------------------------------------------------------oSoo--oooSSooSo-------------------------------------
--------------------------oooo-----oooooo--------------------------------------------oooo--------------------oSo----------oSooS-------------------------------------------------------oooooo------------
------------ooSo-----------r----g-------r------oo---------ooooo-------------------------r-----oo----ooo--------------------------------------------oo--------oooo------------------------R-R------------
XXXXXXXXXXX---------XXXXXXXXXXXXXXXXXXXXXXX--R--k--------r-g-G------y---G-----------XXXXXX------GY------------ooo--------ooooooo---------------------g-K--G-----g-r---------k--------XXXXXXXXX----------
XXXXXXXXXXX---oo-XXXXXXXXXXXXXXXXXXXXXXXXXXXXXXXXXXX---XXXXXXXXX---XXXXXXX----------XXXXXXXXXXXXXXX-----------G----------G-k-yy----XX-------------XXXXXXXXXXXXXXXXXXXXX--XXXXXXXX----XXXXXXXXX----------
XXXXXXXXXXX-yRY--XXXXXXXXXXXXXXXXXXXXXXXXXXXXXXXXXXX---XXXXXXXXX---XXXXXXX-g--------XXXXXXXXXXXXXXX-y-ykY--XXXXXXXXX----XXXXXXXXX--XXXXX-----XXXXXXXXXXXXXXXXXXXXXXXXXXXXXXXXXXXX----XXXXXXXXXXXXXXXXXXX
XXXXXXXXXXXXXXXXXXXXXXXXXXXXXXXXXXXXXXXXXXXXXXXXXXXXXXXXXXXXXXXXXXXXXXXXXXXXXXXXXXXXXXXXXXXXXXXXXXXXXXXXXXXXXXXXXXXXXXXXXXXXXXXXXXXXXXXXXXXXXXXXXXXXXXXXXXXXXXXXXXXXXXXXXXXXXXXXXXXXXXXXXXXXXXXXXXXXXXXX

