--------------------------------------------------------------------------------------------------------------------------------------------------------------------------------------------------------
--------------------------------------------------------------------------------------------------------------------------------------------------------------------------------------------------------
--------------------------------------------------------------------------------------------------------------------------------------------------------------------------------------------------------
--------------------------------------------------------------------------------------------------------------------------------------------------------------------------------------------------------
--------------------------------------------------------------------------------------------------------------------------------------------------------------------------------------------------------
--------------------------------------------------------------------------------------------------------------------------------------------------------------------------------------------------------
--------------------------------------------------------------------------------------------------------------------------------------------------------------------------------------------------------
--------------------------------------------------------------------------------------------------------------------------------------------------------------------------------------------------------
--------------------------------------------------------------------------------------------------------------------------------------------------------------------------------------------------------
--------------------------------------------------------------------------------------------------------------------------------------------------------------------------------------------------------
--------------------------------------------------------------------------------------------------------------------------------------------------------------------------------------------------------
--------------------------------------------------------------------------------------------------------------------------------------------------------------------------------------------------------
-----------------------------ooSoS---------------------------------------------------------------------------------------oooSo----------oSSoo-----------------------------------------oSSo--------------
---------------------------------------------------------------------------------------------ooooSoo------------ooooSo-------------------------------oSSSoo---------------ooSoSoo-----------------------
--------------------------------ooo-----------------oooSo-----------------------------oo---------------------------------ooo--------------oo---------------------oooS--------------oooooo---------------
----------------SSo-------------k-yy--------------------------------oooo-----ooo---------------oooooo------------oooo---rYr--------------g-r---------ooooo----------------ooooooo--g--------------------
----------------------------XXXXXXXXX---------------ooooooo-----------------------XXXXXXXX---r------y-----XXX---y--R---XXXXXXXX-------XXXXXXXXX------k------k----oooo----k---Kk---XXXXXXXXXX------------
XXXXXXXXXXXXX-----------XXXXXXXXXXXXX------oooo-----------------GR---oo-------ooo-XXXXXXXXXXXXXXXXXXXXXXXXXXXXXXXXXXXXXXXXXXXXX--ooo--XXXXXXXXX----XXXXXXXXXXX--kk-----XXXXXXXXXXXXXXXXXXXXXXXXXX-------
XXXXXXXXXXXXX-------XXXXXXXXXXXXXXXXX-------r---k-XXXXXXXXXXXXXXXXX--G------r--r--XXXXXXXXXXXXXXXXXXXXXXXXXXXXXXXXXXXXXXXXXXXXX--rr---XXXXXXXXXXXXXXXXXXXXXXXXXXXXXXXXXXXXXXXXXXXXXXXXXXXXXXXXXXX----R--
XXXXXXXXXXXXXXXXXXXXXXXXXXXXXXXXXXXXXXXXXXXXXXXXXXXXXXXXXXXXXXXXXXXXXXXXXXXXXXXXXXXXXXXXXXXXXXXXXXXXXXXXXXXXXXXXXXXXXXXXXXXXXXXXXXXXXXXXXXXXXXXXXXXXXXXXXXXXXXXXXXXXXXXXXXXXXXXXXXXXXXXXXXXXXXXXXXXXXXXX

