--------------------------------------------------------------------------------------------------------------------------------------------------------------------------------------------------------
--------------------------------------------------------------------------------------------------------------------------------------------------------------------------------------------------------
--------------------------------------------------------------------------------------------------------------------------------------------------------------------------------------------------------
--------------------------------------------------------------------------------------------------------------------------------------------------------------------------------------------------------
--------------------------------------------------------------------------------------------------------------------------------------------------------------------------------------------------------
--------------------------------------------------------------------------------------------------------------------------------------------------------------------------------------------------------
--------------------------------------------------------------------------------------------------------------------------------------------------------------------------------------------------------
--------------------------------------------------------------------------------------------------------------------------------------------------------------------------------------------------------
--------------------------------------------------------------------------------------------------------------------------------------------------------------------------------------------------------
--------------------------------------------------------------------------------------------------------------------------------------------------------------------------------------------------------
--------------------------------------------------------------------------------------------------------------------------------------------------------------------------------------------------------
--------------------------------------------------------------------------------------------------------------------------------------------------------------------------------------------------------
----------------------------------------------------------------------------------------------------------------ooS-----------------------------------------------------------------------SoS----Soo----
--------------------------SSoS---------------------------------oooS---------------------------ooSoSSoo------------------oSooo---------------------------------------------------------------------------
-----------------------------------------------------------------------ooSSo------------------------------------ooooo------------ooooo-------------------------------------oSoS---------oooo-----oooooo-
------------------Sooo--oooooooo-------------------------------ooo-------------------------------ooooo----------yrRk-k--------------------------------oSSoSo--ooo--------------------------r-g--------y-
--------------------------g-----R---------ooooo------oooo-------y-K-----oo------------XXXX---------Y---XXXXX--XXXXXXXXX--g--------------XXXXXXXXXXX----------------------oooooooo------XXXXXXXXXXXXXXXXX
-----------------------XXXXXXXXXXX--ooo-----r---XXX--r------XXXXXXXXXX----k-Y---------XXXXXXXXXXXXXXXXXXXXXX--XXXXXXXXXXXXXXXXX----K----XXXXXXXXXXX---oooooo-XXXXXXXXXX------gR---XXX--XXXXXXXXXXXXXXXXX
------------XX--y---Y--XXXXXXXXXXX-G-g---XXXXXXXXXXXXXXXXXXXXXXXXXXXXXXXXXXXXXXXXXXXXXXXXXXXXXXXXXXXXXXXXXXXXXXXXXXXXXXXXXXXXXXXXXXXXXXXXXXXXXXXXXX-g------r-XXXXXXXXXXXXXXXXXXXXXXXX--XXXXXXXXXXXXXXXXX
XXXXXXXXXXXXXXXXXXXXXXXXXXXXXXXXXXXXXXXXXXXXXXXXXXXXXXXXXXXXXXXXXXXXXXXXXXXXXXXXXXXXXXXXXXXXXXXXXXXXXXXXXXXXXXXXXXXXXXXXXXXXXXXXXXXXXXXXXXXXXXXXXXXXXXXXXXXXXXXXXXXXXXXXXXXXXXXXXXXXXXXXXXXXXXXXXXXXXXXX

