--------------------------------------------------------------------------------------------------------------------------------------------------------------------------------------------------------
--------------------------------------------------------------------------------------------------------------------------------------------------------------------------------------------------------
--------------------------------------------------------------------------------------------------------------------------------------------------------------------------------------------------------
--------------------------------------------------------------------------------------------------------------------------------------------------------------------------------------------------------
--------------------------------------------------------------------------------------------------------------------------------------------------------------------------------------------------------
--------------------------------------------------------------------------------------------------------------------------------------------------------------------------------------------------------
--------------------------------------------------------------------------------------------------------------------------------------------------------------------------------------------------------
--------------------------------------------------------------------------------------------------------------------------------------------------------------------------------------------------------
--------------------------------------------------------------------------------------------------------------------------------------------------------------------------------------------------------
--------------------------------------------------------------------------------------------------------------------------------------------------------------------------------------------------------
--------------------------------------------------------------------------------------------------------------------------------------------------------------------------------------------------------
--------------------------------------------------------------------------------------------------------------------------------------------------------------------------------------------------------
------------------------ooSooooS-----oSoS-------Soo--------------------------------------oooo-------------------------------oSSo------------------------------------------------------------------------
------------------------------------------------------------------ooo------oSo----------------------------------oooSSo-----------------------SSo-------------oSo----------------------Soo---------------
---------------ooooooo-----ooo-------oooo-------oooo----------------------------------------oo-----------------------------------------------------oooo-------------------------------------------------
-------------------------gk---yg------Y--k------R--r-------------ooo-----oooo-----------------G--------------------ooo------------oooSo-----ooo---Y-k---------ooo----oooooo----------oo-----------------
------------------ooo--XXXXXXXXXXXXXXXXXXXXXXXXXXXXXXXXXXX--------y-y-y--k---y----------XXXXXXXX-----------------gg--kY---XXXXXXX-----------y--r-XXXXXXXXX-----K-g------y-r-XXXX------yK--XXX-----------
----------------Y------XXXXXXXXXXXXXXXXXXXXXXXXXXXXXXXXXXX------XXXXXXXXXXXXXXXXX-------XXXXXXXX--oo------G----XXXXXXXXXXXXXXXXXX----ooo---XXXXXXXXXXXXXXXXXXXXXXXXXXXXXXXXXXXXX----XXXXXXXXX--g--y-----
XXXXXXXXXX----XXXXXXXXXXXXXXXXXXXXXXXXXXXXXXXXXXXXXXXXXXXX-gY---XXXXXXXXXXXXXXXXX-------XXXXXXXX--grk---XXXXXXXXXXXXXXXXXXXXXXXXX--k-gk----XXXXXXXXXXXXXXXXXXXXXXXXXXXXXXXXXXXXX----XXXXXXXXXXXXXXXX----
XXXXXXXXXXXXXXXXXXXXXXXXXXXXXXXXXXXXXXXXXXXXXXXXXXXXXXXXXXXXXXXXXXXXXXXXXXXXXXXXXXXXXXXXXXXXXXXXXXXXXXXXXXXXXXXXXXXXXXXXXXXXXXXXXXXXXXXXXXXXXXXXXXXXXXXXXXXXXXXXXXXXXXXXXXXXXXXXXXXXXXXXXXXXXXXXXXXXXXXX

