--------------------------------------------------------------------------------------------------------------------------------------------------------------------------------------------------------
--------------------------------------------------------------------------------------------------------------------------------------------------------------------------------------------------------
--------------------------------------------------------------------------------------------------------------------------------------------------------------------------------------------------------
--------------------------------------------------------------------------------------------------------------------------------------------------------------------------------------------------------
--------------------------------------------------------------------------------------------------------------------------------------------------------------------------------------------------------
--------------------------------------------------------------------------------------------------------------------------------------------------------------------------------------------------------
--------------------------------------------------------------------------------------------------------------------------------------------------------------------------------------------------------
--------------------------------------------------------------------------------------------------------------------------------------------------------------------------------------------------------
--------------------------------------------------------------------------------------------------------------------------------------------------------------------------------------------------------
--------------------------------------------------------------------------------------------------------------------------------------------------------------------------------------------------------
--------------------------------------------------------------------------------------------------------------------------------------------------------------------------------------------------------
--------------------------------------------------------------------------------------------------------------------------------------------------------------------------------------------------------
------------------------------------------------------------------------ooooo-----SSo----------ooo-----------ooo----------------------------------------------------------------------------------------
------------------------------------------Sooo---------------------------------------------------------------------------------------oooooo----oooSSoo--------------------------------------------------
------------------------oSoSSSoo--------------------------------Sooo---oooooo----oooooo--------------------oooooo----oooSo-----------------------------------oooooS----------------oo-------------------
----------------ooo-----------------------oooo----oSoooS------------------g-G---------K-------r--y---------y-g--r----------------------oooooo----oooo-----------------------------Y-R-g----r------------
--------------------------oooo-----ooo--ky-rG-------------XX-oooooooo-XXXXXXXXXXXXXXXXXX-----XXXXXX-------XXXXXXXXXX---ooo--XX-------y--g------k-r--K----------ooooooo-XX--------XXXXXXXXXXXXXX---------
XXXXXXXXXXXXX-oooooo-----g--k-------gr-XXXXXXXXX---oooo---XX---k------XXXXXXXXXXXXXXXXXXXXXXXXXXXXX---ooo-XXXXXXXXXX--------XXXXXXXXXXXXXXXXXXXXXXXXXXX-------y---k----XX--------XXXXXXXXXXXXXX---------
XXXXXXXXXXXXX-r---gg---XXXXXXXXXXXXXXXXXXXXXXXXX--y----ky-XXXXXXXXXXXXXXXXXXXXXXXXXXXXXXXXXXXXXXXXX-g--r--XXXXXXXXXXXXXXXXXXXXXXXXXXXXXXXXXXXXXXXXXXXXX-----XXXXXXXXXXXXX--------XXXXXXXXXXXXXX----y-XXX
XXXXXXXXXXXXXXXXXXXXXXXXXXXXXXXXXXXXXXXXXXXXXXXXXXXXXXXXXXXXXXXXXXXXXXXXXXXXXXXXXXXXXXXXXXXXXXXXXXXXXXXXXXXXXXXXXXXXXXXXXXXXXXXXXXXXXXXXXXXXXXXXXXXXXXXXXXXXXXXXXXXXXXXXXXXXXXXXXXXXXXXXXXXXXXXXXXXXXXXX

