--------------------------------------------------------------------------------------------------------------------------------------------------------------------------------------------------------
--------------------------------------------------------------------------------------------------------------------------------------------------------------------------------------------------------
--------------------------------------------------------------------------------------------------------------------------------------------------------------------------------------------------------
--------------------------------------------------------------------------------------------------------------------------------------------------------------------------------------------------------
--------------------------------------------------------------------------------------------------------------------------------------------------------------------------------------------------------
--------------------------------------------------------------------------------------------------------------------------------------------------------------------------------------------------------
--------------------------------------------------------------------------------------------------------------------------------------------------------------------------------------------------------
--------------------------------------------------------------------------------------------------------------------------------------------------------------------------------------------------------
--------------------------------------------------------------------------------------------------------------------------------------------------------------------------------------------------------
--------------------------------------------------------------------------------------------------------------------------------------------------------------------------------------------------------
--------------------------------------------------------------------------------------------------------------------------------------------------------------------------------------------------------
--------------------------------------------------------------------------------------------------------------------------------------------------------------------------------------------------------
--------------------------------------------------------------------------------------oSoooo-----------------------------------ooooSS-------------ooSo----------------oSSo------------------------------
--------------------------------------------------------------------------------------------------------------------------------------------------------------------------------------------------------
----------------------oooooSS-----------------------------------oooSoo-----------------ooo----ooSoooo----------------------------oooo-------------oooooo-------oSoSo---------------------Soooo----------
-------------------------------------------------ooooSooSo---------------------------gGgrg-----------------oooSooS-------------k-rKrrg---------------------------------k-------ooo----------------------
----------------------ooooooo--XX----------------------------------ooo--------g----XXXXXXXXXX---oooo---XXX-------------------XXXXXXXXXX----------XXXXXXXX------ooo---XXXXXX--------XXXX-ooo-------------
----------------------kY-r---g-XX--------ooo------oooooo--------kY--------XXXXXXXXXXXXXXXXXXX-k---y-Yg-XXX--oooo-------------XXXXXXXXXX-----XXXXXXXXXXXXX----Y---gr--XXXXXX--ooooo-XXXX----ky-----------
XXXXXXXXXXX-----XXXXXXXXXXXXXXXXX---XXX----------G-kK----------XXXXXXXXXXXXXXXXXXXXXXXXXXXXXXXXXXXXXXXXXXX-------y-----------XXXXXXXXXXXXXXXXXXXXXXXXXXXXXXXXXXXXXXXXXXXXXX--rK----XXXXXXXXXXXXXXXX-----
XXXXXXXXXXXXXXXXXXXXXXXXXXXXXXXXXXXXXXXXXXXXXXXXXXXXXXXXXXXXXXXXXXXXXXXXXXXXXXXXXXXXXXXXXXXXXXXXXXXXXXXXXXXXXXXXXXXXXXXXXXXXXXXXXXXXXXXXXXXXXXXXXXXXXXXXXXXXXXXXXXXXXXXXXXXXXXXXXXXXXXXXXXXXXXXXXXXXXXXX

