--------------------------------------------------------------------------------------------------------------------------------------------------------------------------------------------------------
--------------------------------------------------------------------------------------------------------------------------------------------------------------------------------------------------------
--------------------------------------------------------------------------------------------------------------------------------------------------------------------------------------------------------
--------------------------------------------------------------------------------------------------------------------------------------------------------------------------------------------------------
--------------------------------------------------------------------------------------------------------------------------------------------------------------------------------------------------------
--------------------------------------------------------------------------------------------------------------------------------------------------------------------------------------------------------
--------------------------------------------------------------------------------------------------------------------------------------------------------------------------------------------------------
--------------------------------------------------------------------------------------------------------------------------------------------------------------------------------------------------------
--------------------------------------------------------------------------------------------------------------------------------------------------------------------------------------------------------
--------------------------------------------------------------------------------------------------------------------------------------------------------------------------------------------------------
--------------------------------------------------------------------------------------------------------------------------------------------------------------------------------------------------------
--------------------------------------------------------------------------------------------------------------------------------------------------------------------------------------------------------
---------------------------oSoo-------------------------------------------------------------------------------------------------------------------------------------------------------------------------
----------------------------------------------------------------------------Sooooo----------------------------------------------------------------------------------------------------------------------
-----------------SSoS------oooo----------------SSo-------oSoSS----------------------oo--------oSooSo-------------ooS---------------------------------------Soo------------------------------------------
--------------------------r-yYR---------------------------------------------ooo-----kk----------------oSSo-------------------------------ooo------------------------------------------------ooSSo----Gy-
-----------------oooo----XXXXXXXXX------------oo---XXX---oooo--------------g-k--r--XXXXXXX---oooooo--------------------XXX---------------RY-Rr----------oooooooo-XX---------------ooo-------------XXXXXX
XXXXXXXXXXXXXX------y-yk-XXXXXXXXXXXX--ooo---g--k--XXX-----yy----------XXXXXXXXXXXXXXXXXXX-r-yy--rR------oo------gggrY-XXX------------XXXXXXXXXXXXXXXXX--Y----Yr-XXXXXX-oo----------Y--------oooo-XXXXXX
XXXXXXXXXXXXXXXXXXXXXXXXXXXXXXXXXXXXX-Y-r---XXXXXXXXXXXXXXXXXXXXX------XXXXXXXXXXXXXXXXXXXXXXXXXXXXXX--k---k-XXXXXXXXXXXXXXXXXX--XXXXXXXXXXXXXXXXXXXXXXXXXXXXXXXXXXXXXX-r--------XXXXXXXX-GYk---R-XXXXXX
XXXXXXXXXXXXXXXXXXXXXXXXXXXXXXXXXXXXXXXXXXXXXXXXXXXXXXXXXXXXXXXXXXXXXXXXXXXXXXXXXXXXXXXXXXXXXXXXXXXXXXXXXXXXXXXXXXXXXXXXXXXXXXX--XXXXXXXXXXXXXXXXXXXXXXXXXXXXXXXXXXXXXXXXXXXXXXXXXXXXXXXXXXXXXXXXXXXXXXX

