--------------------------------------------------------------------------------------------------------------------------------------------------------------------------------------------------------
--------------------------------------------------------------------------------------------------------------------------------------------------------------------------------------------------------
--------------------------------------------------------------------------------------------------------------------------------------------------------------------------------------------------------
--------------------------------------------------------------------------------------------------------------------------------------------------------------------------------------------------------
--------------------------------------------------------------------------------------------------------------------------------------------------------------------------------------------------------
--------------------------------------------------------------------------------------------------------------------------------------------------------------------------------------------------------
--------------------------------------------------------------------------------------------------------------------------------------------------------------------------------------------------------
--------------------------------------------------------------------------------------------------------------------------------------------------------------------------------------------------------
--------------------------------------------------------------------------------------------------------------------------------------------------------------------------------------------------------
--------------------------------------------------------------------------------------------------------------------------------------------------------------------------------------------------------
--------------------------------------------------------------------------------------------------------------------------------------------------------------------------------------------------------
--------------------------------------------------------------------------------------------------------------------------------------------------------------------------------------------------------
---------------------------------------------------------------------------------------------------------------------------------------------oooSoo---------------------ooo-----------------------------
-----------------oooo----------------------ooooS--------------------------------------------------------------------------------------------------------------------------------------------------------
-----------------------------------------------------SoSoo------oooo------------------------------------SoS---ooSoooo---------------------------ooo---------------------oo------------oooo-----oooo-----
---------------------------------------------oooo-----------------------yG-----------------oSoSo---------------------------------oooSo------------gk------------oSo------r-----------YRy----------------
-------------------------------XX----------r-YyGYk---ooooo------oo---XXXXXXX-------XXX-------------------oo-----ooo-------------------------XXXXXXXXXXXXXXXXX---------XXXXXX--------XXXXXXX---oooooo----
XXXXXXXXXXXXXXXXXXXXXXX-oooooo-XXXXXXX---XXXXXXXXXX-------r-----r--y-XXXXXXX---XXXXXXX------ooo---------------g---g---XXXXX------ooooo------XXXXXXXXXXXXXXXXX--ooo----XXXXXXXX------XXXXXXX---k-----R-XX
XXXXXXXXXXXXXXXXXXXXXXX-r--y---XXXXXXX---XXXXXXXXXXXXXXXXXXXXXXXXXXXXXXXXXXXXXXXXXXXXX---------g------XXXXXXXXXXXXXXXXXXXXXXXXXX--------r---XXXXXXXXXXXXXXXXX----k-kY-XXXXXXXX-r----XXXXXXXXXXXXXXXXXXXX
XXXXXXXXXXXXXXXXXXXXXXXXXXXXXXXXXXXXXXXXXXXXXXXXXXXXXXXXXXXXXXXXXXXXXXXXXXXXXXXXXXXXXXXXXXXXXXXXXXXXXXXXXXXXXXXXXXXXXXXXXXXXXXXXXXXXXXXXXXXXXXXXXXXXXXXXXXXXXXXXXXXXXXXXXXXXXXXXXXXXXXXXXXXXXXXXXXXXXXXX

