--------------------------------------------------------------------------------------------------------------------------------------------------------------------------------------------------------
--------------------------------------------------------------------------------------------------------------------------------------------------------------------------------------------------------
--------------------------------------------------------------------------------------------------------------------------------------------------------------------------------------------------------
--------------------------------------------------------------------------------------------------------------------------------------------------------------------------------------------------------
--------------------------------------------------------------------------------------------------------------------------------------------------------------------------------------------------------
--------------------------------------------------------------------------------------------------------------------------------------------------------------------------------------------------------
--------------------------------------------------------------------------------------------------------------------------------------------------------------------------------------------------------
--------------------------------------------------------------------------------------------------------------------------------------------------------------------------------------------------------
--------------------------------------------------------------------------------------------------------------------------------------------------------------------------------------------------------
--------------------------------------------------------------------------------------------------------------------------------------------------------------------------------------------------------
--------------------------------------------------------------------------------------------------------------------------------------------------------------------------------------------------------
--------------------------------------------------------------------------------------------------------------------------------------------------------------------------------------------------------
-----------------------------------------------------------oooo---------------------------oooSS---------------------------------------------------------------------------------------------------------
----------------oooS------------------ooooSSo------------------------------------------------------------------------------------------------------------oooo-----------------ooSS---ooSSoo-------------
---------------------------------------------------------oooooooo---------SSo--------------ooooo------------------------------------------------ooSS----------------------------------------------------
---------------ooo-------ooo-----------ooo----------------GGr-----------------------ooo----Kgg--------ry---r---------------------------------------------ooooo-------ooS---------oo--oooooo-------------
----------------rGg----G-r------------k--Y-g------XXXXXXXXXXXXXXXXXXX------oooo----------XXXXXXXXX---XXXXXXXX-----------------------------G-----ooooo-XX---K-r------------------Y-k------y--------------
--------------XXXXXXXXXXXXXXXX-------XXXXXXXXX----XXXXXXXXXXXXXXXXXXX-------y----oooo----XXXXXXXXX---XXXXXXXXXXXX--k--------------------%%%-----------XXXXXXXXXXX----oooo-XXXXXXXXXXXXXXXXXX---------XXX
--------------XXXXXXXXXXXXXXXXXXXXXXXXXXXXXXXXXXXXXXXXXXXXXXXXXXXXXXXXXXXXXXXXXX---G-g-R-XXXXXXXXX---XXXXXXXXXXXXXXXXXXXXXX-Y--------g--G||--XXXXXXXXXXXXXXXXXXXX---k-----XXXXXXXXXXXXXXXXXXXXXXX----XXX
XXXXXXXXXXXXXXXXXXXXXXXXXXXXXXXXXXXXXXXXXXXXXXXXXXXXXXXXXXXXXXXXXXXXXXXXXXXXXXXXXXXXXXXXXXXXXXXXXXXXXXXXXXXXXXXXXXXXXXXXXXXXXXXXXXXXXXXXXXXXXXXXXXXXXXXXXXXXXXXXXXXXXXXXXXXXXXXXXXXXXXXXXXXXXXXXXXXXXXXX

