--------------------------------------------------------------------------------------------------------------------------------------------------------------------------------------------------------
--------------------------------------------------------------------------------------------------------------------------------------------------------------------------------------------------------
--------------------------------------------------------------------------------------------------------------------------------------------------------------------------------------------------------
--------------------------------------------------------------------------------------------------------------------------------------------------------------------------------------------------------
--------------------------------------------------------------------------------------------------------------------------------------------------------------------------------------------------------
--------------------------------------------------------------------------------------------------------------------------------------------------------------------------------------------------------
--------------------------------------------------------------------------------------------------------------------------------------------------------------------------------------------------------
--------------------------------------------------------------------------------------------------------------------------------------------------------------------------------------------------------
--------------------------------------------------------------------------------------------------------------------------------------------------------------------------------------------------------
--------------------------------------------------------------------------------------------------------------------------------------------------------------------------------------------------------
--------------------------------------------------------------------------------------------------------------------------------------------------------------------------------------------------------
--------------------------------------------------------------------------------------------------------------------------------------------------------------------------------------------------------
--------------------------------------------------------------------------------------------------------------------------------------------------------------------------------------------------------
----------------------------------------------------------------------oSooo-----------ooSSo--------ooSSooo----------------------------------------------------------------ooooSo------------------------
-------------------------------------------------------------------------------------------------------------------------------------------------------oooo---------------------------------------------
-------------------------------oooSSo--oSooSo---------------------------ooooo------ooooooo---------oooooooo----------------------oooSSSo----------------------------------oooooooo----------------------
----------------------------------------------------------------------------------------g------------------------------------------------XX-----------oooooo------XXX----------------------oooooo-------
XXXXXXXXXXXXXXXXXXXXXX----oo--oooooo-----oo----ooooooo---------------XXXXXXXXXXXXXXXXXXXXXXX--XXXXXXXXXXXXXX--------------------oooooooo-XXXXXXXXXX---------------XXXXXXXXXXXXXXXXX--oooo------g--XXXXX-
XXXXXXXXXXXXXXXXXXXXXX---------------------------------XXX-----------XXXXXXXXXXXXXXXXXXXXXXXXXXXXXXXXXXXXXXXXXXXXXXXXXXXXXX--------------XXXXXXXXXXXXXXXXXXXX-----XXXXXXXXXXXXXXXXX-------XXXXXXXXXXXXXX
XXXXXXXXXXXXXXXXXXXXXXXXXXXXXXXXXXXXXXXXXXXXXXXXXXXXXXXXXXXXXXXXXXXXXXXXXXXXXXXXXXXXXXXXXXXXXXXXXXXXXXXXXXXXXXXXXXXXXXXXXXXXXXXXXXXXXXXXXXXXXXXXXXXXXXXXXXXXXXXXXXXXXXXXXXXXXXXXXXXXXXXXXXXXXXXXXXXXXXXX

