--------------------------------------------------------------------------------------------------------------------------------------------------------------------------------------------------------
--------------------------------------------------------------------------------------------------------------------------------------------------------------------------------------------------------
--------------------------------------------------------------------------------------------------------------------------------------------------------------------------------------------------------
--------------------------------------------------------------------------------------------------------------------------------------------------------------------------------------------------------
--------------------------------------------------------------------------------------------------------------------------------------------------------------------------------------------------------
--------------------------------------------------------------------------------------------------------------------------------------------------------------------------------------------------------
--------------------------------------------------------------------------------------------------------------------------------------------------------------------------------------------------------
--------------------------------------------------------------------------------------------------------------------------------------------------------------------------------------------------------
--------------------------------------------------------------------------------------------------------------------------------------------------------------------------------------------------------
--------------------------------------------------------------------------------------------------------------------------------------------------------------------------------------------------------
--------------------------------------------------------------------------------------------------------------------------------------------------------------------------------------------------------
--------------------------------------------------------------------------------------------------------------------------------------------------------------------------------------------------------
------------------------------------oooSoo-------------------------oooS---------------------------------------------------------------------------------------------------------------------------oooo--
-----------------------------------------------------------------------------------------SSooooS---ooooSoo----------------------------------------------------------------------------------------------
----------------------oooSo--------ooooooo-----------------------oooo------oooSoo---------------------------------------------------------------oooooo-----ooo----------------------oSoooSo-------oooo--
------------------------------------g---------------------------g----g--------------------ooooooo-----ooooo--------------------ooo-------ooo-------g----g-----------------------------------------------
-----------g----XXXXX---ooo-------XXXXXXXXXXX----ooo--XXXX-----XXXXXXXXXX--oooooo--XXXX----g---------g-------XXXXX----------------------------XXXXXXXXXXXXXXXXX----ooo-------------ooooooo-------XXXXXXX
----------XXXXXXXXXXX-------------XXXXXXXXXXX---------XXXXXXXXXXXXXXXXXXX---g------XXXXXXXXXXXXXXXXXXXXXXXXXXXXXXX----ooo-----oooo-------oooo-XXXXXXXXXXXXXXXXX-----------oo--XXX--g-------------XXXXXXX
XXXXXXXXXXXXXXXXXXXXXXXXXXXXX-----XXXXXXXXXXXXXXXXXXXXXXXXXXXXXXXXXXXXXXXXXXXXXXXXXXXXXXXXXXXXXXXXXXXXXXXXXXXXXXXX-------g---------XXXXX------XXXXXXXXXXXXXXXXXXXXXXXXX-------XXXXXXXXXXXXXX-----XXXXXXX
XXXXXXXXXXXXXXXXXXXXXXXXXXXXXXXXXXXXXXXXXXXXXXXXXXXXXXXXXXXXXXXXXXXXXXXXXXXXXXXXXXXXXXXXXXXXXXXXXXXXXXXXXXXXXXXXXXXXXXXXXXXXXXXXXXXXXXXXXXXXXXXXXXXXXXXXXXXXXXXXXXXXXXXXXXXXXXXXXXXXXXXXXXXXXXXXXXXXXXXX

