--------------------------------------------------------------------------------------------------------------------------------------------------------------------------------------------------------
--------------------------------------------------------------------------------------------------------------------------------------------------------------------------------------------------------
--------------------------------------------------------------------------------------------------------------------------------------------------------------------------------------------------------
--------------------------------------------------------------------------------------------------------------------------------------------------------------------------------------------------------
--------------------------------------------------------------------------------------------------------------------------------------------------------------------------------------------------------
--------------------------------------------------------------------------------------------------------------------------------------------------------------------------------------------------------
--------------------------------------------------------------------------------------------------------------------------------------------------------------------------------------------------------
--------------------------------------------------------------------------------------------------------------------------------------------------------------------------------------------------------
--------------------------------------------------------------------------------------------------------------------------------------------------------------------------------------------------------
--------------------------------------------------------------------------------------------------------------------------------------------------------------------------------------------------------
--------------------------------------------------------------------------------------------------------------------------------------------------------------------------------------------------------
--------------------------------------------------------------------------------------------------------------------------------------------------------------------------------------------------------
----------------------------oooo-------------------------SoSS---------------------------------------------------SoSoooo---------------------------------------------------------------------------------
---------------------------------------------Sooo----------------------------------------------------------------------------------ooo----------------------------ooS----------------------Soooo--------
----------------------------ooo-----------------------ooooooo-----SoSoo------------------------------------------oooo------ooo--------------------------SoSooo---------------------oo-------------------
-----------oSSoooo------------------SSooo-----ooo-----------------------------------------------------SSoSSS----------------------------------------------------ooooo-----SSSo-----------ooooooooo------
---------------------------XXXXXX-----------------g--XXXXXXXXXX----ooo-----------XXXXXX------XXXXXXX----------XXXXXXXXXX-oooooooo----------ooo---------ooooooo------------------XXXXXXXX----------------
-----------ooooo---------g-XXXXXX--oooooo--XXXXXXXXXXXXXXXXXXXX------------------XXXXXXXXXXXXXXXXXXX---ooo----XXXXXXXXXX----------XXXXXXX----------------------XXXXXXXX--oooooo-XXXXXXXXXXXXXXXXXXXXXX--
--------------------XXXXXXXXXXXXX----------XXXXXXXXXXXXXXXXXXXXXXXXXXXXXXXXXXXXXXXXXXXXXXXXXXXXXXXXX----------XXXXXXXXXXXXXXXXXXXXXXXXXXXXXXXXX-g----XXXXXXXXXXXXXXXXXX---------XXXXXXXXXXXXXXXXXXXXXX--
XXXXXXXXXXXXXXXXXXXXXXXXXXXXXXXXXXXXXXXXXXXXXXXXXXXXXXXXXXXXXXXXXXXXXXXXXXXXXXXXXXXXXXXXXXXXXXXXXXXXXXXXXXXXXXXXXXXXXXXXXXXXXXXXXXXXXXXXXXXXXXXXXXXXXXXXXXXXXXXXXXXXXXXXXXXXXXXXXXXXXXXXXXXXXXXXXXXXXXXX

