--------------------------------------------------------------------------------------------------------------------------------------------------------------------------------------------------------
--------------------------------------------------------------------------------------------------------------------------------------------------------------------------------------------------------
--------------------------------------------------------------------------------------------------------------------------------------------------------------------------------------------------------
--------------------------------------------------------------------------------------------------------------------------------------------------------------------------------------------------------
--------------------------------------------------------------------------------------------------------------------------------------------------------------------------------------------------------
--------------------------------------------------------------------------------------------------------------------------------------------------------------------------------------------------------
--------------------------------------------------------------------------------------------------------------------------------------------------------------------------------------------------------
--------------------------------------------------------------------------------------------------------------------------------------------------------------------------------------------------------
--------------------------------------------------------------------------------------------------------------------------------------------------------------------------------------------------------
--------------------------------------------------------------------------------------------------------------------------------------------------------------------------------------------------------
--------------------------------------------------------------------------------------------------------------------------------------------------------------------------------------------------------
--------------------------------------------------------------------------------------------------------------------------------------------------------------------------------------------------------
-----------------------oSoo----------------------------------------------------ooS----------------------------------------------------------------------------------------------------------------------
-----------------------------------------------------------oSoooS--------oSo------------------------------------------oSo----------------------------------------------------------------------ooSo-----
-----------------------oooooo--------------------------------------------------------------oooo-----ooo----------------------ooSoSoSoo---------------------oooo-----------------------------------------
-------------oooS----------------------------g------------oooooo----------------------------------------------------ooooooo-------------oSS----------ooo---------oooooo-----------------------ooooooo---
--------------------XXXXXXXXXXXXXXXXXX----XXXXXXXXXXXXXX---g------------------XXXXXX--------oo----oooo---XXXXX-----------------oooo-----------------------XXXXXX--------XXXXXXXXXXXXXXXXXXXX------------
--------------ooooo-XXXXXXXXXXXXXXXXXX----XXXXXXXXXXXXXXXXXXXXXXXXX----XXXXXXXXXXXXX----------gg---------XXXXX-----XXXXXXXXX--------------------------oo--XXXXXXXXXXXXXXXXXXXXXXXXXXXXXXXXXXXXXXXXXXXX--
--------------------XXXXXXXXXXXXXXXXXXXXXXXXXXXXXXXXXXXXXXXXXXXXXXXXXXXXXXXXXXXXXXXX------XXXXXXXXXXXXXXXXXXXX-----XXXXXXXXXXXXXXXXXXXX------XXXXX--------XXXXXXXXXXXXXXXXXXXXXXXXXXXXXXXXXXXXXXXXXXXX--
XXXXXXXXXXXXXXXXXXXXXXXXXXXXXXXXXXXXXXXXXXXXXXXXXXXXXXXXXXXXXXXXXXXXXXXXXXXXXXXXXXXXXXXXXXXXXXXXXXXXXXXXXXXXXXXXXXXXXXXXXXXXXXXXXXXXXXXXXXXXXXXXXXXXXXXXXXXXXXXXXXXXXXXXXXXXXXXXXXXXXXXXXXXXXXXXXXXXXXXX

