--------------------------------------------------------------------------------------------------------------------------------------------------------------------------------------------------------
--------------------------------------------------------------------------------------------------------------------------------------------------------------------------------------------------------
--------------------------------------------------------------------------------------------------------------------------------------------------------------------------------------------------------
--------------------------------------------------------------------------------------------------------------------------------------------------------------------------------------------------------
--------------------------------------------------------------------------------------------------------------------------------------------------------------------------------------------------------
--------------------------------------------------------------------------------------------------------------------------------------------------------------------------------------------------------
--------------------------------------------------------------------------------------------------------------------------------------------------------------------------------------------------------
--------------------------------------------------------------------------------------------------------------------------------------------------------------------------------------------------------
--------------------------------------------------------------------------------------------------------------------------------------------------------------------------------------------------------
--------------------------------------------------------------------------------------------------------------------------------------------------------------------------------------------------------
--------------------------------------------------------------------------------------------------------------------------------------------------------------------------------------------------------
--------------------------------------------------------------------------------------------------------------------------------------------------------------------------------------------------------
------------------------------------------------------------------ooS----------------------------------------------------------------------------------------------------ooSoooS------------------------
---------------------------------------------------------------------------SooSoo-----------------------------------------------------------------------------------------------------------------------
-------------------------------------oSS-------------------------oooo-----------------------------------------------oooSo-------------------------------------------------oooooo---------oo-------------
------------------------------ooo-------------oo-----------------------------ooo---------------oSSoSo-----ooooSoo------------------------------------------ooooSo---------------------------------------
-------------------------------------oooo-------g-------------XXXXXXXXXXX---------XXXX--------------------------------ooooo------------g------XXXX---XXXX---------------XXXXXXXXXXX--XXXXXXXXX----------
-------------------ooooo----XXXXXXXX------XXXXXXXX------------XXXXXXXXXXXXXXXXXXXXXXXX------------oooo----ooooooo-------------oooo-XXXXXXXXX--XXXX---XXXX--ooooo--XXXXXXXXXXXXXXXXX--XXXXXXXXX-----XXXXX
-------------XXXXX-------XXXXXXXXXXXXXXXXXXXXXXXXX------------XXXXXXXXXXXXXXXXXXXXXXXX---------------g------------XXXXXXXXXX-------XXXXXXXXXXXXXXX---XXXX---------XXXXXXXXXXXXXXXXX--XXXXXXXXXXXXXXXXXXX
XXXXXXXXXXXXXXXXXXXXXXXXXXXXXXXXXXXXXXXXXXXXXXXXXXXXXXXXXXXXXXXXXXXXXXXXXXXXXXXXXXXXXXXXXXXXXXXXXXXXXXXXXXXXXXXXXXXXXXXXXXXXXXXXXXXXXXXXXXXXXXXXXXXXXXXXXXXXXXXXXXXXXXXXXXXXXXXXXXXXXXXXXXXXXXXXXXXXXXXX

