--------------------------------------------------------------------------------------------------------------------------------------------------------------------------------------------------------
--------------------------------------------------------------------------------------------------------------------------------------------------------------------------------------------------------
--------------------------------------------------------------------------------------------------------------------------------------------------------------------------------------------------------
--------------------------------------------------------------------------------------------------------------------------------------------------------------------------------------------------------
--------------------------------------------------------------------------------------------------------------------------------------------------------------------------------------------------------
--------------------------------------------------------------------------------------------------------------------------------------------------------------------------------------------------------
--------------------------------------------------------------------------------------------------------------------------------------------------------------------------------------------------------
--------------------------------------------------------------------------------------------------------------------------------------------------------------------------------------------------------
--------------------------------------------------------------------------------------------------------------------------------------------------------------------------------------------------------
--------------------------------------------------------------------------------------------------------------------------------------------------------------------------------------------------------
--------------------------------------------------------------------------------------------------------------------------------------------------------------------------------------------------------
--------------------------------------------------------------------------------------------------------------------------------------------------------------------------------------------------------
-------------------------------------------------------------------------ooooo-----ooSo------------------------------------------------------------------------------------------------------oooS-------
-----------------SoSoS-----------------------------------------------------------------------------------oSooo-----------------------------------------------------oooSoo-------------------------------
----------------------------------------------oooo---------------ooo-----ooooo----oooooo------------------------------------------------------------------------------------------------------ooo-------
------------------oooooo-----oooooo----------------------oSSooo----------------------------------ooo--------oo-----SoSo-----------ooSoo----------------------------oooo---------------------------------
-----------------------------------------ooo-XXXXXXXXX----------------XXXXXXXXXXXXXXXXXXXX-------g-------------------------oo------------------------XXXXXX---------g------XXXXX-----XXXX---XXXXXXXX----
--------------XXXXXXXXXXX-------oooo---------XXXXXXXXXXX----ooo-------XXXXXXXXXXXXXXXXXXXX----XXXXXXXXXXXXXXXXXXX---oo------------ooooo--ooooo---XXXXXXXXXXXXXXXXXXXXXXXXXXXXXXX---XXXXXX---XXXXXXXX----
XXXXXXXXXXXXXXXXXXXXXXXXX------------XXXXXXXXXXXXXXXXXXX--------XXXXXXXXXXXXXXXXXXXXXXXXXX--XXXXXXXXXXXXXXXXXXXXX--------XXXXXXX-----------------XXXXXXXXXXXXXXXXXXXXXXXXXXXXXXX---XXXXXX---XXXXXXXX----
XXXXXXXXXXXXXXXXXXXXXXXXXXXXXXXXXXXXXXXXXXXXXXXXXXXXXXXXXXXXXXXXXXXXXXXXXXXXXXXXXXXXXXXXXXXXXXXXXXXXXXXXXXXXXXXXXXXXXXXXXXXXXXXXXXXXXXXXXXXXXXXXXXXXXXXXXXXXXXXXXXXXXXXXXXXXXXXXXXXXXXXXXXXXXXXXXXXXXXXX

