--------------------------------------------------------------------------------------------------------------------------------------------------------------------------------------------------------
--------------------------------------------------------------------------------------------------------------------------------------------------------------------------------------------------------
--------------------------------------------------------------------------------------------------------------------------------------------------------------------------------------------------------
--------------------------------------------------------------------------------------------------------------------------------------------------------------------------------------------------------
--------------------------------------------------------------------------------------------------------------------------------------------------------------------------------------------------------
--------------------------------------------------------------------------------------------------------------------------------------------------------------------------------------------------------
--------------------------------------------------------------------------------------------------------------------------------------------------------------------------------------------------------
--------------------------------------------------------------------------------------------------------------------------------------------------------------------------------------------------------
--------------------------------------------------------------------------------------------------------------------------------------------------------------------------------------------------------
--------------------------------------------------------------------------------------------------------------------------------------------------------------------------------------------------------
--------------------------------------------------------------------------------------------------------------------------------------------------------------------------------------------------------
--------------------------------------------------------------------------------------------------------------------------------------------------------------------------------------------------------
----------------------------ooo---------------------------------------------------------------------------------------------oooooo----------------------------------------------------------------------
-----------------------------------ooooo----ooSooo-----------------oSoo--------------------------------------------------------------------------------------------oooooo----------------------ooooo----
-------------ooooSS-----------------------------------------ooooo---------------------oSo---------------------oSSooSoo-----oooooo---------------------oSoooo--------------------------------------------
-------------------------------------oooo----ooooo--ooooo-----------ooo----------------------------------------------------------------------------------------------ooo---ooo--------oSSoSoo-----------
----------------oooo-------XXXXXXX-------------------------XXXXXXX--------------------oooo--------------------oooooo-----XXXXXXXXXX----------------------oo---------------------------------------------
-----------------g--g------XXXXXXXXXXXXXXXXXXXXXXXX---ooo--XXXXXXXXXXXXX------------------------------ooooo--------------XXXXXXXXXX-----XXXX---XXXXXX-------------XXXXXXXXXXXXXXXXXXX----oo---XXXXXXX---
------------XXXXXXXXXXX----XXXXXXXXXXXXXXXXXXXXXXXX--------XXXXXXXXXXXXX------XXXXXXXXXXXXXXX---XXXXX-g-----XXXXXXXXXXX--XXXXXXXXXX-----XXXXXXXXXXXXXXXXXXXXXXXXXXXXXXXXXXXXXXXXXXXXX---------XXXXXXX---
XXXXXXXXXXXXXXXXXXXXXXXXXXXXXXXXXXXXXXXXXXXXXXXXXXXXXXXXXXXXXXXXXXXXXXXXXXXXXXXXXXXXXXXXXXXXXXXXXXXXXXXXXXXXXXXXXXXXXXXXXXXXXXXXXXXXXXXXXXXXXXXXXXXXXXXXXXXXXXXXXXXXXXXXXXXXXXXXXXXXXXXXXXXXXXXXXXXXXXXX

