--------------------------------------------------------------------------------------------------------------------------------------------------------------------------------------------------------
--------------------------------------------------------------------------------------------------------------------------------------------------------------------------------------------------------
--------------------------------------------------------------------------------------------------------------------------------------------------------------------------------------------------------
--------------------------------------------------------------------------------------------------------------------------------------------------------------------------------------------------------
--------------------------------------------------------------------------------------------------------------------------------------------------------------------------------------------------------
--------------------------------------------------------------------------------------------------------------------------------------------------------------------------------------------------------
--------------------------------------------------------------------------------------------------------------------------------------------------------------------------------------------------------
--------------------------------------------------------------------------------------------------------------------------------------------------------------------------------------------------------
--------------------------------------------------------------------------------------------------------------------------------------------------------------------------------------------------------
--------------------------------------------------------------------------------------------------------------------------------------------------------------------------------------------------------
--------------------------------------------------------------------------------------------------------------------------------------------------------------------------------------------------------
--------------------------------------------------------------------------------------------------------------------------------------------------------------------------------------------------------
---------------------------------------------------------oSo-----------------------------------------------------SSSSoo---------------------------------oooSoo------------------------------------------
----------------------oSSo--------------------ooooooo-------------------------------------------------------------------------ooSoSS-----oSS-------------------------oooo-------------------------------
---------------------------------------------------------oooo-----------ooSSo----------------------------------ooooo----------------------------------oooooo----------------------------------------ooo-
-----------------------------------------------ooo--------------oooo-------------oo-----oSSo--------------------------g--------ooooooo-----oo------------------------oooo-------------------------------
------------XXXXXX---------XXX---------XXXXX------------XXXXXX------------oo------g------------XXX------------XXXXXXXXXX-----------------------------XXXXXXXXXX-----------------------------------XXXXXX
------------XXXXXXXXXXXXXXXXXX---------XXXXXXXXXXXXXXX--XXXXXX--oooooo---------XXXXXXXX---oo---XXX------------XXXXXXXXXX--XXXXXXXXXXXXXXXXXXXXX---oo-XXXXXXXXXX----XXXXXXXXX-------oo-------XXXXXXXXXXXX
------------XXXXXXXXXXXXXXXXXXXXXXXXXXXXXXXXXXXXXXXXXXXXXXXXXX---------XXXXXXXXXXXXXXXX--------XXXXXXXXXXXXXXXXXXXXXXXXXXXXXXXXXXXXXXXXXXXXXXXX------XXXXXXXXXXXXXXXXXXXXXXX----------------XXXXXXXXXXXX
XXXXXXXXXXXXXXXXXXXXXXXXXXXXXXXXXXXXXXXXXXXXXXXXXXXXXXXXXXXXXXXXXXXXXXXXXXXXXXXXXXXXXXXXXXXXXXXXXXXXXXXXXXXXXXXXXXXXXXXXXXXXXXXXXXXXXXXXXXXXXXXXXXXXXXXXXXXXXXXXXXXXXXXXXXXXXXXXXXXXXXXXXXXXXXXXXXXXXXXX

