--------------------------------------------------------------------------------------------------------------------------------------------------------------------------------------------------------
--------------------------------------------------------------------------------------------------------------------------------------------------------------------------------------------------------
--------------------------------------------------------------------------------------------------------------------------------------------------------------------------------------------------------
--------------------------------------------------------------------------------------------------------------------------------------------------------------------------------------------------------
--------------------------------------------------------------------------------------------------------------------------------------------------------------------------------------------------------
--------------------------------------------------------------------------------------------------------------------------------------------------------------------------------------------------------
--------------------------------------------------------------------------------------------------------------------------------------------------------------------------------------------------------
--------------------------------------------------------------------------------------------------------------------------------------------------------------------------------------------------------
--------------------------------------------------------------------------------------------------------------------------------------------------------------------------------------------------------
--------------------------------------------------------------------------------------------------------------------------------------------------------------------------------------------------------
--------------------------------------------------------------------------------------------------------------------------------------------------------------------------------------------------------
--------------------------------------------------------------------------------------------------------------------------------------------------------------------------------------------------------
------------------------------------------------------------------------------------------SooooSoo------------------------------------------------------------------------------------------------------
-------------------------------------------------------ooSoSoSo-------ooo----------------------------------------Soo--------------------------------------oSoo-----oSo----------------------------------
--------------------------------------------------------------------------------------------ooooo-----------------------ooSoS--------ooSo---------------------------------------------------------------
------------------oSo--------------------ooSSo-----------ooo-------oooooo-----ooooSoo----------g---------------oooooo-------------------------------------oooo---ooooo----------------------------------
XXXXXXXXXXXXXX--------------------------------------------------------------------------XXXXXXXXXXX--oooo---------------oooooooo-XXX---oo---------------------------------------------------------------
XXXXXXXXXXXXXX---oooo-------------XXX-----ooooo---XXXXXXXXXXXXXX--XXXXXXXXXXX-oooooo----XXXXXXXXXXX--------XXXXXXXXXXX-----------XXX---------XXXXX-----XXXXXXXXXXXXXXXX--------------------ooo------XXXX
XXXXXXXXXXXXXX--------------------XXXXX-----------XXXXXXXXXXXXXX--XXXXXXXXXXX-----------XXXXXXXXXXXXXXXXXXXXXXXXXXXXXXXXXXXXXXXXXXXXXXXXXXXXXXXXXX-----XXXXXXXXXXXXXXXXXXXXXXXXXXX--------------XXXXXXXX
XXXXXXXXXXXXXXXXXXXXXXXXXXXXXXXXXXXXXXXXXXXXXXXXXXXXXXXXXXXXXXXXXXXXXXXXXXXXXXXXXXXXXXXXXXXXXXXXXXXXXXXXXXXXXXXXXXXXXXXXXXXXXXXXXXXXXXXXXXXXXXXXXXXXXXXXXXXXXXXXXXXXXXXXXXXXXXXXXXXXXXXXXXXXXXXXXXXXXXXX

