--------------------------------------------------------------------------------------------------------------------------------------------------------------------------------------------------------
--------------------------------------------------------------------------------------------------------------------------------------------------------------------------------------------------------
--------------------------------------------------------------------------------------------------------------------------------------------------------------------------------------------------------
--------------------------------------------------------------------------------------------------------------------------------------------------------------------------------------------------------
--------------------------------------------------------------------------------------------------------------------------------------------------------------------------------------------------------
--------------------------------------------------------------------------------------------------------------------------------------------------------------------------------------------------------
--------------------------------------------------------------------------------------------------------------------------------------------------------------------------------------------------------
--------------------------------------------------------------------------------------------------------------------------------------------------------------------------------------------------------
--------------------------------------------------------------------------------------------------------------------------------------------------------------------------------------------------------
--------------------------------------------------------------------------------------------------------------------------------------------------------------------------------------------------------
--------------------------------------------------------------------------------------------------------------------------------------------------------------------------------------------------------
--------------------------------------------------------------------------------------------------------------------------------------------------------------------------------------------------------
---------------------------------------------------------ooooS--------------------------------------------------------------------------------------------------------------------------ooSoo-----------
------------------------oooooo----------------------------------------------------------------------------------------------------------------------ooS-------------------------------------------------
----------------------------------------------------------ooooo-----------------------------oSoS----------------------------------ooSS----------------------------oooo-------------------oooo-----------
---------------------------oooooo----oo---ooooooo-------------------------------oo-----------------------------------------oSo--------------------ooo----------------g---oo------Sooo-------------------
-------------------------------------------------------XXXXXXXXXXXX-------------------------ooo-----------------XXXXXX------------ooooo------------------XXXX---XXXXXXX---------------XXXXXXXXX-oooo----
-----------------------XXXXXXXXXXXXXXXXXX---oooo-------XXXXXXXXXXXXXXX-------XXXXXXXXXXXX----------XXXX---------XXXXXX-----oo------------XXXX----XXXXXXXXXXXX---XXXXXXXXXXXXX---oo----XXXXXXXXX---------
XXXXXXXXXXXXXXXXXXXXXXXXXXXXXXXXXXXXXXXXX--------------XXXXXXXXXXXXXXXXXXXXXXXXXXXXXXXXXXXXXXXXXXXXXXXX----XXXXXXXXXXXXXX--------XXXXXXXXXXXXXXXXXXXXXXXXXXXXXXXXXXXXXXXXXXXX---------XXXXXXXXXXXXXXXXXX
XXXXXXXXXXXXXXXXXXXXXXXXXXXXXXXXXXXXXXXXXXXXXXXXXXXXXXXXXXXXXXXXXXXXXXXXXXXXXXXXXXXXXXXXXXXXXXXXXXXXXXXXXXXXXXXXXXXXXXXXXXXXXXXXXXXXXXXXXXXXXXXXXXXXXXXXXXXXXXXXXXXXXXXXXXXXXXXXXXXXXXXXXXXXXXXXXXXXXXXX

