--------------------------------------------------------------------------------------------------------------------------------------------------------------------------------------------------------
--------------------------------------------------------------------------------------------------------------------------------------------------------------------------------------------------------
--------------------------------------------------------------------------------------------------------------------------------------------------------------------------------------------------------
--------------------------------------------------------------------------------------------------------------------------------------------------------------------------------------------------------
--------------------------------------------------------------------------------------------------------------------------------------------------------------------------------------------------------
--------------------------------------------------------------------------------------------------------------------------------------------------------------------------------------------------------
--------------------------------------------------------------------------------------------------------------------------------------------------------------------------------------------------------
--------------------------------------------------------------------------------------------------------------------------------------------------------------------------------------------------------
--------------------------------------------------------------------------------------------------------------------------------------------------------------------------------------------------------
--------------------------------------------------------------------------------------------------------------------------------------------------------------------------------------------------------
--------------------------------------------------------------------------------------------------------------------------------------------------------------------------------------------------------
--------------------------------------------------------------------------------------------------------------------------------------------------------------------------------------------------------
-----------------------------------------------oSo---------SoSoSoo-------------------oSo-------------------------------------------------------------ooooo-----ooSS-------------------------------------
---------------oooSo-----SSoS-------------------------------------------------------------------oooSooSSo------------------------------------ooo------------------------------------------------oooSoS--
------------------------------------oSooo----oooooo-------ooooooo------------------ooooo-------------------------------------------------------------ooooooo---ooooo------------------------------------
------------------oo---oooooo-----------------------------------------SoSSo------------g---------oooooooo--------------------oSSSo----------------------------------------------------oooooooo-----oooo-
--------------------------------------ooo--XXXXXXXXXX----XXXXXXXXXX----------ooo--XXXXXXXXXXXXX----------------ooo-------------------XXXXXXX--------XXXXXXXXXXXXXXXXXX--------------------------g-------
--------------XXXXXXXXXXXXXXXXXX-----------XXXXXXXXXXXXXXXXXXXXXXXX----oo---------XXXXXXXXXXXXXXXXXXXXXXXXXXXX----------------ooo----XXXXXXXXXXXXXXXXXXXXXXXXXXXXXXXXX------------------oooo---XXXXXXXXX
XXXXXXXXXXXX--XXXXXXXXXXXXXXXXXXXXXXXXXXXXXXXXXXXXXXXXXXXXXXXXXXXXX---------XXXXXXXXXXXXXXXXXXXXXXXXXXXXXXXXXXXXXXXX-----g-----------XXXXXXXXXXXXXXXXXXXXXXXXXXXXXXXXXXXXXXXXXXXXXXX-----------XXXXXXXXX
XXXXXXXXXXXXXXXXXXXXXXXXXXXXXXXXXXXXXXXXXXXXXXXXXXXXXXXXXXXXXXXXXXXXXXXXXXXXXXXXXXXXXXXXXXXXXXXXXXXXXXXXXXXXXXXXXXXXXXXXXXXXXXXXXXXXXXXXXXXXXXXXXXXXXXXXXXXXXXXXXXXXXXXXXXXXXXXXXXXXXXXXXXXXXXXXXXXXXXXX

