--------------------------------------------------------------------------------------------------------------------------------------------------------------------------------------------------------
--------------------------------------------------------------------------------------------------------------------------------------------------------------------------------------------------------
--------------------------------------------------------------------------------------------------------------------------------------------------------------------------------------------------------
--------------------------------------------------------------------------------------------------------------------------------------------------------------------------------------------------------
--------------------------------------------------------------------------------------------------------------------------------------------------------------------------------------------------------
--------------------------------------------------------------------------------------------------------------------------------------------------------------------------------------------------------
--------------------------------------------------------------------------------------------------------------------------------------------------------------------------------------------------------
--------------------------------------------------------------------------------------------------------------------------------------------------------------------------------------------------------
--------------------------------------------------------------------------------------------------------------------------------------------------------------------------------------------------------
--------------------------------------------------------------------------------------------------------------------------------------------------------------------------------------------------------
--------------------------------------------------------------------------------------------------------------------------------------------------------------------------------------------------------
--------------------------------------------------------------------------------------------------------------------------------------------------------------------------------------------------------
-------------------------------------------------oSSo-----------------------------oooS----------------------------------------------oSooSo---------------------------------------ooSoS------------------
-------------------------------------ooSooo-------------------ooS---------------------------------------oSSS------------------------------------oSo--------------------SSo------------------------------
------------------------------Soooo---------------ooooo---------------------------oooooo---------------------------------------------oooooo--------------ooSoo------------------oooo---------------oSoo-
-------------ooSSSSo------------------ooooooo---------------oooooo----------------------------ooooo----ooooo-----------Sooooo------------------oooo--------------------------------------oSSSo----------
-------------------------oo---------------------XXXXXXXXX------g----oooo--------XXXXXXXXXX------------------g---------------------XXXXXXXXXX-----------oooooo----------------XXXXXXXXXXX-------------oo-
----------------oooo----------------XXXXXXXXXX--XXXXXXXXX--XXXXXXXX----------XXXXXXXXXXXXX---XXXXXXXXXXXXXXXXXXXXXXXX-ooooo-------XXXXXXXXXXXXXXXXXXXX-------------XXXXXXXX--XXXXXXXXXXX-------XXX------
-----------------g-g-XXXXXXXXXXXXXXXXXXXXXXXXXXXXXXXXXXXXXXXXXXXXXXXXXXXXXXXXXXXXXXXXXXXXXXXXXXXXXXXXXXXXXXXXXXXXXXXX-------------XXXXXXXXXXXXXXXXXXXXXXXXXXXXXXXXXXXXXXXXX--XXXXXXXXXXX-------XXXXXXXXX
XXXXXXXXXXXXXXXXXXXXXXXXXXXXXXXXXXXXXXXXXXXXXXXXXXXXXXXXXXXXXXXXXXXXXXXXXXXXXXXXXXXXXXXXXXXXXXXXXXXXXXXXXXXXXXXXXXXXXXXXXXXXXXXXXXXXXXXXXXXXXXXXXXXXXXXXXXXXXXXXXXXXXXXXXXXXXXXXXXXXXXXXXXXXXXXXXXXXXXXX

