--------------------------------------------------------------------------------------------------------------------------------------------------------------------------------------------------------
--------------------------------------------------------------------------------------------------------------------------------------------------------------------------------------------------------
--------------------------------------------------------------------------------------------------------------------------------------------------------------------------------------------------------
--------------------------------------------------------------------------------------------------------------------------------------------------------------------------------------------------------
--------------------------------------------------------------------------------------------------------------------------------------------------------------------------------------------------------
--------------------------------------------------------------------------------------------------------------------------------------------------------------------------------------------------------
--------------------------------------------------------------------------------------------------------------------------------------------------------------------------------------------------------
--------------------------------------------------------------------------------------------------------------------------------------------------------------------------------------------------------
--------------------------------------------------------------------------------------------------------------------------------------------------------------------------------------------------------
--------------------------------------------------------------------------------------------------------------------------------------------------------------------------------------------------------
--------------------------------------------------------------------------------------------------------------------------------------------------------------------------------------------------------
--------------------------------------------------------------------------------------------------------------------------------------------------------------------------------------------------------
---------------------------------------------------------------------------------------------------------------oSooooo------------------------------------------------------ooS----ooS------------------
----------------SoS-------------------------------------------------------------------------------------------------------------------------------------------------------------------------------------
--------------------------------ooooo------ooSo----------------------oSoo------------------------ooo---ooo--------ooooo---------------------------------------------------ooooo-------------------------
---------------ooooooo-----------------------------ooooo-----ooo------------------------------------------------------------------------------oSoS------------------------------------------------------
XXXXXXXXXXXXXX------------------ooooooo------------------------------------XXXXXXXXX----XXXXXXXX-------oooooo-XXXXXXXXXX----------------------------XXXXX--XXXXX--------XXXXXXXXXXXXXXXXXXXXXXXX------XX
XXXXXXXXXXXXXXXXXXXXXXX--XXXXX--------------------ooooo--------------------XXXXXXXXXXXXXXXXXXXXX------------g-XXXXXXXXXXXXXXXX--------------oooo----XXXXXXXXXXXX------XXXXXXXXXXXXXXXXXXXXXXXXXX---oo-XX
XXXXXXXXXXXXXXXXXXXXXXXXXXXXXXXXXXXXXXXXXXXXXXXX---------XX-------XXXXXXXXXXXXXXXXXXXXXXXXXXXXXXXXXXXXXXXXXXXXXXXXXXXXXXXXXXXX---XXXXXX-------------XXXXXXXXXXXX------XXXXXXXXXXXXXXXXXXXXXXXXXX------XX
XXXXXXXXXXXXXXXXXXXXXXXXXXXXXXXXXXXXXXXXXXXXXXXXXXXXXXXXXXXXXXXXXXXXXXXXXXXXXXXXXXXXXXXXXXXXXXXXXXXXXXXXXXXXXXXXXXXXXXXXXXXXXXXXXXXXXXXXXXXXXXXXXXXXXXXXXXXXXXXXXXXXXXXXXXXXXXXXXXXXXXXXXXXXXXXXXXXXXXXX

