--------------------------------------------------------------------------------------------------------------------------------------------------------------------------------------------------------
--------------------------------------------------------------------------------------------------------------------------------------------------------------------------------------------------------
--------------------------------------------------------------------------------------------------------------------------------------------------------------------------------------------------------
--------------------------------------------------------------------------------------------------------------------------------------------------------------------------------------------------------
--------------------------------------------------------------------------------------------------------------------------------------------------------------------------------------------------------
--------------------------------------------------------------------------------------------------------------------------------------------------------------------------------------------------------
--------------------------------------------------------------------------------------------------------------------------------------------------------------------------------------------------------
--------------------------------------------------------------------------------------------------------------------------------------------------------------------------------------------------------
--------------------------------------------------------------------------------------------------------------------------------------------------------------------------------------------------------
--------------------------------------------------------------------------------------------------------------------------------------------------------------------------------------------------------
--------------------------------------------------------------------------------------------------------------------------------------------------------------------------------------------------------
--------------------------------------------------------------------------------------------------------------------------------------------------------------------------------------------------------
---------------ooS----------------------------------------Soo----------------------------------------------ooooS------------------------------oooooS----------ooooS------SoS----SoSoo-------------------
---------------------ooSSoo-----------------------oSo----------------SSSSo------------------------------------------------------------------------------------------------------------------------------
---------------oooo---------------------------------------oooooo--------------------------------------------oooooo------------------------------oooo-------------------ooooo-----ooooo--ooSoo--ooooo----
-------------------------------------------------------------------ooooo-----ooSooSo----------------------------g--------------------SoS---------------oo------------------------g-----------------g----
------------XXXXXXXX----------oo-----------------------XXXXXXXXXX-----------------------------XXXXXXXXXXXXXXXXXXXXX--oooooo--XXXXX----------XXXXXXXXXX-------XXXXXXXXXXXXXXXXXXXXXXXXXX---ooo-XXXXXXXX--
------------XXXXXXXXXXXXXXXX-----------XXXX----XXXXXXXXXXXXXXXXXXXXXXXXXXXXX---oo----XXXXXXXXXXXXXXXXXXXXXXXXXXXXXX------g---XXXXX-ooooooo--XXXXXXXXXXXXXXXXXXXXXXXXXXXXXXXXXXXXXXXXXXX-------XXXXXXXX--
XXXXXXXXXXXXXXXXXXXXXXXXXXXXXXXXXXXXXXXXXXX----XXXXXXXXXXXXXXXXXXXXXXXXXXXXX---------XXXXXXXXXXXXXXXXXXXXXXXXXXXXXXXXXXXXXXXXXXXXX----------XXXXXXXXXXXXXXXXXXXXXXXXXXXXXXXXXXXXXXXXXXXXXXXXXXXXXXXXXXXX
XXXXXXXXXXXXXXXXXXXXXXXXXXXXXXXXXXXXXXXXXXXXXXXXXXXXXXXXXXXXXXXXXXXXXXXXXXXXXXXXXXXXXXXXXXXXXXXXXXXXXXXXXXXXXXXXXXXXXXXXXXXXXXXXXXXXXXXXXXXXXXXXXXXXXXXXXXXXXXXXXXXXXXXXXXXXXXXXXXXXXXXXXXXXXXXXXXXXXXXX

