--------------------------------------------------------------------------------------------------------------------------------------------------------------------------------------------------------
--------------------------------------------------------------------------------------------------------------------------------------------------------------------------------------------------------
--------------------------------------------------------------------------------------------------------------------------------------------------------------------------------------------------------
--------------------------------------------------------------------------------------------------------------------------------------------------------------------------------------------------------
--------------------------------------------------------------------------------------------------------------------------------------------------------------------------------------------------------
--------------------------------------------------------------------------------------------------------------------------------------------------------------------------------------------------------
--------------------------------------------------------------------------------------------------------------------------------------------------------------------------------------------------------
--------------------------------------------------------------------------------------------------------------------------------------------------------------------------------------------------------
--------------------------------------------------------------------------------------------------------------------------------------------------------------------------------------------------------
--------------------------------------------------------------------------------------------------------------------------------------------------------------------------------------------------------
--------------------------------------------------------------------------------------------------------------------------------------------------------------------------------------------------------
--------------------------------------------------------------------------------------------------------------------------------------------------------------------------------------------------------
-----------------ooSo---------------------------------------------------------------------------------------------Soooo--------------------------------------------------------------------------SSS----
----------------------------------------------------------------------------------------------------------------------------------------oSS------------ooS----------------------------------------------
------------------ooo-------------------------------------------------------oSooSo------ooo----------------------ooooo----------ooSS-------------------------------------------------------------ooo----
-------------------gg--------oooo---------------------------SoooS--------------------------g---oo-----ooooSSo----------------------------ooo----------------------------------------------ooo-----------
---------------XXXXXXX------------------------------------------------------ooooo----XXXXXXXXX-----------------XXXXXXXXXXXXXX---ooooo-------------------------XXXXXXXX--------------oo---------XXXXXXXXX
----------XXXXXXXXXXXX-------------------------------XXXX--oooooo-----oo-------------XXXXXXXXXXXXXXXX-oooooooo-XXXXXXXXXXXXXXXX--------XXXXXXXX-----XXXXXXXXXXXXXXXXXX------------------XXXXXXXXXXXXXXXX
XXXXXXXXXXXXXXXXXXXXXX------------XXXXXX-------XXXXXXXXXX------------------XXXXXXXXXXXXXXXXXXXXXXXXXX-----g----XXXXXXXXXXXXXXXXXXXXXXXXXXXXXXXXXXXXXXXXXXXXXXXXXXXXXXXXXXXXXXXXXXXXXXXXXXXXXXXXXXXXXXXXX
XXXXXXXXXXXXXXXXXXXXXXXXXXXXXXXXXXXXXXXXXXXXXXXXXXXXXXXXXXXXXXXXXXXXXXXXXXXXXXXXXXXXXXXXXXXXXXXXXXXXXXXXXXXXXXXXXXXXXXXXXXXXXXXXXXXXXXXXXXXXXXXXXXXXXXXXXXXXXXXXXXXXXXXXXXXXXXXXXXXXXXXXXXXXXXXXXXXXXXXX

