--------------------------------------------------------------------------------------------------------------------------------------------------------------------------------------------------------
--------------------------------------------------------------------------------------------------------------------------------------------------------------------------------------------------------
--------------------------------------------------------------------------------------------------------------------------------------------------------------------------------------------------------
--------------------------------------------------------------------------------------------------------------------------------------------------------------------------------------------------------
--------------------------------------------------------------------------------------------------------------------------------------------------------------------------------------------------------
--------------------------------------------------------------------------------------------------------------------------------------------------------------------------------------------------------
--------------------------------------------------------------------------------------------------------------------------------------------------------------------------------------------------------
--------------------------------------------------------------------------------------------------------------------------------------------------------------------------------------------------------
--------------------------------------------------------------------------------------------------------------------------------------------------------------------------------------------------------
--------------------------------------------------------------------------------------------------------------------------------------------------------------------------------------------------------
--------------------------------------------------------------------------------------------------------------------------------------------------------------------------------------------------------
--------------------------------------------------------------------------------------------------------------------------------------------------------------------------------------------------------
-------------------------------------------------------------------------------------------------------Soo------------------------oooo------------------------------------------------------------------
-----------------------------------------------------------------------------ooSSooS-----------------------------ooooS------------------ooooooS---------------------------------------------------------
--------------Soo----------------------ooSo-----------------------------------------------------------oooo------------------oooo--ooo---------------------------------------------------------oSoSoS----
--------------------ooSoo-------------------------oooo-----------------------ooooooo------------------------------ooo-------------------ooooooo-----------ooo----------------------oSoooSo--------------
------------------------------oo---------------------------------------------g---------------------XXXXXXXXX---------g----ooo----XXXXXX---g------XXXXXXX------------ooooo-----XXXX--------------oo------
--------------------ooo-------------XX----------oooooooo-XXXXXXX--oo--XXXXXXXXXXXXXXXX-------------XXXXXXXXXXXXXXXXXXXXX---------XXXXXXXXXXXXXXXXXXXXXXXXXXXXX--XX------------XXXX---oooo-------------XX
------------XXXXXXX----------XXXXXXXXXXXXXXXXX-----------XXXXXXX------XXXXXXXXXXXXXXXX-----XXXX----XXXXXXXXXXXXXXXXXXXXXXXXXXXXXXXXXXXXXXXXXXXXXXXXXXXXXXXXXXXXXXXXXXXXXXX----XXXX----------XXXXXXXXXXXX
XXXXXXXXXXXXXXXXXXXXXXXXXXXXXXXXXXXXXXXXXXXXXXXXXXXXXXXXXXXXXXXXXXXXXXXXXXXXXXXXXXXXXXXXXXXXXXXXXXXXXXXXXXXXXXXXXXXXXXXXXXXXXXXXXXXXXXXXXXXXXXXXXXXXXXXXXXXXXXXXXXXXXXXXXXXXXXXXXXXXXXXXXXXXXXXXXXXXXXXX

