--------------------------------------------------------------------------------------------------------------------------------------------------------------------------------------------------------
--------------------------------------------------------------------------------------------------------------------------------------------------------------------------------------------------------
--------------------------------------------------------------------------------------------------------------------------------------------------------------------------------------------------------
--------------------------------------------------------------------------------------------------------------------------------------------------------------------------------------------------------
--------------------------------------------------------------------------------------------------------------------------------------------------------------------------------------------------------
--------------------------------------------------------------------------------------------------------------------------------------------------------------------------------------------------------
--------------------------------------------------------------------------------------------------------------------------------------------------------------------------------------------------------
--------------------------------------------------------------------------------------------------------------------------------------------------------------------------------------------------------
--------------------------------------------------------------------------------------------------------------------------------------------------------------------------------------------------------
--------------------------------------------------------------------------------------------------------------------------------------------------------------------------------------------------------
--------------------------------------------------------------------------------------------------------------------------------------------------------------------------------------------------------
--------------------------------------------------------------------------------------------------------------------------------------------------------------------------------------------------------
----------------------------------------------------ooSooSS---------------------------------------------------------------------------------------------------------------------------------------------
-----------------------------------------------------------------Soo--------------oooo--------------------------------------------------------oSoo------------------Soo-----------------oSooooooo--oooo-
------------------------------------------------------ooooo-----------------------------------------------------------SooSo--------------------------------------------------oooS-----------------------
-------------------------------------------ooSoo----------------ooooo---ooSooSo----oooo------------------------------------------------oo-----------ooooo--ooSS----ooo---------------------oooo-----oo--
---------------------------------------------------XXXXXXXXXXX-------------------------------XXXXXXXXXXXXXX--------oooooooo-XXXXXXXX-----------------------------------------oo-------------------------
---------------------XXXX----------XX-------ooo----XXXXXXXXXXXXXXXXXXX---ooooo--XXXXXXXXXXXXXXXXXXXXXXXXXXX-------------g---XXXXXXXXXXXXXXXXXXXXXXXXXXXXXX----ooo-XXXXXXX----------XXXXXXXXXXXXXXXXXXXXX
---------------------XXXXXXXX------XXXXXX----------XXXXXXXXXXXXXXXXXXX----------XXXXXXXXXXXXXXXXXXXXXXXXXXXXXXXXXXXXXXXXXXXXXXXXXXXXXXXXXXXXXXXXXXXXXXXXXX--------XXXXXXXXXXXXXXXXXXXXXXXXXXXXXXXXXXXXXX
XXXXXXXXXXXXXXXXXXXXXXXXXXXXXXXXXXXXXXXXXXXXXXXXXXXXXXXXXXXXXXXXXXXXXXXXXXXXXXXXXXXXXXXXXXXXXXXXXXXXXXXXXXXXXXXXXXXXXXXXXXXXXXXXXXXXXXXXXXXXXXXXXXXXXXXXXXXXXXXXXXXXXXXXXXXXXXXXXXXXXXXXXXXXXXXXXXXXXXXX

