--------------------------------------------------------------------------------------------------------------------------------------------------------------------------------------------------------
--------------------------------------------------------------------------------------------------------------------------------------------------------------------------------------------------------
--------------------------------------------------------------------------------------------------------------------------------------------------------------------------------------------------------
--------------------------------------------------------------------------------------------------------------------------------------------------------------------------------------------------------
--------------------------------------------------------------------------------------------------------------------------------------------------------------------------------------------------------
--------------------------------------------------------------------------------------------------------------------------------------------------------------------------------------------------------
--------------------------------------------------------------------------------------------------------------------------------------------------------------------------------------------------------
--------------------------------------------------------------------------------------------------------------------------------------------------------------------------------------------------------
--------------------------------------------------------------------------------------------------------------------------------------------------------------------------------------------------------
--------------------------------------------------------------------------------------------------------------------------------------------------------------------------------------------------------
--------------------------------------------------------------------------------------------------------------------------------------------------------------------------------------------------------
--------------------------------------------------------------------------------------------------------------------------------------------------------------------------------------------------------
----------------------------oooo--------------------------------------------------------------------------------------------------------------------------------------------oooooo----------------------
-------------------------------------oooo--------------------------------------------------------------------------------Sooo------------------------------ooooo----------------------------------------
----------------------------oooooo-------------------%%%%%%%-------------------ooo----------------------------ooo-------------------------Sooooo------------------------------oooo------------oSoooSS---
--------------Soooooo----------------ooooo-----------|||||||---------------------------oSoo---ooSooo----oo----------------oooo-------------------------------------------------------ooooo--------------
XXXXXXXXXXXX---------------XXXXXXXXX---g-------------|||||||-----g----g----------------------------------------oooo-XX--------------------oooo---XXXXXX--------------XXXXXXXXXXXXXX-----------ooooo-----
XXXXXXXXXXXX-ooooooo-------XXXXXXXXXXXXXXXXXX----XXXXXXXXXXXXXXXXXXXXXXXXXXXXX----------------ooo----XXXXXXXX-------XXXXXXXXXXXXX----------------XXXXXX---XXXXXXXX---XXXXXXXXXXXXXX-oooooo-------------X
XXXXXXXXXXXX---------------XXXXXXXXXXXXXXXXXX----XXXXXXXXXXXXXXXXXXXXXXXXXXXXXXXXXXX--------------gg-XXXXXXXXXXXXXXXXXXXXXXXXXXXXXXXXXXXXXXXXXXXXXXXXXXXXXXXXXXXXX---XXXXXXXXXXXXXX--------XXXXXXXXXXXXX
XXXXXXXXXXXXXXXXXXXXXXXXXXXXXXXXXXXXXXXXXXXXXXXXXXXXXXXXXXXXXXXXXXXXXXXXXXXXXXXXXXXXXXXXXXXXXXXXXXXXXXXXXXXXXXXXXXXXXXXXXXXXXXXXXXXXXXXXXXXXXXXXXXXXXXXXXXXXXXXXXXXXXXXXXXXXXXXXXXXXXXXXXXXXXXXXXXXXXXXX

