--------------------------------------------------------------------------------------------------------------------------------------------------------------------------------------------------------
--------------------------------------------------------------------------------------------------------------------------------------------------------------------------------------------------------
--------------------------------------------------------------------------------------------------------------------------------------------------------------------------------------------------------
--------------------------------------------------------------------------------------------------------------------------------------------------------------------------------------------------------
--------------------------------------------------------------------------------------------------------------------------------------------------------------------------------------------------------
--------------------------------------------------------------------------------------------------------------------------------------------------------------------------------------------------------
--------------------------------------------------------------------------------------------------------------------------------------------------------------------------------------------------------
--------------------------------------------------------------------------------------------------------------------------------------------------------------------------------------------------------
--------------------------------------------------------------------------------------------------------------------------------------------------------------------------------------------------------
--------------------------------------------------------------------------------------------------------------------------------------------------------------------------------------------------------
--------------------------------------------------------------------------------------------------------------------------------------------------------------------------------------------------------
--------------------------------------------------------------------------------------------------------------------------------------------------------------------------------------------------------
--------------------------ooSoSo------------------------------------------------------------------------------------------------------------------------------------------------------------------------
-----------------oooo-------------------------------------------------------------------------ooSSSoSo-----------------------------------------Soo------oSo---------------SooS--------------------------
--------------------------ooooooooo--oSSoo---------------------oooooo---oSSoooo------Soo----------------------------------------------------------------------------------------------------------------
------------------oooo--------------------------oooS------ooo---------------------------------ooooo------------------------oSoo------ooooooo------------oooo-----------ooooooooo-------------------SSSo-
-------------------------XXXXXXXXXXX----oo--------------------XXXXXXXXX----ooooo---ooooooo---------------------------XXXXX----------------------------------------ooo------------XXX---------XXXX-------
XXXXXXXXXXXXXXXXXXXXXXXXXXXXXXXXXXXX-------g----ooooo-XXXXXXXXXXXXXXXXX------g--------------XXXXXXXXXXX----------XX--XXXXX----oooo---oooo----XXXXXXXXXXXXXXXXX--------XXXXXXXXXXXXXX---------XXXX-------
XXXXXXXXXXXXXXXXXXXXXXXXXXXXXXXXXXXXXXXXXXXXX---------XXXXXXXXXXXXXXXXXXXXXXXXXXXXXXXXXXXXXXXXXXXXXXXXX---XXXXXXXXXXXXXXXX-------------------XXXXXXXXXXXXXXXXXXXXXXXXXXXXXXXXXXXXXXX---------XXXX-------
XXXXXXXXXXXXXXXXXXXXXXXXXXXXXXXXXXXXXXXXXXXXXXXXXXXXXXXXXXXXXXXXXXXXXXXXXXXXXXXXXXXXXXXXXXXXXXXXXXXXXXXXXXXXXXXXXXXXXXXXXXXXXXXXXXXXXXXXXXXXXXXXXXXXXXXXXXXXXXXXXXXXXXXXXXXXXXXXXXXXXXXXXXXXXXXXXXXXXXXX

