--------------------------------------------------------------------------------------------------------------------------------------------------------------------------------------------------------
--------------------------------------------------------------------------------------------------------------------------------------------------------------------------------------------------------
--------------------------------------------------------------------------------------------------------------------------------------------------------------------------------------------------------
--------------------------------------------------------------------------------------------------------------------------------------------------------------------------------------------------------
--------------------------------------------------------------------------------------------------------------------------------------------------------------------------------------------------------
--------------------------------------------------------------------------------------------------------------------------------------------------------------------------------------------------------
--------------------------------------------------------------------------------------------------------------------------------------------------------------------------------------------------------
--------------------------------------------------------------------------------------------------------------------------------------------------------------------------------------------------------
--------------------------------------------------------------------------------------------------------------------------------------------------------------------------------------------------------
--------------------------------------------------------------------------------------------------------------------------------------------------------------------------------------------------------
--------------------------------------------------------------------------------------------------------------------------------------------------------------------------------------------------------
--------------------------------------------------------------------------------------------------------------------------------------------------------------------------------------------------------
-------------------------------oSSSSo--------------------------------------------------------------------------------------------------SoooSS-------------------------------------------------oSoooo----
---------------------oSoS-------------------------------------------------------------------------------------------------ooo---------------------------------------ooo--------------ooSSoSo------------
-------------------------------oooooo-----------------------------------------------------------------oSSo----------------------------oooooooo---------------------------------ooo------------oooo------
--------------------oooo------g----g------------------ooS-------------------ooo------------Soo----------------------------oo------------------------------------------oo--------------ooooo-------------
------------XXXXX--------g-XXXXXXXXXXX----------XXXX-----------------------------------------------ooooo-----------------------------XXXXXXXXXXX---------------------------------------------XXXXXXXXX--
XXXXXXXXXXXXXXXXXXXXXXXXXXXXXXXXXXXXXXXXXX------XXXX---ooo-----------XXXXXXXXXXXX------------ooo---------g-XXXXXX---oo-XXXXXXXXXXXX--XXXXXXXXXXX------------------XXXXXXXXX---g-----XXXXXXXXXXXXXXXXXXXX
XXXXXXXXXXXXXXXXXXXXXXXXXXXXXXXXXXXXXXXXXXXXXXXXXXXX--------XXXXXXXXXXXXXXXXXXXXX------g----------XXXXXXXXXXXXXXX------XXXXXXXXXXXXXXXXXXXXXXXXX----------XXXX----XXXXXXXXXXXXXXXXXXXXXXXXXXXXXXXXXXXXXX
XXXXXXXXXXXXXXXXXXXXXXXXXXXXXXXXXXXXXXXXXXXXXXXXXXXXXXXXXXXXXXXXXXXXXXXXXXXXXXXXXXXXXXXXXXXXXXXXXXXXXXXXXXXXXXXXXXXXXXXXXXXXXXXXXXXXXXXXXXXXXXXXXXXXXXXXXXXXXXXXXXXXXXXXXXXXXXXXXXXXXXXXXXXXXXXXXXXXXXXX

