--------------------------------------------------------------------------------------------------------------------------------------------------------------------------------------------------------
--------------------------------------------------------------------------------------------------------------------------------------------------------------------------------------------------------
--------------------------------------------------------------------------------------------------------------------------------------------------------------------------------------------------------
--------------------------------------------------------------------------------------------------------------------------------------------------------------------------------------------------------
--------------------------------------------------------------------------------------------------------------------------------------------------------------------------------------------------------
--------------------------------------------------------------------------------------------------------------------------------------------------------------------------------------------------------
--------------------------------------------------------------------------------------------------------------------------------------------------------------------------------------------------------
--------------------------------------------------------------------------------------------------------------------------------------------------------------------------------------------------------
--------------------------------------------------------------------------------------------------------------------------------------------------------------------------------------------------------
--------------------------------------------------------------------------------------------------------------------------------------------------------------------------------------------------------
--------------------------------------------------------------------------------------------------------------------------------------------------------------------------------------------------------
--------------------------------------------------------------------------------------------------------------------------------------------------------------------------------------------------------
---------------------------------------------------------------------------------------------Soo----oooSoSo-------------------ooo---------------oSoSo------------------------------------------oSSSoS---
------------------------oSo--------------------------------------------------------------------------------------------------------------ooo------------------SSSooo------------------------------------
---------------oo--------------------------------------------------------------------------ooooooo----ooo----------------------oo--------------------------------------------------------------oooo-----
------------------------ooo------------------------------------------ooo---------ooSo-------g-------------------ooo--------------------ooooo------------------ooooo-----ooo-----------------------------
------------XXXXXX---------------------------------------------XXXX--------XXXXX---------XXXXXXXXXXXXXXXXXXXXXX-------XXXXXXXXXXXXXXX----------XXXXXXX------------g-------------------------XXXXXXXXXXX-
------------XXXXXX--XXXXXXXXXXXXXXX------------XXXXXXXXXXX-----XXXX--oooo--XXXXX----oo---XXXXXXXXXXXXXXXXXXXXXXXXXXXXXXXXXXXXXXXXXXXXXXXXXXXXXXXXXXXXX-----XXXXXXXXXX-----------------------XXXXXXXXXXX-
XXXXXXXXXXXXXXXXXX--XXXXXXXXXXXXXXXXXXXXXXXXX--XXXXXXXXXXXXXXXXXXXX--------XXXXX---------XXXXXXXXXXXXXXXXXXXXXXXXXXXXXXXXXXXXXXXXXXXXXXXXXXXXXXXXXXXXX-----XXXXXXXXXX------------XXXXXXXX---XXXXXXXXXXX-
XXXXXXXXXXXXXXXXXXXXXXXXXXXXXXXXXXXXXXXXXXXXXXXXXXXXXXXXXXXXXXXXXXXXXXXXXXXXXXXXXXXXXXXXXXXXXXXXXXXXXXXXXXXXXXXXXXXXXXXXXXXXXXXXXXXXXXXXXXXXXXXXXXXXXXXXXXXXXXXXXXXXXXXXXXXXXXXXXXXXXXXXXXXXXXXXXXXXXXXX

