--------------------------------------------------------------------------------------------------------------------------------------------------------------------------------------------------------
--------------------------------------------------------------------------------------------------------------------------------------------------------------------------------------------------------
--------------------------------------------------------------------------------------------------------------------------------------------------------------------------------------------------------
--------------------------------------------------------------------------------------------------------------------------------------------------------------------------------------------------------
--------------------------------------------------------------------------------------------------------------------------------------------------------------------------------------------------------
--------------------------------------------------------------------------------------------------------------------------------------------------------------------------------------------------------
--------------------------------------------------------------------------------------------------------------------------------------------------------------------------------------------------------
--------------------------------------------------------------------------------------------------------------------------------------------------------------------------------------------------------
--------------------------------------------------------------------------------------------------------------------------------------------------------------------------------------------------------
--------------------------------------------------------------------------------------------------------------------------------------------------------------------------------------------------------
--------------------------------------------------------------------------------------------------------------------------------------------------------------------------------------------------------
--------------------------------------------------------------------------------------------------------------------------------------------------------------------------------------------------------
------------------------------------------------------------oSoo-----ooo--------------------------------------------------------------oooS--------------------------------------------------------------
---------------------------------------------------------------------------------ooooo------------------------------------------------------------------SooSSooo----------------------------------------
---------------------------------------------oooo--------oooooo------oo------------------------------oSoo-------------------------------------------------------------------oSSo------------------------
---------------oooSoSS-------oooooS----------------------g----------------------oooo----------------------------ooo------------oo-------------oSSooo----ooooooo-------------------oooo------------------
--------------------------------------XXXXXXXXXXXX------XXXXXXXXXXXXXXXXXX-----------------------------oooo-------------------------XXXXXXXXX--------------------------------oo-------------------------
------------------ooooo------ooooo----XXXXXXXXXXXX------XXXXXXXXXXXXXXXXXX-----XXXXXXXXX-----XXXXXX--------------oo----XXXXXXXXXXXXXXXXXXXXXX---oooo--XXXXXXXXXXX-----g-------g--XXXXXXX-------oo--XXXXX
-------------------------------g------XXXXXXXXXXXX------XXXXXXXXXXXXXXXXXX-----XXXXXXXXXXXXXXXXXXXXXXXXXXXXXX----------XXXXXXXXXXXXXXXXXXXXXX---------XXXXXXXXXXXXXXXXXXXXXXXXXXXXXXXXXXXXX-----g--XXXXX
XXXXXXXXXXXXXXXXXXXXXXXXXXXXXXXXXXXXXXXXXXXXXXXXXXXXXXXXXXXXXXXXXXXXXXXXXXXXXXXXXXXXXXXXXXXXXXXXXXXXXXXXXXXXXXXXXXXXXXXXXXXXXXXXXXXXXXXXXXXXXXXXXXXXXXXXXXXXXXXXXXXXXXXXXXXXXXXXXXXXXXXXXXXXXXXXXXXXXXXX

