--------------------------------------------------------------------------------------------------------------------------------------------------------------------------------------------------------
--------------------------------------------------------------------------------------------------------------------------------------------------------------------------------------------------------
--------------------------------------------------------------------------------------------------------------------------------------------------------------------------------------------------------
--------------------------------------------------------------------------------------------------------------------------------------------------------------------------------------------------------
--------------------------------------------------------------------------------------------------------------------------------------------------------------------------------------------------------
--------------------------------------------------------------------------------------------------------------------------------------------------------------------------------------------------------
--------------------------------------------------------------------------------------------------------------------------------------------------------------------------------------------------------
--------------------------------------------------------------------------------------------------------------------------------------------------------------------------------------------------------
--------------------------------------------------------------------------------------------------------------------------------------------------------------------------------------------------------
--------------------------------------------------------------------------------------------------------------------------------------------------------------------------------------------------------
--------------------------------------------------------------------------------------------------------------------------------------------------------------------------------------------------------
--------------------------------------------------------------------------------------------------------------------------------------------------------------------------------------------------------
-----------------------oSo--------------------------------------------------------------------------------------------------------------------------------oSSoo-----------------------------------------
-------------------------------------------------------oSooS------------------------------------oSS---------------------------------oSoSS-----------------------------------oSooS-----------------------
---------------------oooooo----------------SoS--------------------------------------------------------ooSoo-------oooo--------------------------oooS----oooooo------------------------------------------
------------------------------oooo---------------------ooooo-----------------------------------oooo--------------------------oo-------oooo-------------------g----------------oooo----------------------
-------------------XXXXXXXXXX--------XXXX----ooo--------------------ooo-------------------------------ooooooo------oooooo---------------------oooo----XXXXXXXXXX----------------------------------------
--------------oooo-XXXXXXXXXXXXXXXXXXXXXX-g----------XXXXXXXXX----g-----XXXXXXXXXXXXX---------XXXXXXX-------------------g-XXXXXXXXXXXXXXXXXX----------XXXXXXXXXXXXXXX-----XXXXXXXXXX--ooooo-XXXXXXXXXXXX
XXXXXXXXXXXX---g---XXXXXXXXXXXXXXXXXXXXXXXXXXXXXXXX--XXXXXXXXX---XXXXXXXXXXXXXXXXXXXXXXXXXXXXXXXXXXXXXXXXXXXXXXXXXXXXXXXXXXXXXXXXXXXXXXXXXXXXXXXXXXXXXXXXXXXXXXXXXXXXXXXXXXXXXXXXXXX--------XXXXXXXXXXXX
XXXXXXXXXXXXXXXXXXXXXXXXXXXXXXXXXXXXXXXXXXXXXXXXXXXXXXXXXXXXXXXXXXXXXXXXXXXXXXXXXXXXXXXXXXXXXXXXXXXXXXXXXXXXXXXXXXXXXXXXXXXXXXXXXXXXXXXXXXXXXXXXXXXXXXXXXXXXXXXXXXXXXXXXXXXXXXXXXXXXXXXXXXXXXXXXXXXXXXXX

