--------------------------------------------------------------------------------------------------------------------------------------------------------------------------------------------------------
--------------------------------------------------------------------------------------------------------------------------------------------------------------------------------------------------------
--------------------------------------------------------------------------------------------------------------------------------------------------------------------------------------------------------
--------------------------------------------------------------------------------------------------------------------------------------------------------------------------------------------------------
--------------------------------------------------------------------------------------------------------------------------------------------------------------------------------------------------------
--------------------------------------------------------------------------------------------------------------------------------------------------------------------------------------------------------
--------------------------------------------------------------------------------------------------------------------------------------------------------------------------------------------------------
--------------------------------------------------------------------------------------------------------------------------------------------------------------------------------------------------------
--------------------------------------------------------------------------------------------------------------------------------------------------------------------------------------------------------
--------------------------------------------------------------------------------------------------------------------------------------------------------------------------------------------------------
--------------------------------------------------------------------------------------------------------------------------------------------------------------------------------------------------------
--------------------------------------------------------------------------------------------------------------------------------------------------------------------------------------------------------
-------------------------------------------------------------------------------------------ooSo---------------------------------------------------------------------------------------------------------
-----------------------------------------------------------------------------------------------------------------------------------------------------------------------oooo-----------------------------
-------------------------------------------------------------ooo-----oooooSo----------------ooo-------ooooooo--------------------------------------------------------------------------------------oooo-
---------------g---------oooo-----ooSSo-----------------------------------------SSoooSo---------------------------------------------oSSooo------------oo---------------oooo-------------Soooo-----------
------------XXXXXX---------------------------------oooooo--XXXXXX---ooooooo-------------XXXXXXXX---------ooooo----XXXXXXX------------------XX--------------XXX-------------------XXXXX--------XXX-------
XXXXXXXXXXXXXXXXXX----XXXXXXXX---ooooo--XX-----XXX---------XXXXXX-----------------ooo---XXXXXXXX------------------XXXXXXX----------oooooo--XX--------XXXXXXXXX-------XXXXXXXXXXXXXXXXX---oooo-XXX-------
XXXXXXXXXXXXXXXXXX--XXXXXXXXXX----------XX-----XXXXXXXXXXXXXXXXXX--XXXXXXXXXXX-----g----XXXXXXXX-----XXXXXXXXXX---XXXXXXX---XXXXX----------XXXXXXXXXXXXXXXXXXXXXXXXXXXXXXXXXXXXXXXXXXX--------XXXXXXXXXX
XXXXXXXXXXXXXXXXXXXXXXXXXXXXXXXXXXXXXXXXXXXXXXXXXXXXXXXXXXXXXXXXXXXXXXXXXXXXXXXXXXXXXXXXXXXXXXXXXXXXXXXXXXXXXXXXXXXXXXXXXXXXXXXXXXXXXXXXXXXXXXXXXXXXXXXXXXXXXXXXXXXXXXXXXXXXXXXXXXXXXXXXXXXXXXXXXXXXXXXX

