--------------------------------------------------------------------------------------------------------------------------------------------------------------------------------------------------------
--------------------------------------------------------------------------------------------------------------------------------------------------------------------------------------------------------
--------------------------------------------------------------------------------------------------------------------------------------------------------------------------------------------------------
--------------------------------------------------------------------------------------------------------------------------------------------------------------------------------------------------------
--------------------------------------------------------------------------------------------------------------------------------------------------------------------------------------------------------
--------------------------------------------------------------------------------------------------------------------------------------------------------------------------------------------------------
--------------------------------------------------------------------------------------------------------------------------------------------------------------------------------------------------------
--------------------------------------------------------------------------------------------------------------------------------------------------------------------------------------------------------
--------------------------------------------------------------------------------------------------------------------------------------------------------------------------------------------------------
--------------------------------------------------------------------------------------------------------------------------------------------------------------------------------------------------------
--------------------------------------------------------------------------------------------------------------------------------------------------------------------------------------------------------
--------------------------------------------------------------------------------------------------------------------------------------------------------------------------------------------------------
--------------------------------------------------------------------------------------------------------------------------------------------------------------------------------------------------------
----------------------------------------------------------------------ooooS-----------------------------------------------------------------------ooS---------------------------------------------------
--------------------------------------------------------------------------------oSoooooo------------------------SoSoooo---------------------------------------oooo-------------------ooSo---------------
----------------------------oooSSoo---------------------------------------------------------------------------------------------------------------oooooo------------------------------------------------
----------------oo---------------------XXXXXXXXX----------------------------------oooooo-XXX----------------------ooo-------XX-----XXXX--------------------XXXXXXXX---XXX--------------oooo-XXXXX-------
XXXXXXXXXX------------XXXX--oooooooo---XXXXXXXXX-----XXX-------------XXXXXXXXX-----------XXXXX-------------oo------g-----XXXXXXXXXXXXXX----------XXXXXXXX--XXXXXXXX---XXX-------------------XXXXXXXXXXXX
XXXXXXXXXXXXXXXXXXXXXXXXXX-------------XXXXXXXXX-----XXX--------XXXXXXXXXXXXXXXXXXXXXXXXXXXXXXXXXXXX----------XXXXXXXXXXXXXXXXXXXXXXXXX----------XXXXXXXX--XXXXXXXX---XXX---XXX----XXXXXXXXXXXXXXXXXXXXX
XXXXXXXXXXXXXXXXXXXXXXXXXXXXXXXXXXXXXXXXXXXXXXXXXXXXXXXXXXXXXXXXXXXXXXXXXXXXXXXXXXXXXXXXXXXXXXXXXXXXXXXXXXXXXXXXXXXXXXXXXXXXXXXXXXXXXXXXXXXXXXXXXXXXXXXXXXXXXXXXXXXXXXXXXXXXXXXXXXXXXXXXXXXXXXXXXXXXXXXX

