--------------------------------------------------------------------------------------------------------------------------------------------------------------------------------------------------------
--------------------------------------------------------------------------------------------------------------------------------------------------------------------------------------------------------
--------------------------------------------------------------------------------------------------------------------------------------------------------------------------------------------------------
--------------------------------------------------------------------------------------------------------------------------------------------------------------------------------------------------------
--------------------------------------------------------------------------------------------------------------------------------------------------------------------------------------------------------
--------------------------------------------------------------------------------------------------------------------------------------------------------------------------------------------------------
--------------------------------------------------------------------------------------------------------------------------------------------------------------------------------------------------------
--------------------------------------------------------------------------------------------------------------------------------------------------------------------------------------------------------
--------------------------------------------------------------------------------------------------------------------------------------------------------------------------------------------------------
--------------------------------------------------------------------------------------------------------------------------------------------------------------------------------------------------------
--------------------------------------------------------------------------------------------------------------------------------------------------------------------------------------------------------
--------------------------------------------------------------------------------------------------------------------------------------------------------------------------------------------------------
-----------------------------------------------------------oooo------ooo--oSSoSoo-----------------------------------------------------------------------------------------------------------------------
-------------------------------Soo-------------------------------------------------------------------------------------------ooSS----------Soooo--------------------------------------oSoooo------------
------------------------------------------------------------ooo------oo---ooooo------------Sooo-------------ooooSoS-----------------------------------ooooo---SoSoo-------------------------------------
-------------------------------oooo-------------------------g--------------------------------------oooSSSo------------------ooooo-------oooooo------------------------------------------oooo------------
--------------oooo-----XXXX------------------XXXXXX-----XXXXXXXX---XXXXXXXXXXXXXXX--------ooooooo--------------ooo----XXXX-g------------g-----------XXXXXXXX---oo--------oo------------------------oo---
--------------------XXXXXXXXXXXXXXXXXX-----XXXXXXXXXXXXXXXXXXXXX---XXXXXXXXXXXXXXX------------------------------------XXXXXXXXXXXXXXXXXXXXXXXXXXX---XXXXXXXX-----------g-------------XXXXXXXXXXX------XX
-------------XXXXXXXXXXXXXXXXXXXXXXXXX-----XXXXXXXXXXXXXXXXXXXXXXXXXXXXXXXXXXXXXXX-----XXXXXXXXXXX--g------XXXXXXXXXXXXXXXXXXXXXXXXXXXXXXXXXXXXXX---XXXXXXXXXXXXXXXXXXXXXXXX------XXXXXXXXXXXXXXXXXXXXXX
XXXXXXXXXXXXXXXXXXXXXXXXXXXXXXXXXXXXXXXXXXXXXXXXXXXXXXXXXXXXXXXXXXXXXXXXXXXXXXXXXXXXXXXXXXXXXXXXXXXXXXXXXXXXXXXXXXXXXXXXXXXXXXXXXXXXXXXXXXXXXXXXXXXXXXXXXXXXXXXXXXXXXXXXXXXXXXXXXXXXXXXXXXXXXXXXXXXXXXXX

