--------------------------------------------------------------------------------------------------------------------------------------------------------------------------------------------------------
--------------------------------------------------------------------------------------------------------------------------------------------------------------------------------------------------------
--------------------------------------------------------------------------------------------------------------------------------------------------------------------------------------------------------
--------------------------------------------------------------------------------------------------------------------------------------------------------------------------------------------------------
--------------------------------------------------------------------------------------------------------------------------------------------------------------------------------------------------------
--------------------------------------------------------------------------------------------------------------------------------------------------------------------------------------------------------
--------------------------------------------------------------------------------------------------------------------------------------------------------------------------------------------------------
--------------------------------------------------------------------------------------------------------------------------------------------------------------------------------------------------------
--------------------------------------------------------------------------------------------------------------------------------------------------------------------------------------------------------
--------------------------------------------------------------------------------------------------------------------------------------------------------------------------------------------------------
--------------------------------------------------------------------------------------------------------------------------------------------------------------%%%%%%------------------------------------
--------------------------------------------------------------------------------------------------------------------------------------------------------------||||||------------------------------------
-----------------------------SSooo-----------------------------------------oooS-------------oSooS------ooSo---------------------------------------------------||||||---g--------------------------------
--------------------------------------------------------------------------------------------------------------------------------------------------------------||||||--%%%-------------------------------
---------------Soo------------oooo------------------------------------------ooo---------------oo-----oooo--------ooSooSo-------------ooSooo-------------------||||||--|||--------------------ooSoo------
---------------------------g------------------SoSSo---oo------------------------------------------------------------------------------------------------------||||||--|||------------oSooo--------------
------------ooooooo---XX--XXXXXXXXXXX---------------------------------ooo-XXXXXXXXXXX-oo---XXXXXXXXXXXXXXXXXX-------ooo-----------ooooooo---------------------||||||--|||---XXX-----------------oo------
XXXXXXXXXXX-----------XXXXXXXXXXXXXXX---------------XXXXXXXX--------------XXXXXXXXXXX---g--XXXXXXXXXXXXXXXXXX----------------------------------oo---------XXXXXXXXXXXXXXXXXXXXX-----ooooo---------------
XXXXXXXXXXXXXXXXXXXXXXXXXXXXXXXXXXXXXXXXXXXX--------XXXXXXXXXX-----XXXXXXXXXXXXXXXXXXXXXXXXXXXXXXXXXXXXXXXXXX---XXXXXXXXX--------XXXXXXXXXXX----------XXXXXXXXXXXXXXXXXXXXXXXXXXXX----------XXXXXXXXXXXX
XXXXXXXXXXXXXXXXXXXXXXXXXXXXXXXXXXXXXXXXXXXXXXXXXXXXXXXXXXXXXXXXXXXXXXXXXXXXXXXXXXXXXXXXXXXXXXXXXXXXXXXXXXXXXXXXXXXXXXXXXXXXXXXXXXXXXXXXXXXXXXXXXXXXXXXXXXXXXXXXXXXXXXXXXXXXXXXXXXXXXXXXXXXXXXXXXXXXXXXX

