--------------------------------------------------------------------------------------------------------------------------------------------------------------------------------------------------------
--------------------------------------------------------------------------------------------------------------------------------------------------------------------------------------------------------
--------------------------------------------------------------------------------------------------------------------------------------------------------------------------------------------------------
--------------------------------------------------------------------------------------------------------------------------------------------------------------------------------------------------------
--------------------------------------------------------------------------------------------------------------------------------------------------------------------------------------------------------
--------------------------------------------------------------------------------------------------------------------------------------------------------------------------------------------------------
--------------------------------------------------------------------------------------------------------------------------------------------------------------------------------------------------------
--------------------------------------------------------------------------------------------------------------------------------------------------------------------------------------------------------
--------------------------------------------------------------------------------------------------------------------------------------------------------------------------------------------------------
--------------------------------------------------------------------------------------------------------------------------------------------------------------------------------------------------------
--------------------------------------------------------------------------------------------------------------------------------------------------------------------------------------------------------
--------------------------------------------------------------------------------------------------------------------------------------------------------------------------------------------------------
----------------------oooooo----------------------------------------------------------------------------------ooS--------------------------ooo----------------------------------------------------------
--------------------------------------------------SSooS----------------------oSoSoo-----------oooo-----------------------------------------------oooSoooS---ooSo----------------------------------------
----------------------ooooooo----------------------------------------------------------------------------------ooo----------oSSoo-----------------------------------------------------------------------
-----------------------------------------ooooo---ooooooo---oooSo------------ooooo-------------oooo-------------------------------------------g-----ooooooo----------------ooooo------------oo----oooo---
--------------XXXXXXXXXXXXXXXX------------------g--g-------------------------------------------------------XXXXXXXXXXXXXXX-oooooo---------XXXXXX------g-------------------------XXXXXXXXX---------------
--------------XXXXXXXXXXXXXXXX---------XXXXXXXXXXXXXXXXXXX----ooo--XXXXXXXXXXXXXXXXX----oooo-XXXXXX--------XXXXXXXXXXXXXXX---------XXXXXXXXXXXXXXXXXXXXXXXXXXXXXXXX-----XXXXXXXXXXXXXXXXXXXXXXX-oooooo--
XXXXXXXXXXXXXXXXXXXXXXXXXXXXXX---------XXXXXXXXXXXXXXXXXXX---------XXXXXXXXXXXXXXXXXXXX------XXXXXXXXXXXXXXXXXXXXXXXXXXXXXXXXXXXXXXXXXXXXXXXXXXXXXXXXXXXXXXXXXXXXXX-----XXXXXXXXXXXXXXXXXXXXXXX-g-------
XXXXXXXXXXXXXXXXXXXXXXXXXXXXXXXXXXXXXXXXXXXXXXXXXXXXXXXXXXXXXXXXXXXXXXXXXXXXXXXXXXXXXXXXXXXXXXXXXXXXXXXXXXXXXXXXXXXXXXXXXXXXXXXXXXXXXXXXXXXXXXXXXXXXXXXXXXXXXXXXXXXXXXXXXXXXXXXXXXXXXXXXXXXXXXXXXXXXXXXX

