--------------------------------------------------------------------------------------------------------------------------------------------------------------------------------------------------------
--------------------------------------------------------------------------------------------------------------------------------------------------------------------------------------------------------
--------------------------------------------------------------------------------------------------------------------------------------------------------------------------------------------------------
--------------------------------------------------------------------------------------------------------------------------------------------------------------------------------------------------------
--------------------------------------------------------------------------------------------------------------------------------------------------------------------------------------------------------
--------------------------------------------------------------------------------------------------------------------------------------------------------------------------------------------------------
--------------------------------------------------------------------------------------------------------------------------------------------------------------------------------------------------------
--------------------------------------------------------------------------------------------------------------------------------------------------------------------------------------------------------
--------------------------------------------------------------------------------------------------------------------------------------------------------------------------------------------------------
--------------------------------------------------------------------------------------------------------------------------------------------------------------------------------------------------------
--------------------------------------------------------------------------------------------------------------------------------------------------------------------------------------------------------
--------------------------------------------------------------------------------------------------------------------------------------------------------------------------------------------------------
-------------------------------------------------------------------------------------------------oSSoSoo---ooS------------------------------------------------------------------------------------------
-------------------------------------------ooSo---------------------------------------------------------------------------------------ooSSo----------------------------------------SoSo-----------------
------------------------------------------------------------oSSSoo------ooo--------ooo-----------ooooooo----oo-----Soooo--------------------------------------------------------------------------------
--------------ooooooSo----ooSoo---------oooooooo-------------------------------------------------------g-----------------------oSo-------------------------------------ooo--------oooo------------------
-----------------------------------------------------------oooooo---XXXXXXXXX----XXXXXXX----XXXXXXXXXXXXXXXXXXXXX---ooo-------------------g--XXXXXX---------------------------------------------------XX
--------------ooooooo------oooooo-XXXXXXXXXXXXXXX----XXXX---ggg-----XXXXXXXXX----XXXXXXX----XXXXXXXXXXXXXXXXXXXXX--------g--ooooooo--XXXXXXXXXXXXXXXXXXXXXXXXXXX-----XXXXXX-----XXXXXXXXXX----XXX---XXXX
XXXXXXXXXXXXX----------------g----XXXXXXXXXXXXXXX----XXXXXXXXXXXXXXXXXXXXXXXXXXXXXXXXXXX----XXXXXXXXXXXXXXXXXXXXXXXXXXXXXXX----------XXXXXXXXXXXXXXXXXXXXXXXXXXX-----XXXXXXXXXXXXXXXXXXXXX----XXX---XXXX
XXXXXXXXXXXXXXXXXXXXXXXXXXXXXXXXXXXXXXXXXXXXXXXXXXXXXXXXXXXXXXXXXXXXXXXXXXXXXXXXXXXXXXXXXXXXXXXXXXXXXXXXXXXXXXXXXXXXXXXXXXXXXXXXXXXXXXXXXXXXXXXXXXXXXXXXXXXXXXXXXXXXXXXXXXXXXXXXXXXXXXXXXXXXXXXXXXXXXXXX

