--------------------------------------------------------------------------------------------------------------------------------------------------------------------------------------------------------
--------------------------------------------------------------------------------------------------------------------------------------------------------------------------------------------------------
--------------------------------------------------------------------------------------------------------------------------------------------------------------------------------------------------------
--------------------------------------------------------------------------------------------------------------------------------------------------------------------------------------------------------
--------------------------------------------------------------------------------------------------------------------------------------------------------------------------------------------------------
--------------------------------------------------------------------------------------------------------------------------------------------------------------------------------------------------------
--------------------------------------------------------------------------------------------------------------------------------------------------------------------------------------------------------
--------------------------------------------------------------------------------------------------------------------------------------------------------------------------------------------------------
--------------------------------------------------------------------------------------------------------------------------------------------------------------------------------------------------------
--------------------------------------------------------------------------------------------------------------------------------------------------------------------------------------------------------
--------------------------------------------------------------------------------------------------------------------------------------------------------------------------------------------------------
--------------------------------------------------------------------------------------------------------------------------------------------------------------------------------------------------------
--------------------------------------------------------------------------oSooo---------------------------------------------------------------------ooooSo---------Sooo---------------------------------
---------------------------------------------------oooo------------------------------------------------------------------------------------------------------------------------------oSSooSSo-----------
---------------------ooo-------oSooo---------------------------------------ooooo---------------Sooo---------------------------ooo-------------------oooooo------oooooo----------------------------------
--------------------------------------------------ooooo-------------oo------------------oo--------------------------------------------ooooooooo-------------------------------oSS------oooooo--ooSSooo--
----------------XXXXXXXXXXXX----ooooo---XXXXX-----------XXX--------g-----XXXXXXXX--------gg--ooooooo----------XXXX-----------oooooo-------------XXXXXXXXXXXXXXXXXXXXXXXXXX------------------------------
----------------XXXXXXXXXXXX------g---g-XXXXX----XXXXXXXXXX-ooo---XXXXXXXXXXXXXXX---XXXXXXXX------------------XXXX---ooo----------------oooooo--XXXXXXXXXXXXXXXXXXXXXXXXXX-oooooo--XXXXXXXXXXX-ooooooo--
----------------XXXXXXXXXXXX--XXXXXXXXXXXXXXX----XXXXXXXXXX-------XXXXXXXXXXXXXXX---XXXXXXXXXXXXXXXXXXX-------XXXX---------XXXXXXXXXX-----------XXXXXXXXXXXXXXXXXXXXXXXXXX---------XXXXXXXXXXX----------
XXXXXXXXXXXXXXXXXXXXXXXXXXXXXXXXXXXXXXXXXXXXXXXXXXXXXXXXXXXXXXXXXXXXXXXXXXXXXXXXXXXXXXXXXXXXXXXXXXXXXXXXXXXXXXXXXXXXXXXXXXXXXXXXXXXXXXXXXXXXXXXXXXXXXXXXXXXXXXXXXXXXXXXXXXXXXXXXXXXXXXXXXXXXXXXXXXXXXXXX

