--------------------------------------------------------------------------------------------------------------------------------------------------------------------------------------------------------
--------------------------------------------------------------------------------------------------------------------------------------------------------------------------------------------------------
--------------------------------------------------------------------------------------------------------------------------------------------------------------------------------------------------------
--------------------------------------------------------------------------------------------------------------------------------------------------------------------------------------------------------
--------------------------------------------------------------------------------------------------------------------------------------------------------------------------------------------------------
--------------------------------------------------------------------------------------------------------------------------------------------------------------------------------------------------------
--------------------------------------------------------------------------------------------------------------------------------------------------------------------------------------------------------
--------------------------------------------------------------------------------------------------------------------------------------------------------------------------------------------------------
--------------------------------------------------------------------------------------------------------------------------------------------------------------------------------------------------------
--------------------------------------------------------------------------------------------------------------------------------------------------------------------------------------------------------
--------------------------------------------------------------------------------------------------------------------------------------------------------------------------------------------------------
--------------------------------------------------------------------------------------------------------------------------------------------------------------------------------------------------------
------------------------------------------oooo----------------------------------------------------------------------------------------------------------------------------------------------------------
----------------------------------------------------------------------------------oSo-----------------------------------------------------------------------------------g-------------------------------
------------------oSo--------------------ooooo------------ooo-----------------------------------------------------------------------------ooo--------------------------%%%%-----------------------------
-----------------------------------------------------------------ooo--------------oooooo-----------------------oo--------oSoo-----------------------SSooo--oSooSoooo---||||-----------------------------
-------------XXXX---oo-----XXXX--------XXXXXXXXXXX-----XX--------------------------------------------oo------------------------------------oo--------------------------||||-----------------------------
-------------XXXX----------XXXX--------XXXXXXXXXXXXXXXXXX--------ooo---XXXX------XXXXXXXX-ooooooo----------XXXXXXXXXX----oooooo-----------g------oooooooo-----oooo---XXXXXXXXXXXXX--XXXX---XXXXX--------
-------------XXXXXXXXXX----XXXXXXXXXX--XXXXXXXXXXXXXXXXXXXXXXXX------g-XXXX------XXXXXXXX----------XXXXXXXXXXXXXXXXXXXX-----g----XXXXX---XXXXXXX---------------------XXXXXXXXXXXXXXXXXXXXXXXXXXX--------
XXXXXXXXXXXXXXXXXXXXXXXXXXXXXXXXXXXXXXXXXXXXXXXXXXXXXXXXXXXXXXXXXXXXXXXXXXXXXXXXXXXXXXXXXXXXXXXXXXXXXXXXXXXXXXXXXXXXXXXXXXXXXXXXXXXXXXXXXXXXXXXXXXXXXXXXXXXXXXXXXXXXXXXXXXXXXXXXXXXXXXXXXXXXXXXXXXXXXXXX

