--------------------------------------------------------------------------------------------------------------------------------------------------------------------------------------------------------
--------------------------------------------------------------------------------------------------------------------------------------------------------------------------------------------------------
--------------------------------------------------------------------------------------------------------------------------------------------------------------------------------------------------------
--------------------------------------------------------------------------------------------------------------------------------------------------------------------------------------------------------
--------------------------------------------------------------------------------------------------------------------------------------------------------------------------------------------------------
--------------------------------------------------------------------------------------------------------------------------------------------------------------------------------------------------------
--------------------------------------------------------------------------------------------------------------------------------------------------------------------------------------------------------
--------------------------------------------------------------------------------------------------------------------------------------------------------------------------------------------------------
--------------------------------------------------------------------------------------------------------------------------------------------------------------------------------------------------------
--------------------------------------------------------------------------------------------------------------------------------------------------------------------------------------------------------
--------------------------------------------------------------------------------------------------------------------------------------------------------------------------------------------------------
--------------------------------------------------------------------------------------------------------------------------------------------------------------------------------------------------------
---------------------------------ooSo----ooooooooo---------------------ooooooo---------------SoS-----ooo----------------------------------------------oooo------------------------oSSooo----------------
------------------------------------------------------SSoo-------------------------SoooSo----------------------------------------------------------------------------------------------------oooSoS-----
---------------oSooo-------oooo----oo------ooooo-------------------------oooo----------------ooo----ooo-------oSoSooSo----------------------SooSo-----oo-------oSSo--------------ooooo------------------
-------------------------------------------------------ooo-----ooooo--------------oooooo-----------------------------------------------------------------g---------------------------g-------ooooooo----
----------------oooooo----------XXXXXXXXXXXXXXXXXXX-------------------XXXXXXXXXXX---------XXXXXXXXXXXXXXX--------oooooo----XXXX--------------ooooo---XXXXXX--ooo----XXXX-------XXXXXXXXXXX-----------XXX
--------------------------------XXXXXXXXXXXXXXXXXXXXXXXXXXXXXXXXXXXXXXXXXXXXXXXXXXXXXXXXXXXXXXXXXXXXXXXXX------------------XXXXXXX----ooo------------XXXXXX---------XXXX-ooo---XXXXXXXXXXXXXXXXXXXXXXXXX
--------------XXXXXXXXXXXXXXXXXXXXXXXXXXXXXXXXXXXXXXXXXXXXXXXXXXXXXXXXXXXXXXXXXXXXXXXXXXXXXXXXXXXXXXXXXXXXXXXXXXXXXXXXXXXXXXXXXXXX--------XXXXXXXXXXXXXXXXXXXXXXXXXXXXXX-g-----XXXXXXXXXXXXXXXXXXXXXXXXX
XXXXXXXXXXXXXXXXXXXXXXXXXXXXXXXXXXXXXXXXXXXXXXXXXXXXXXXXXXXXXXXXXXXXXXXXXXXXXXXXXXXXXXXXXXXXXXXXXXXXXXXXXXXXXXXXXXXXXXXXXXXXXXXXXXXXXXXXXXXXXXXXXXXXXXXXXXXXXXXXXXXXXXXXXXXXXXXXXXXXXXXXXXXXXXXXXXXXXXXX

