--------------------------------------------------------------------------------------------------------------------------------------------------------------------------------------------------------
--------------------------------------------------------------------------------------------------------------------------------------------------------------------------------------------------------
--------------------------------------------------------------------------------------------------------------------------------------------------------------------------------------------------------
--------------------------------------------------------------------------------------------------------------------------------------------------------------------------------------------------------
--------------------------------------------------------------------------------------------------------------------------------------------------------------------------------------------------------
--------------------------------------------------------------------------------------------------------------------------------------------------------------------------------------------------------
--------------------------------------------------------------------------------------------------------------------------------------------------------------------------------------------------------
--------------------------------------------------------------------------------------------------------------------------------------------------------------------------------------------------------
--------------------------------------------------------------------------------------------------------------------------------------------------------------------------------------------------------
--------------------------------------------------------------------------------------------------------------------------------------------------------------------------------------------------------
--------------------------------------------------------------------------------------------------------------------------------------------------------------------------------------------------------
--------------------------------------------------------------------------------------------------------------------------------------------------------------------------------------------------------
--------------oSoo-------------------oSoS----------------------------------------------ooSoooo-------------Soo------------ooo---------------------------------------------------------------------------
-----------------------------------------------Soo--------------------------------------------------------------------------------------------------------------------------------------------SoSoo-----
--------------oooooo----SSSooo--------oo-------------------SoS-------oooo--------------ooooo------------ooo-------------------------------------------oooooooS------------------------------------------
--------------g--------------------------------oo----------------------------------------------------------------------------------------------ooSo---------------------oSSoo-----oSSoSooSo---ooooo-----
-------------XXXXXXXX-ooooooo-------XXXXXXX---------XXXX---oooooo--ooooooo---XXX----XXXXXXXXXXX--------XXXXXXXX----XXXX--XXXXXXXX--------XXX-----------ooooooo-----------------------------------g------
-------------XXXXXXXX------g---XXXXXXXXXXXXXXXXXXXXXXXXX---------------------XXX----XXXXXXXXXXX----ooo-XXXXXXXXXXXXXXXXXXXXXXXXXX--------XXX----oooo-----g---------------oooooo-----oooo----XXXXXXXXXX--
XXXXXXXXXXXXXXXXXXXXXXXXXXXXXXXXXXXXXXXXXXXXXXXXXXXXXXXXXXXXXXXXXXXXXXXXXXXXXXXX----XXXXXXXXXXX--------XXXXXXXXXXXXXXXXXXXXXXXXXXXXXXXXXXXXX---------XXXXXXXXXXX----------------------------XXXXXXXXXXXX
XXXXXXXXXXXXXXXXXXXXXXXXXXXXXXXXXXXXXXXXXXXXXXXXXXXXXXXXXXXXXXXXXXXXXXXXXXXXXXXXXXXXXXXXXXXXXXXXXXXXXXXXXXXXXXXXXXXXXXXXXXXXXXXXXXXXXXXXXXXXXXXXXXXXXXXXXXXXXXXXXXXXXXXXXXXXXXXXXXXXXXXXXXXXXXXXXXXXXXXX

