--------------------------------------------------------------------------------------------------------------------------------------------------------------------------------------------------------
--------------------------------------------------------------------------------------------------------------------------------------------------------------------------------------------------------
--------------------------------------------------------------------------------------------------------------------------------------------------------------------------------------------------------
--------------------------------------------------------------------------------------------------------------------------------------------------------------------------------------------------------
--------------------------------------------------------------------------------------------------------------------------------------------------------------------------------------------------------
--------------------------------------------------------------------------------------------------------------------------------------------------------------------------------------------------------
--------------------------------------------------------------------------------------------------------------------------------------------------------------------------------------------------------
--------------------------------------------------------------------------------------------------------------------------------------------------------------------------------------------------------
--------------------------------------------------------------------------------------------------------------------------------------------------------------------------------------------------------
--------------------------------------------------------------------------------------------------------------------------------------------------------------------------------------------------------
--------------------------------------------------------------------------------------------------------------------------------------------------------------------------------------------------------
--------------------------------------------------------------------------------------------------------------------------------------------------------------------------------------------------------
----------------------------------------------------------------------------------------ooS-----------------------------------------------------------------ooSooooo------------------------------------
------------------------------------------------------------------------oooo-----------------------------Soooo----------------------------ooooSS------------------------------------ooooSooo------------
---------------------------------------------------------------------------------------ooo-----------------------SoS------------------------------------------ooooo-----ooo-----------------------------
------------------------------------------------------------oo---oo---------------------------oSooooo------------------ooooo--ooSS-------ooooo---------------------------------------oooo-------ooS-----
--------------------ooooo--------------------------------------------------------oo---XXXXXXX---------------------oo---------------------------------------XXXXXXXXXXXXXXXXX--ooo-------g--------------X
XXXXXXXXXXX------------------------------XXX-------------XXXXXXXXXXXXXXXXXXXXX--------XXXXXXX---ooo---XXXXXXXXX-------XXXXXXX--oo-------XXXXXXXXXX---oooo--XXXXXXXXXXXXXXXXX----g--XXXXXXXXXX--oooo----X
XXXXXXXXXXX-----XXXXXXXXXXXXXXXX--XXXXXXXXXX------XXXXXXXXXXXXXXXXXXXXXXXXXXXXXXXXXXXXXXXXXXX------gg-XXXXXXXXXXXXXXXXXXXXXXX-----------XXXXXXXXXX---g-----XXXXXXXXXXXXXXXXXXXXXXXXXXXXXXXXXX----------X
XXXXXXXXXXXXXXXXXXXXXXXXXXXXXXXXXXXXXXXXXXXXXXXXXXXXXXXXXXXXXXXXXXXXXXXXXXXXXXXXXXXXXXXXXXXXXXXXXXXXXXXXXXXXXXXXXXXXXXXXXXXXXXXXXXXXXXXXXXXXXXXXXXXXXXXXXXXXXXXXXXXXXXXXXXXXXXXXXXXXXXXXXXXXXXXXXXXXXXXX

