--------------------------------------------------------------------------------------------------------------------------------------------------------------------------------------------------------
--------------------------------------------------------------------------------------------------------------------------------------------------------------------------------------------------------
--------------------------------------------------------------------------------------------------------------------------------------------------------------------------------------------------------
--------------------------------------------------------------------------------------------------------------------------------------------------------------------------------------------------------
--------------------------------------------------------------------------------------------------------------------------------------------------------------------------------------------------------
--------------------------------------------------------------------------------------------------------------------------------------------------------------------------------------------------------
--------------------------------------------------------------------------------------------------------------------------------------------------------------------------------------------------------
--------------------------------------------------------------------------------------------------------------------------------------------------------------------------------------------------------
--------------------------------------------------------------------------------------------------------------------------------------------------------------------------------------------------------
--------------------------------------------------------------------------------------------------------------------------------------------------------------------------------------------------------
--------------------------------------------------------------------------------------------------------------------------------------------------------------------------------------------------------
--------------------------------------------------------------------------------------------------------------------------------------------------------------------------------------------------------
----------------------------------------------------------------------------oSoo---------------------------------------------------------------------------ooSSSo---------------------------------------
-----------------------------------------------------------------------------------------------ooSoo----------------------------------------------------------------------------------SoSooo------------
--------------------ooSooo-----------------ooooS----------------------------oooo-----------------------------------oooo-----------------------------ooo----oooo------------ooo--------------------------
-------------------------------SSSoSS------------------------ooSoS--------------------Sooooo-----ooo-------------------------------------------------------------------------------ooooooooo--oSoo------
XXXXXXXXXXX----------oooooo----------------ooooo--------------------------XXXXXXXXXX---------------g----------------oo----------------XX-----------XXXXXXXXXXXXXXXXXXXXXXXXXXXX-----------------------XX
XXXXXXXXXXXXXXXXXXX------------oooooooo--g--------------g-----oooo--XXXXXXXXXXXXXXXX---oooo--XXXXXXXX---------------------------------XX--XXXXX----XXXXXXXXXXXXXXXXXXXXXXXXXXXX---XXXXXXXXXXX---------XX
XXXXXXXXXXXXXXXXXXXXXXXXXXXXX-----------XXXXXXXXXXXXXXXXXX----------XXXXXXXXXXXXXXXX---------XXXXXXXX--------XXXXXXXXXXXXX----XXX-----XX--XXXXX----XXXXXXXXXXXXXXXXXXXXXXXXXXXXXXXXXXXXXXXXXX---------XX
XXXXXXXXXXXXXXXXXXXXXXXXXXXXXXXXXXXXXXXXXXXXXXXXXXXXXXXXXXXXXXXXXXXXXXXXXXXXXXXXXXXXXXXXXXXXXXXXXXXXXXXXXXXXXXXXXXXXXXXXXXXXXXXXXXXXXXXXXXXXXXXXXXXXXXXXXXXXXXXXXXXXXXXXXXXXXXXXXXXXXXXXXXXXXXXXXXXXXXXX

