--------------------------------------------------------------------------------------------------------------------------------------------------------------------------------------------------------
--------------------------------------------------------------------------------------------------------------------------------------------------------------------------------------------------------
--------------------------------------------------------------------------------------------------------------------------------------------------------------------------------------------------------
--------------------------------------------------------------------------------------------------------------------------------------------------------------------------------------------------------
--------------------------------------------------------------------------------------------------------------------------------------------------------------------------------------------------------
--------------------------------------------------------------------------------------------------------------------------------------------------------------------------------------------------------
--------------------------------------------------------------------------------------------------------------------------------------------------------------------------------------------------------
--------------------------------------------------------------------------------------------------------------------------------------------------------------------------------------------------------
--------------------------------------------------------------------------------------------------------------------------------------------------------------------------------------------------------
--------------------------------------------------------------------------------------------------------------------------------------------------------------------------------------------------------
--------------------------------------------------------------------------------------------------------------------------------------------------------------------------------------------------------
--------------------------------------------------------------------------------------------------------------------------------------------------------------------------------------------------------
-------------------------SoSSoo-------------------------------------------------------------------------------------------------------------------------------------------------------------------------
----------------------------------------oSoo--------------------------------------------------------------------------------------------SSo----oSo---------------ooSo-----------------------------oSSoo-
--------------------------oo----------------------------------------------------------------------------------------------------------------------------oooo--------------ooo---------------------------
---------------------------------------oooooooo---------------------------------------ooSoSoo-------------------oooo-------------------oooo---oooo------------ooooo-----------------ooS---oooS---oooooo-
-----------ooo--------XXXXXXXXXX-------------------------ooooo----------------------------------------------------------------------------------------ooooo------------oooooo---------------------------
XXXXXXXXXX------------XXXXXXXXXX-----XXXXXXXXXXX--oo--------------XXXX-----XXXX-------ooooooo--------------------oooooo--oooo-------XXXXXXXXXXXXXXXXX----g---XXXXXXXXX--------XX-----------ooo--XXXXXXXX
XXXXXXXXXXXXXXXXXXXXXXXXXXXXXXXX-----XXXXXXXXXXX-------XXXXXXXX---XXXXXXXXXXXXXXXXX-----------XXXXXXXXXXXXXXXX-g---------g----XXXX--XXXXXXXXXXXXXXXXXXXXXXXXXXXXXXXXXXXXXXXXXXXX----------------XXXXXXXX
XXXXXXXXXXXXXXXXXXXXXXXXXXXXXXXXXXXXXXXXXXXXXXXXXXXXXXXXXXXXXXXXXXXXXXXXXXXXXXXXXXXXXXXXXXXXXXXXXXXXXXXXXXXXXXXXXXXXXXXXXXXXXXXXXXXXXXXXXXXXXXXXXXXXXXXXXXXXXXXXXXXXXXXXXXXXXXXXXXXXXXXXXXXXXXXXXXXXXXXX

