--------------------------------------------------------------------------------------------------------------------------------------------------------------------------------------------------------
--------------------------------------------------------------------------------------------------------------------------------------------------------------------------------------------------------
--------------------------------------------------------------------------------------------------------------------------------------------------------------------------------------------------------
--------------------------------------------------------------------------------------------------------------------------------------------------------------------------------------------------------
--------------------------------------------------------------------------------------------------------------------------------------------------------------------------------------------------------
--------------------------------------------------------------------------------------------------------------------------------------------------------------------------------------------------------
--------------------------------------------------------------------------------------------------------------------------------------------------------------------------------------------------------
--------------------------------------------------------------------------------------------------------------------------------------------------------------------------------------------------------
--------------------------------------------------------------------------------------------------------------------------------------------------------------------------------------------------------
--------------------------------------------------------------------------------------------------------------------------------------------------------------------------------------------------------
--------------------------------------------------------------------------------------------------------------------------------------------------------------------------------------------------------
--------------------------------------------------------------------------------------------------------------------------------------------------------------------------------------------------------
--------------------oooooo--------------------------------------------------------------------------------------------------------------------------------ooo--------------------SSS--------------------
--------------------------------------ooSoSS---------oSoo---------------------------------------------ooSo------------------------------------------------------ooS-------------------------------------
----------------------oooooo--------------------------------------------------------------------------------------------------SooSoo-------------------------------------------oooo---------------------
----------------------------------------oooo------ooooooo---------ooS-----------------oo-------------ooooo--------oooSooSSo---------------------oSSS--------g--oooooo-----------------------------------
---------------oo--XXXXXXXXXX---XXX--------------------------------------------------------------------------XXXX-------------oooo---XXXX---------------XXXXXX-------------XXXXXXXXXXXX---XXXXXX----XXXX
-------------g-----XXXXXXXXXX---XXXXXXXXXXXXXXXXXXXXXXXXXXXXXXXXX-------XXXXXX----XXXXXXXX--------XXXXXXXXXXXXXXX--ooooo-------------XXXXXXXXX-oooooooo-XXXXXXXXXXXXXXXXXXXXXXXXXXXXXXX---XXXXXX----XXXX
XXXXXXXXXXXXXXXXXXXXXXXXXXXXXXXXXXXXXXXXXXXXXXXXXXXXXXXXXXXXXXXXX-------XXXXXXXXXXXXXXXXXX--------XXXXXXXXXXXXXXX-----------XXXXXXXXXXXXXXXXXX--------g-XXXXXXXXXXXXXXXXXXXXXXXXXXXXXXX---XXXXXX----XXXX
XXXXXXXXXXXXXXXXXXXXXXXXXXXXXXXXXXXXXXXXXXXXXXXXXXXXXXXXXXXXXXXXXXXXXXXXXXXXXXXXXXXXXXXXXXXXXXXXXXXXXXXXXXXXXXXXXXXXXXXXXXXXXXXXXXXXXXXXXXXXXXXXXXXXXXXXXXXXXXXXXXXXXXXXXXXXXXXXXXXXXXXXXXXXXXXXXXXXXXXX

