--------------------------------------------------------------------------------------------------------------------------------------------------------------------------------------------------------
--------------------------------------------------------------------------------------------------------------------------------------------------------------------------------------------------------
--------------------------------------------------------------------------------------------------------------------------------------------------------------------------------------------------------
--------------------------------------------------------------------------------------------------------------------------------------------------------------------------------------------------------
--------------------------------------------------------------------------------------------------------------------------------------------------------------------------------------------------------
--------------------------------------------------------------------------------------------------------------------------------------------------------------------------------------------------------
--------------------------------------------------------------------------------------------------------------------------------------------------------------------------------------------------------
---------------------------------------------------------------------------------------------------------------------oSo--------------------------------------------------------------------------------
--------------------------------------------------------------------------------------------------------------------------------------------------------------------------------------------------------
-------------------------------------------------------------------------------------------------------------------ooo----------------------------------------------------------------------------------
-------------------------------------------------------------------------------------------------------------------g------------------------------------------------------------------------------------
-------------------------------------------------------------------------------------------------------------------%%%%%--------------------------g-----------------------------------------------------
---------------------------------------------------------------------------------oSS-------------------------------|||||------------------------%%%-----------------ooo---------------------------------
-----------------------------------------ooo-----------------------------------------------------------------------|||||----------------oooo----|||-----------------------------oSSSoo------------------
----------------oooo-----------------------------------------------oooo----------ooo-----------------oooSooo-------|%%%%%%%---------------------|||----------SoSS----oooo-------------------------------
------------------------------------------oo-----------------ooo----------------------------SooSS------------------||||||||--------------oooo---|||--------------------------------oo----ooo------------
--------------XXXXXXXX-----------------------------------------------oo----XX---XXXXXX----------------oooo---XXXXX-||||||||-------------------XXXXXXXXXXXX-ooooo---XXXXXXX--------------------------g---
--------------XXXXXXXX----------------XXXXXXXXXX-oooooo---XXXXXXX----------XX---XXXXXX----oooooo-------------XXXXX-||||||||-----XXXXXXXXXXXXXXXXXXXXXXXXXX---------XXXXXXXXXXXXXXXXXXXXX---oo---XXXXXXXX
XXXXXXXXXXXXXXXXXXXXXXXXXXXXXXXXXXXXXXXXXXXXXXXX----------XXXXXXXXXXXXXXXXXXXXXXXXXXXXXX-----------XXXXXXXXXXXXXXXXXXXXXXXXXXXXXXXXXXXXXXXXXXXXXXXXXXXXXXXXXXXXXXXXXXXXXXXXXXXXXXXXXXXXX--------XXXXXXXX
XXXXXXXXXXXXXXXXXXXXXXXXXXXXXXXXXXXXXXXXXXXXXXXXXXXXXXXXXXXXXXXXXXXXXXXXXXXXXXXXXXXXXXXXXXXXXXXXXXXXXXXXXXXXXXXXXXXXXXXXXXXXXXXXXXXXXXXXXXXXXXXXXXXXXXXXXXXXXXXXXXXXXXXXXXXXXXXXXXXXXXXXXXXXXXXXXXXXXXXX

