--------------------------------------------------------------------------------------------------------------------------------------------------------------------------------------------------------
--------------------------------------------------------------------------------------------------------------------------------------------------------------------------------------------------------
--------------------------------------------------------------------------------------------------------------------------------------------------------------------------------------------------------
--------------------------------------------------------------------------------------------------------------------------------------------------------------------------------------------------------
--------------------------------------------------------------------------------------------------------------------------------------------------------------------------------------------------------
--------------------------------------------------------------------------------------------------------------------------------------------------------------------------------------------------------
--------------------------------------------------------------------------------------------------------------------------------------------------------------------------------------------------------
--------------------------------------------------------------------------------------------------------------------------------------------------------------------------------------------------------
--------------------------------------------------------------------------------------------------------------------------------------------------------------------------------------------------------
--------------------------------------------------------------------------------------------------------------------------------------------------------------------------------------------------------
--------------------------------------------------------------------------------------------------------------------------------------------------------------------------------------------------------
--------------------------------------------------------------------------------------------------------------------------------------------------------------------------------------------------------
-------------oooooSo----oooo---------------------------oSo-------------------------------------SoooSSSo-------------------------------------------------------------------------------------------------
-------------------------------------------SoooS--------------------------------------SSoo--------------------------------------------------------------------------------------------------------------
--------------ooo--------ooooo------------------------------------------------------------------oooooo-------------------------------------oooo--------------------oSo--------------------------SSoSSSo-
------------------------------------------oooooooo------------Soooo-------------------ooooo------------------------------------oSSoSS-------------------------------------------------------------------
XXXXXXXXXXXXXXXXXXXXXXXXXXXXXXXX----g--XX----------XXXXXXXX-------------XXXXXX----------g----XXXXXXXXXXX-------XXXXXXXXXX----------------ooooo-----------------------------XXXX-----------ooo---ooooooo-
XXXXXXXXXXXXXXXXXXXXXXXXXXXXXXXXXXXXXXXXXXXXXXXXXXXXXXXXXXX--ooooo--XXXXXXXXXXXXXXXXXXXXXXXXXXXXXXXXXXXX---oo--XXXXXXXXXX--------oooooo-----------ooooo----XXXX--------XXXXXXXXXX-----------------------
XXXXXXXXXXXXXXXXXXXXXXXXXXXXXXXXXXXXXXXXXXXXXXXXXXXXXXXXXXX---------XXXXXXXXXXXXXXXXXXXXXXXXXXXXXXXXXXXX-------XXXXXXXXXXXXXX---g-g-----XXXXXXXXX--------XXXXXXXXXXXXXXXXXXXXXXXXXXXXXXXXXXXXXXXXXXXXXXX
XXXXXXXXXXXXXXXXXXXXXXXXXXXXXXXXXXXXXXXXXXXXXXXXXXXXXXXXXXXXXXXXXXXXXXXXXXXXXXXXXXXXXXXXXXXXXXXXXXXXXXXXXXXXXXXXXXXXXXXXXXXXXXXXXXXXXXXXXXXXXXXXXXXXXXXXXXXXXXXXXXXXXXXXXXXXXXXXXXXXXXXXXXXXXXXXXXXXXXXX

