--------------------------------------------------------------------------------------------------------------------------------------------------------------------------------------------------------
--------------------------------------------------------------------------------------------------------------------------------------------------------------------------------------------------------
--------------------------------------------------------------------------------------------------------------------------------------------------------------------------------------------------------
--------------------------------------------------------------------------------------------------------------------------------------------------------------------------------------------------------
--------------------------------------------------------------------------------------------------------------------------------------------------------------------------------------------------------
--------------------------------------------------------------------------------------------------------------------------------------------------------------------------------------------------------
--------------------------------------------------------------------------------------------------------------------------------------------------------------------------------------------------------
--------------------------------------------------------------------------------------------------------------------------------------------------------------------------------------------------------
--------------------------------------------------------------------------------------------------------------------------------------------------------------------------------------------------------
--------------------------------------------------------------------------------------------------------------------------------------------------------------------------------------------------------
--------------------------------------------------------------------------------------------------------------------------------------------------------------------------------------------------------
--------------------------------------------------------------------------------------------------------------------------------------------------------------------------------------------------------
------------------------------ooSo----------------------------------------------------------------------------------------------------------------------------------------------------------------------
------------------------------------------------------------SSS--------------ooo------------------------------------------------------------------------------------------------------------------------
-------------------ooSo-------ooo-----ooS--------Soo-------------------oSo------------------------------------------------------------------------------------------------------------------------------
-----------------------------------------------------------ooo----------------ooo-----SooSoo------------------------------------oSSooSo-------oooo-------------------------------oooS-----------Sooo----
--------------------ooo---XXXXXXXXX---ooo-----ooooooo-----------------------------g------------------------XXXX----------XXXXXX--------------------XXXXXXXXXX----ooo------------------------------------
--------------------------XXXXXXXXX------------------g--XXXXXXXXXXXXX------XXXXXXXXX---oooooo------XXXXXXXXXXXX----------XXXXXX---oooo----XXXXXXXXXXXXXXXXXXX-------------oo-------ooooo---------oooooo-
XXXXXXXXXXXXXX----XXXXXXXXXXXXXXXXXXXXXXXXXXXXXXXXXXXXXXXXXXXXXXXXXXXXXXXXXXXXXXXXXX---------------XXXXXXXXXXXXXXXXXXXXXXXXXXXX-----------XXXXXXXXXXXXXXXXXXXXXXXXXXXXX------------------XXXX-----------
XXXXXXXXXXXXXXXXXXXXXXXXXXXXXXXXXXXXXXXXXXXXXXXXXXXXXXXXXXXXXXXXXXXXXXXXXXXXXXXXXXXXXXXXXXXXXXXXXXXXXXXXXXXXXXXXXXXXXXXXXXXXXXXXXXXXXXXXXXXXXXXXXXXXXXXXXXXXXXXXXXXXXXXXXXXXXXXXXXXXXXXXXXXXXXXXXXXXXXXX

