--------------------------------------------------------------------------------------------------------------------------------------------------------------------------------------------------------
--------------------------------------------------------------------------------------------------------------------------------------------------------------------------------------------------------
--------------------------------------------------------------------------------------------------------------------------------------------------------------------------------------------------------
--------------------------------------------------------------------------------------------------------------------------------------------------------------------------------------------------------
--------------------------------------------------------------------------------------------------------------------------------------------------------------------------------------------------------
--------------------------------------------------------------------------------------------------------------------------------------------------------------------------------------------------------
--------------------------------------------------------------------------------------------------------------------------------------------------------------------------------------------------------
--------------------------------------------------------------------------------------------------------------------------------------------------------------------------------------------------------
--------------------------------------------------------------------------------------------------------------------------------------------------------------------------------------------------------
--------------------------------------------------------------------------------------------------------------------------------------------------------------------------------------------------------
--------------------------------------------------------------------------------------------------------------------------------------------------------------------------------------------------------
--------------------------------------------------------------------------------------------------------------------------------------------------------------------------------------------------------
---------------------------------Soooo-----oooo--------------------------------------------------------------------------------------------------------ooSoo--------------------------------------------
------------------------------------------------------------------------------------------------ooSSoS------------ooo-----------------------------------------------------------------------------------
-------------------------oo------ooooo-------oooo------oSSooo-----------------------oSoSo-------------------------------------------------------------ooooooo------SoS--------oo------------------------
-------------------------------------------g---------------------------oSoo--------------------oooooooo-----------------ooSooSo-------------oooooooo-------------------------------------ooSSooSo-------
--------------XXXXXXXXXXXXXXXXXXXXXXXXXX--XXXXXXXX---ooooooo----oo-----------------ooooo-------------------ooo-----g---------------------------------XXXXXXXXXX--ooooo----XXXXXXXXXXXXXX-----------XXXXX
--------------XXXXXXXXXXXXXXXXXXXXXXXXXX--XXXXXXXX--------------g----oooo-----ooo----g----XXXXXXXXXXXXXXX-------XXXXXXX----oooo------------oooooo----XXXXXXXXXX---------XXXXXXXXXXXXXXXX-oooooo----XXXXX
XXXXXXXXXXXXXXXXXXXXXXXXXXXXXXXXXXXXXXXXXXXXXXXXXXXXXXXXXXXXXXXXXXXX--------------XXXXXXXXXXXXXXXXXXXXXXXXXXXXXXXXXXXXX---------XXXX-g---------g-----XXXXXXXXXXXXXXXXXXXXXXXXXXXXXXXXXXX-----------XXXXX
XXXXXXXXXXXXXXXXXXXXXXXXXXXXXXXXXXXXXXXXXXXXXXXXXXXXXXXXXXXXXXXXXXXXXXXXXXXXXXXXXXXXXXXXXXXXXXXXXXXXXXXXXXXXXXXXXXXXXXXXXXXXXXXXXXXXXXXXXXXXXXXXXXXXXXXXXXXXXXXXXXXXXXXXXXXXXXXXXXXXXXXXXXXXXXXXXXXXXXXX

