--------------------------------------------------------------------------------------------------------------------------------------------------------------------------------------------------------
--------------------------------------------------------------------------------------------------------------------------------------------------------------------------------------------------------
--------------------------------------------------------------------------------------------------------------------------------------------------------------------------------------------------------
--------------------------------------------------------------------------------------------------------------------------------------------------------------------------------------------------------
--------------------------------------------------------------------------------------------------------------------------------------------------------------------------------------------------------
--------------------------------------------------------------------------------------------------------------------------------------------------------------------------------------------------------
--------------------------------------------------------------------------------------------------------------------------------------------------------------------------------------------------------
--------------------------------------------------------------------------------------------------------------------------------------------------------------------------------------------------------
--------------------------------------------------------------------------------------------------------------------------------------------------------------------------------------------------------
--------------------------------------------------------------------------------------------------------------------------------------------------------------------------------------------------------
--------------------------------------------------------------------------------------------------------------------------------------------------------------------------------------------------------
--------------------------------------------------------------------------------------------------------------------------------------------------------------------------------------------------------
---------------------------------------------------------------------------------------------------------oSo--------------------------------------------------------------------------------------------
--------------------------------------------------------------------------------------------------------------------------------------------------------------------------------------------------------
-----------------SSoS---------------------------SSo--ooo------------------oo-----Sooo-----------------------------------------------SSo-------------------------------------oooo------------------------
------------------------ooo---------------------------------oooSoooo----g------------------------oSooo-----------------------------------------------------g--------------------------------------------
XXXXXXXXXX-------ooo-------------XX-------------ooo-------------------XXXXXXXXX-ooooooo----------------XXXXXXX----XXXXXXXXXX------oooo-----------XXX---XXXXXX-oo----XXXXXXXXXXXXXX-----------XXXXXXXXXX-
XXXXXXXXXXXXX------------------XXXX-------XXXX---------------oooooooo-XXXXXXXXX-----------------ooo----XXXXXXX----XXXXXXXXXX------g--------------XXXXXXXXXXXX-------XXXXXXXXXXXXXX-ooooo-----XXXXXXXXXX-
XXXXXXXXXXXXXXXXXXXXXXX------XXXXXX-------XXXXXXXXXXXXXXXXX-----------XXXXXXXXXXXXXXXXXXX--------------XXXXXXX----XXXXXXXXXX-----XXXXXXX---------XXXXXXXXXXXXXXXXXXXXXXXXXXXXXXXXX---------XXXXXXXXXXXXX
XXXXXXXXXXXXXXXXXXXXXXXXXXXXXXXXXXXXXXXXXXXXXXXXXXXXXXXXXXXXXXXXXXXXXXXXXXXXXXXXXXXXXXXXXXXXXXXXXXXXXXXXXXXXXXXXXXXXXXXXXXXXXXXXXXXXXXXXXXXXXXXXXXXXXXXXXXXXXXXXXXXXXXXXXXXXXXXXXXXXXXXXXXXXXXXXXXXXXXXX

