--------------------------------------------------------------------------------------------------------------------------------------------------------------------------------------------------------
--------------------------------------------------------------------------------------------------------------------------------------------------------------------------------------------------------
--------------------------------------------------------------------------------------------------------------------------------------------------------------------------------------------------------
--------------------------------------------------------------------------------------------------------------------------------------------------------------------------------------------------------
--------------------------------------------------------------------------------------------------------------------------------------------------------------------------------------------------------
--------------------------------------------------------------------------------------------------------------------------------------------------------------------------------------------------------
--------------------------------------------------------------------------------------------------------------------------------------------------------------------------------------------------------
--------------------------------------------------------------------------------------------------------------------------------------------------------------------------------------------------------
--------------------------------------------------------------------------------------------------------------------------------------------------------------------------------------------------------
--------------------------------------------------------------------------------------------------------------------------------------------------------------------------------------------------------
--------------------------------------------------------------------------------------------------------------------------------------------------------------------------------------------------------
--------------------------------------------------------------------------------------------------------------------------------------------------------------------------------------------------------
---------------------------oSSoSSo-------------ooo----------------oSoooo--ooooSoooo--------------------------------ooSSoo------------------oooo--------------------------------------------------ooSS---
--------------------------------------------------------------------------------------------------------------------------------------------------------------------------------------------------------
---------------------------ooooooo---------------------------------ooooo--oooooo------oooS------------------------ooooooo-------------------oooo-------------------------------------------------oooo---
----------------------------------------------------------oooo----------------------------------------------------------------------oo-------g--------------------------ooS-------ooSoSSo---------------
------------------------XXXXXXXXXXX----------XXXXXXXXXX----------XXXXXXXXXXXXXXXXXXX--------------oooo-----------XXXXXXXXX---------------XXXXXXXXXX--------------------------------------------XXXXXXXX-
--------------XXXXXXXXXXXXXXXXXXXXX-----XXXXXXXXXXXXXXX---oooo---XXXXXXXXXXXXXXXXXXX-----------------------------XXXXXXXXX--------XXXXXXXXXXXXXXXXX----------------------oooo---oooooo---------XXXXXXXX-
--------------XXXXXXXXXXXXXXXXXXXXXXXXXXXXXXXXXXXXXXXXX----g-----XXXXXXXXXXXXXXXXXXXXXXXXXXX-----XXXXXX----------XXXXXXXXX--------XXXXXXXXXXXXXXXXX-----XXXXXXX---g-----g-----------------XXXXXXXXXXXXX-
XXXXXXXXXXXXXXXXXXXXXXXXXXXXXXXXXXXXXXXXXXXXXXXXXXXXXXXXXXXXXXXXXXXXXXXXXXXXXXXXXXXXXXXXXXXXXXXXXXXXXXXXXXXXXXXXXXXXXXXXXXXXXXXXXXXXXXXXXXXXXXXXXXXXXXXXXXXXXXXXXXXXXXXXXXXXXXXXXXXXXXXXXXXXXXXXXXXXXXXX

