--------------------------------------------------------------------------------------------------------------------------------------------------------------------------------------------------------
--------------------------------------------------------------------------------------------------------------------------------------------------------------------------------------------------------
--------------------------------------------------------------------------------------------------------------------------------------------------------------------------------------------------------
--------------------------------------------------------------------------------------------------------------------------------------------------------------------------------------------------------
--------------------------------------------------------------------------------------------------------------------------------------------------------------------------------------------------------
--------------------------------------------------------------------------------------------------------------------------------------------------------------------------------------------------------
--------------------------------------------------------------------------------------------------------------------------------------------------------------------------------------------------------
--------------------------------------------------------------------------------------------------------------------------------------------------------------------------------------------------------
--------------------------------------------------------------------------------------------------------------------------------------------------------------------------------------------------------
--------------------------------------------------------------------------------------------------------------------------------------------------------------------------------------------------------
--------------------------------------------------------------------------------------------------------------------------------------------------------------------------------------------------------
--------------------------------------------------------------------------------------------------------------------------------------------------------------------------------------------------------
-----------------------------------SSooSSoo---SSooo------------------------ooooo----------------------------------------------------------------------------------------------ooSooo--------------------
--------------------------------------------------------------------------------------------------------------------------------ooSSo-------------------------------------------------------------------
----------------Soo---SSSS-----------oooo-----oooooo-----------------------ooooo---------------------------------------------------------SoSo---------------Soooo----oooo------ooo-------ooo------------
---------------------------------------g-----------------ooSoo--------------------------ooooSo---------------------------------oooo--------------Soo------------------------g---------------------------
---------------------ooooo-------XXXXXXXXXXXXXXXXXXXX----------XXX-------XXXXXXXXXXX-------------------------------XXXXXX----------------oo----------XX-----oooooo----oooo-XXXXXXXXXX---oooooo--XXXXXXX-
----------------------g----------XXXXXXXXXXXXXXXXXXXX--oooo----XXX-------XXXXXXXXXXX---oooo------------------------XXXXXX---XXXXXXXXXXX--------------XX-------g------------XXXXXXXXXX-----------XXXXXXX-
XXXXXXXXXXXXXXXXXXXXXXXXXXXXXXXXXXXXXXXXXXXXXXXXXXXXX-----g----XXX-------XXXXXXXXXXX-------g--------------XXXXXXXXXXXXXXX---XXXXXXXXXXXXXXXXXX--g----XX---XXXXXXXXXXXXXXXXXXXXXXXXXXXXXXXXXXXXXXXXXXXXXX
XXXXXXXXXXXXXXXXXXXXXXXXXXXXXXXXXXXXXXXXXXXXXXXXXXXXXXXXXXXXXXXXXXXXXXXXXXXXXXXXXXXXXXXXXXXXXXXXXXXXXXXXXXXXXXXXXXXXXXXXXXXXXXXXXXXXXXXXXXXXXXXXXXXXXXXXXXXXXXXXXXXXXXXXXXXXXXXXXXXXXXXXXXXXXXXXXXXXXXXX

