--------------------------------------------------------------------------------------------------------------------------------------------------------------------------------------------------------
--------------------------------------------------------------------------------------------------------------------------------------------------------------------------------------------------------
--------------------------------------------------------------------------------------------------------------------------------------------------------------------------------------------------------
--------------------------------------------------------------------------------------------------------------------------------------------------------------------------------------------------------
--------------------------------------------------------------------------------------------------------------------------------------------------------------------------------------------------------
--------------------------------------------------------------------------------------------------------------------------------------------------------------------------------------------------------
--------------------------------------------------------------------------------------------------------------------------------------------------------------------------------------------------------
--------------------------------------------------------------------------------------------------------------------------------------------------------------------------------------------------------
--------------------------------------------------------------------------------------------------------------------------------------------------------------------------------------------------------
--------------------------------------------------------------------------------------------------------------------------------------------------------------------------------------------------------
--------------------------------------------------------------------------------------------------------------------------------------------------------------------------------------------------------
--------------------------------------------------------------------------------------------------------------------------------------------------------------------------------------------------------
------------------------------------------------------Sooo----------oooooo----------------------------------------------------------------------oooooo-------------------------------ooooS--------------
-----------------------------------------------------------------------------------------------------------------------------SSooooo-------------------------oSooo--------------------------------------
----------------------------------oSSSoo---------------oo------------oooooo--------------------------------------------------------------------oooooo-------------------------------oooo----------------
----------------------------ooo------------------------------------------------------------oooooo-----------ooo---------------oooo---------------------------ooooo---oSoo----Soo--------------ooo-------
----------XXXXXX---ooo------------oooo------oo------XXXXXXX--------XXXXXXXXXXXXXX--------------g-------------g---XXXXXXXXXX----------XXX-----XXXXXXXXXXX--------------------------XXXXXXXXXX--------XXXX
----------XXXXXX----------ooooo---------------------XXXXXXXXXXXXX--XXXXXXXXXXXXXX-oooooo-XXXXXXXXXX-----XXXXXXXXXXXXXXXXXXXXXXXXXXXXXXXX-----XXXXXXXXXXX----XXXXXXX--ooo----oooo--XXXXXXXXXXXXXXXXXXXXXX
XXXXXXXXXXXXXXXXXXXXXXXX---------XXXXXXXXXXXXXXXXXXXXXXXXXXXXXXXX--XXXXXXXXXXXXXX--------XXXXXXXXXXXXXXXXXXXXXXXXXXXXXXXXXXXXXXXXXXXXXXX-----XXXXXXXXXXXXXXXXXXXXXX-----g---------XXXXXXXXXXXXXXXXXXXXXX
XXXXXXXXXXXXXXXXXXXXXXXXXXXXXXXXXXXXXXXXXXXXXXXXXXXXXXXXXXXXXXXXXXXXXXXXXXXXXXXXXXXXXXXXXXXXXXXXXXXXXXXXXXXXXXXXXXXXXXXXXXXXXXXXXXXXXXXXXXXXXXXXXXXXXXXXXXXXXXXXXXXXXXXXXXXXXXXXXXXXXXXXXXXXXXXXXXXXXXXX

