--------------------------------------------------------------------------------------------------------------------------------------------------------------------------------------------------------
--------------------------------------------------------------------------------------------------------------------------------------------------------------------------------------------------------
--------------------------------------------------------------------------------------------------------------------------------------------------------------------------------------------------------
--------------------------------------------------------------------------------------------------------------------------------------------------------------------------------------------------------
--------------------------------------------------------------------------------------------------------------------------------------------------------------------------------------------------------
--------------------------------------------------------------------------------------------------------------------------------------------------------------------------------------------------------
--------------------------------------------------------------------------------------------------------------------------------------------------------------------------------------------------------
--------------------------------------------------------------------------------------------------------------------------------------------------------------------------------------------------------
--------------------------------------------------------------------------------------------------------------------------------------------------------------------------------------------------------
--------------------------------------------------------------------------------------------------------------------------------------------------------------------------------------------------------
--------------------------------------------------------------------------------------------------------------------------------------------------------------------------------------------------------
--------------------------------------------------------------------------------------------------------------------------------------------------------------------------------------------------------
------------------------------------------------------------------------------------------------------------------------------------------oooo--------------------oSoSoSoo------------------------------
--------------------------------------------------oSo-------------ooSo---------------------------------------------------SSooS--------------------------------------------------------------------------
--------------------------------SoSo--------------------oooooo---------------SSoo---------------------------------------------------------oooooo---ooSoo----ooo----oooooooo------------------oo---------
-----------------------------------------------------------------oooooo----------------------------------ooo-------ooo----ooo---------------------------------------------------------------------------
--------------------XXXXXXXX---oo-------------------------ooo-----------------oo---------------------------------------------------XXXXXXXXXXXXXX----ooo----oo---XXXXXXXXXXX--------------XXXXXXXXXX----
-----------XXXXXXXXXXXXXXXXX------------oo-------XXXXXX--------XXXXXXXXXXX--------g---g------------------oooooo-XXXXXXXXXXXXXXXXX--XXXXXXXXXXXXXX----------------XXXXXXXXXXXXXXXXXXXX-----XXXXXXXXXX----
-----------XXXXXXXXXXXXXXXXXXXXXXXXXX------XXXXXXXXXXXXXXXXXXXXXXXXXXXXXXXXXXXXXXXXXXXXXXXXX--------------------XXXXXXXXXXXXXXXXXXXXXXXXXXXXXXXXXXXXXXXXXXXXXXXXXXXXXXXXXXXXXXXXXXXXXXXXXXXXXXXXXXXX----
XXXXXXXXXXXXXXXXXXXXXXXXXXXXXXXXXXXXXXXXXXXXXXXXXXXXXXXXXXXXXXXXXXXXXXXXXXXXXXXXXXXXXXXXXXXXXXXXXXXXXXXXXXXXXXXXXXXXXXXXXXXXXXXXXXXXXXXXXXXXXXXXXXXXXXXXXXXXXXXXXXXXXXXXXXXXXXXXXXXXXXXXXXXXXXXXXXXXXXXX

