--------------------------------------------------------------------------------------------------------------------------------------------------------------------------------------------------------
--------------------------------------------------------------------------------------------------------------------------------------------------------------------------------------------------------
--------------------------------------------------------------------------------------------------------------------------------------------------------------------------------------------------------
--------------------------------------------------------------------------------------------------------------------------------------------------------------------------------------------------------
--------------------------------------------------------------------------------------------------------------------------------------------------------------------------------------------------------
--------------------------------------------------------------------------------------------------------------------------------------------------------------------------------------------------------
--------------------------------------------------------------------------------------------------------------------------------------------------------------------------------------------------------
--------------------------------------------------------------------------------------------------------------------------------------------------------------------------------------------------------
--------------------------------------------------------------------------------------------------------------------------------------------------------------------------------------------------------
--------------------------------------------------------------------------------------------------------------------------------------------------------------------------------------------------------
--------------------------------------------------------------------------------------------------------------------------------------------------------------------------------------------------------
--------------------------------------------------------------------------------------------------------------------------------------------------------------------------------------------------------
----------------------------------------------------------------SoooSo------------------oooooooo--------------------------------ooo-----oSSoSoS-----------------------SSoo------------------------------
---------------------------------------------------------------------------------------------------oooooo-----------------------------------------------------------------------------------------------
------------------------------oooS------------------------------ooooo--------------------ooooo------------------------oSoo-----oooo------ooooooo----------------------oooo------------------ooo---------
--------------------oooS----------------oo--------------------------------------oooS----------------oooo------------------------------------------------------------g---------oo------------------------
---------------------------oooooooo--------------XX---------XXXXXXXXXXX----------------XXXXXXXXXX---------------------oooo---XXXXXXXXXXXXXXXXXXXX-----------------XXXXXXXXX---------------ooo----XXXXXXX
-----------XXXXXX----oo--------------XXXXXXXX----XX---------XXXXXXXXXXX----------ooooo-XXXXXXXXXXXXXXXXXXXXXXXXX-------------XXXXXXXXXXXXXXXXXXXX--XXXXXXXXXXXXX--XXXXXXXXXXXXXXXXXXXXXXX--------XXXXXXX
-----------XXXXXX---------XXXXXXXXXXXXXXXXXXX----XX-----XXXXXXXXXXXXXXX--g-------------XXXXXXXXXXXXXXXXXXXXXXXXXXXXXXXXXXXXXXXXXXXXXXXXXXXXXXXXXX--XXXXXXXXXXXXXXXXXXXXXXXXXXXXXXXXXXXXXXXXXXXXXXXXXXXXX
XXXXXXXXXXXXXXXXXXXXXXXXXXXXXXXXXXXXXXXXXXXXXXXXXXXXXXXXXXXXXXXXXXXXXXXXXXXXXXXXXXXXXXXXXXXXXXXXXXXXXXXXXXXXXXXXXXXXXXXXXXXXXXXXXXXXXXXXXXXXXXXXXXXXXXXXXXXXXXXXXXXXXXXXXXXXXXXXXXXXXXXXXXXXXXXXXXXXXXXX

