--------------------------------------------------------------------------------------------------------------------------------------------------------------------------------------------------------
--------------------------------------------------------------------------------------------------------------------------------------------------------------------------------------------------------
--------------------------------------------------------------------------------------------------------------------------------------------------------------------------------------------------------
--------------------------------------------------------------------------------------------------------------------------------------------------------------------------------------------------------
--------------------------------------------------------------------------------------------------------------------------------------------------------------------------------------------------------
--------------------------------------------------------------------------------------------------------------------------------------------------------------------------------------------------------
--------------------------------------------------------------------------------------------------------------------------------------------------------------------------------------------------------
--------------------------------------------------------------------------------------------------------------------------------------------------------------------------------------------------------
--------------------------------------------------------------------------------------------------------------------------------------------------------------------------------------------------------
--------------------------------------------------------------------------------------------------------------------------------------------------------------------------------------------------------
--------------------------------------------------------------------------------------------------------------------------------------------------------------------------------------------------------
--------------------------------------------------------------------------------------------------------------------------------------------------------------------------------------------------------
-----------------------------------------------------------------------------------Sooo----------------------------SSoS--------------------oooo---------------------------------------------------------
---------------oSSSoo---oSSo-----------ooSo------------------------------------------------------------------------------------------------------------------------------ooo----------------------------
----------------------------------------------------------------------------------ooooo---------------------------ooooo-------oSo----------oooo-------SSo----ooooo--------------------------------------
---------------oooo--------------------oooo--------------ooo-----------------oo--g---------------ooooo----------------------------------------------------------------ooo-------------------------------
-------------------------g-------------------------------------------XXXX-g-g---XXXXXXXXX--------------XXXX-----XXXXXXXXXX-ooo-----------XXXXXXXXX-ooooo-----ooooooo------------------------------------
--------------XXXXXXXXXXXXXXXXX-ooo---XXXXXXXX---------ooooo---------XXXXXXXXXXXXXXXXXXXX-----XXXXXXXXXXXXXXXXXXXXXXXXXXXX--------XXXXXXXXXXXXXXXX-------------------XXXXXXXX-ooooo-XXX--------XXXXXX---
XXXXXXXXXXXXXXXXXXXXXXXXXXXXXXX-------XXXXXXXX------------------XXX--XXXXXXXXXXXXXXXXXXXXXXXXXXXXXXXXXXXXXXXXXXXXXXXXXXXXXXXXXXXXXXXXXXXXXXXXXXXXXXXXXXXXXXXXXXXXXXXXXXXXXXXX-------XXX--------XXXXXXXXX
XXXXXXXXXXXXXXXXXXXXXXXXXXXXXXXXXXXXXXXXXXXXXXXXXXXXXXXXXXXXXXXXXXXXXXXXXXXXXXXXXXXXXXXXXXXXXXXXXXXXXXXXXXXXXXXXXXXXXXXXXXXXXXXXXXXXXXXXXXXXXXXXXXXXXXXXXXXXXXXXXXXXXXXXXXXXXXXXXXXXXXXXXXXXXXXXXXXXXXXX

