--------------------------------------------------------------------------------------------------------------------------------------------------------------------------------------------------------
--------------------------------------------------------------------------------------------------------------------------------------------------------------------------------------------------------
--------------------------------------------------------------------------------------------------------------------------------------------------------------------------------------------------------
--------------------------------------------------------------------------------------------------------------------------------------------------------------------------------------------------------
--------------------------------------------------------------------------------------------------------------------------------------------------------------------------------------------------------
--------------------------------------------------------------------------------------------------------------------------------------------------------------------------------------------------------
--------------------------------------------------------------------------------------------------------------------------------------------------------------------------------------------------------
--------------------------------------------------------------------------------------------------------------------------------------------------------------------------------------------------------
--------------------------------------------------------------------------------------------------------------------------------------------------------------------------------------------------------
--------------------------------------------------------------------------------------------------------------------------------------------------------------------------------------------------------
--------------------------------------------------------------------------------------------------------------------------------------------------------------------------------------------------------
--------------------------------------------------------------------------------------------------------------------------------------------------------------------------------------------------------
----------------------------------------------ooS-------------------------------------------------------------------------------------------------------------------------------------------------------
-----------------------------------------------------------ooSooo---------ooSoo------------------------------oSoSo-------------oSSSS------------------------------------------------------------ooo-----
----------------------------------------ooo----ooo-------------------------------------------ooooo-------------------------------------------------------------------------oSSoSSoo---oo----------------
----------------ooooo------ooooS--------------g--g----------ooooooo---------ooo--------------------------------------ooooSoo-------------oSSS--------------ooo-----oSooS---------------------oooooooo---
XXXXXXXXXXX----------------------------XXXXXXXXXXXXXXXXXXX-------------XX---------------XX--ooooooo-------------------------------------------------------------------------ooooo---XXXXXXXX-----------X
XXXXXXXXXXX---XXXXXXXX--------ooo------XXXXXXXXXXXXXXXXXXXXXXXXXXXXXXXXXXXXXXXXX--XX----XX----g--------ooo--XXXXXXXX----ooooo-XXXXXXXX---ooooo----------XXXXXXX--ooooooo------------XXXXXXXXXXXXXXXXXXXX
XXXXXXXXXXXXXXXXXXXXXXXXXX-------------XXXXXXXXXXXXXXXXXXXXXXXXXXXXXXXXXXXXXXXXXXXXXXXXXXXXXXXXXXXXXX-------XXXXXXXX----------XXXXXXXX-----------XXXXXXXXXXXXXX-----------XXXXXXXXXXXXXXXXXXXXXXXXXXXXXX
XXXXXXXXXXXXXXXXXXXXXXXXXXXXXXXXXXXXXXXXXXXXXXXXXXXXXXXXXXXXXXXXXXXXXXXXXXXXXXXXXXXXXXXXXXXXXXXXXXXXXXXXXXXXXXXXXXXXXXXXXXXXXXXXXXXXXXXXXXXXXXXXXXXXXXXXXXXXXXXXXXXXXXXXXXXXXXXXXXXXXXXXXXXXXXXXXXXXXXXX

