--------------------------------------------------------------------------------------------------------------------------------------------------------------------------------------------------------
--------------------------------------------------------------------------------------------------------------------------------------------------------------------------------------------------------
--------------------------------------------------------------------------------------------------------------------------------------------------------------------------------------------------------
--------------------------------------------------------------------------------------------------------------------------------------------------------------------------------------------------------
--------------------------------------------------------------------------------------------------------------------------------------------------------------------------------------------------------
--------------------------------------------------------------------------------------------------------------------------------------------------------------------------------------------------------
--------------------------------------------------------------------------------------------------------------------------------------------------------------------------------------------------------
--------------------------------------------------------------------------------------------------------------------------------------------------------------------------------------------------------
--------------------------------------------------------------------------------------------------------------------------------------------------------------------------------------------------------
--------------------------------------------------------------------------------------------------------------------------------------------------------------------------------------------------------
--------------------------------------------------------------------------------------------------------------------------------------------------------------------------------------------------------
--------------------------------------------------------------------------------------------------------------------------------------------------------------------------------------------------------
--------------------------------------------------------------------------------------------------------------------------------------------oSSo-------oSSS-----ooo-----oooSS---------------------------
-----------------------------------------------------------------Soo--------------------------------------oSoooo----------------------------------------------------------------------------------------
----------------ooSo---oo-------oooooo-----------oooo-------------------------------------------------oo--------------------------oooo-------oooo--------oo-----ooo-----ooooo------Soo-----oooo---------
------------------------------------------ooo--------------------ooo-----------ooo-----------ooSo-----------------------oooooo----------------------------------g---------------------------------------
-----------------oo---XXXXXX------oooo--------XXXXXXXX--------------g-----------------XXXXX-------XXXXXXX------------------------XXXXXXXXXXXXXXXXX---XXXXXXXXXXXXXXXXXXXXXXXXXX-ooooo-------oo----------
XXXXXXXXXXX-----------XXXXXXXX---------XXXXXXXXXXXXXXX--oo-----XXXXXXXX-----XXXXXXX---XXXXX-------XXXXXXXXXXXXXXX--------ooooo-XXXXXXXXXXXXXXXXXXXXXXXXXXXXXXXXXXXXXXXXXXXXXXXX-------------------ooo---
XXXXXXXXXXXXXXXXXXXXXXXXXXXXXXXXXXXXXXXXXXXXXXXXXXXXXX---g-----XXXXXXXX-----XXXXXXX---XXXXX-------XXXXXXXXXXXXXXX--------------XXXXXXXXXXXXXXXXXXXXXXXXXXXXXXXXXXXXXXXXXXXXXXXXXXXXXXXXXXXXXXXXXX-------
XXXXXXXXXXXXXXXXXXXXXXXXXXXXXXXXXXXXXXXXXXXXXXXXXXXXXXXXXXXXXXXXXXXXXXXXXXXXXXXXXXXXXXXXXXXXXXXXXXXXXXXXXXXXXXXXXXXXXXXXXXXXXXXXXXXXXXXXXXXXXXXXXXXXXXXXXXXXXXXXXXXXXXXXXXXXXXXXXXXXXXXXXXXXXXXXXXXXXXXX

