--------------------------------------------------------------------------------------------------------------------------------------------------------------------------------------------------------
--------------------------------------------------------------------------------------------------------------------------------------------------------------------------------------------------------
--------------------------------------------------------------------------------------------------------------------------------------------------------------------------------------------------------
--------------------------------------------------------------------------------------------------------------------------------------------------------------------------------------------------------
--------------------------------------------------------------------------------------------------------------------------------------------------------------------------------------------------------
--------------------------------------------------------------------------------------------------------------------------------------------------------------------------------------------------------
--------------------------------------------------------------------------------------------------------------------------------------------------------------------------------------------------------
--------------------------------------------------------------------------------------------------------------------------------------------------------------------------------------------------------
--------------------------------------------------------------------------------------------------------------------------------------------------------------------------------------------------------
--------------------------------------------------------------------------------------------------------------------------------------------------------------------------------------------------------
--------------------------------------------------------------------------------------------------------------------------------------------------------------------------------------------------------
--------------------------------------------------------------------------------------------------------------------------------------------------------------------------------------------------------
--------------------------------ooo------------------ooSo------oooo----------------------oooS-----------------------------------------------------------------------------------------------------------
------------------------------------------------------------------------------------------------------------------------------------------------oSS-------------------------------------------------Soo-
--------------oooooSo-----------ooooo------------------oo----ooooooo------------------------oo---------oSooo------ooo---------------------------------------------------------SoSoSSo-------------------
------------------------------------------------------------------------oSSoo-----------------g---------------------------oSoSo-----------------oooooo---oooS------ooSSSo--------------ooooSSo------oo--
---------------oooooo-------XXXXXXXXXX-----oooo-----XXXXXXXXXXXXXXXXX-------------------XXXXXXXX-------oo----------oooo------------------------------------------------------ooooo----------------------
XXXXXXXXXXXXX---------------XXXXXXXXXX-------g----XXXXXXXXXXXXXXXXXXX---oooo------XX----XXXXXXXXXXXX------g---------------ooooooo--ooooooo-XXXXXXXXXXXX--oooo-------ooo-------------------ooo---XXXXXXXX
XXXXXXXXXXXXXXXXXXXXXXXXXXXXXXXXXXXXXX--XXXXXXXXXXXXXXXXXXXXXXXXXXXXX----------XXXXX----XXXXXXXXXXXXXXXXXXXXXXXXXXXXXXXXX------------------XXXXXXXXXXXX--------------------XXXXXXXXXXX----------XXXXXXXX
XXXXXXXXXXXXXXXXXXXXXXXXXXXXXXXXXXXXXXXXXXXXXXXXXXXXXXXXXXXXXXXXXXXXXXXXXXXXXXXXXXXXXXXXXXXXXXXXXXXXXXXXXXXXXXXXXXXXXXXXXXXXXXXXXXXXXXXXXXXXXXXXXXXXXXXXXXXXXXXXXXXXXXXXXXXXXXXXXXXXXXXXXXXXXXXXXXXXXXXX

