--------------------------------------------------------------------------------------------------------------------------------------------------------------------------------------------------------
--------------------------------------------------------------------------------------------------------------------------------------------------------------------------------------------------------
--------------------------------------------------------------------------------------------------------------------------------------------------------------------------------------------------------
--------------------------------------------------------------------------------------------------------------------------------------------------------------------------------------------------------
--------------------------------------------------------------------------------------------------------------------------------------------------------------------------------------------------------
--------------------------------------------------------------------------------------------------------------------------------------------------------------------------------------------------------
--------------------------------------------------------------------------------------------------------------------------------------------------------------------------------------------------------
--------------------------------------------------------------------------------------------------------------------------------------------------------------------------------------------------------
--------------------------------------------------------------------------------------------------------------------------------------------------------------------------------------------------------
--------------------------------------------------------------------------------------------------------------------------------------------------------------------------------------------------------
--------------------------------------------------------------------------------------------------------------------------------------------------------------------------------------------------------
--------------------------------------------------------------------------------------------------------------------------------------------------------------------------------------------------------
-------------------------------------------------------------SSSSo----Soooo-------------------------------------------------------Soooo-----------------------------------------------------------------
--------------------------------------------------------------------------------------------------------------------------------------------------------------------------------------------------------
----------------------------------ooo---------ooooo----------ooo----oooooo-----oSoSoooo---------------------------------------------oooo------------------------------oooooo---oSo------------------oSo-
----------------------ooSSoSo-------------------------------------------------------------------------------------------------------------------------oSoooSSo------------------------------------------
XXXXXXXXXXXXXX-----------------oooooo--------------------XXXXXXXXXXXXXXXXXXXX----ooooo--XXXXX-----------------------------------XXXXXXXXXXX----g----------------XXXXXXXXXXXXX---oo-----ooo---------oo---
XXXXXXXXXXXXXXXXXXX-oooooooo-------g--------------g-XXXXXXXXXXXXXXXXXXXXXXXXX--g--------XXXXX-------XXXXX---oo------------------XXXXXXXXXXXXXXXXXX-----ooooo----XXXXXXXXXXXXX----------------oo-----g---
XXXXXXXXXXXXXXXXXXX-----------XXXXXXXXXXXXXXXXXXXXXXXXXXXXXXXXXXXXXXXXXXXXXXXXXXXXXXXXXXXXXXX-----g-XXXXX-----------XXXXXX------XXXXXXXXXXXXXXXXXX--------------XXXXXXXXXXXXXXXXXXXXXXXXXXX------XXXXXXX
XXXXXXXXXXXXXXXXXXXXXXXXXXXXXXXXXXXXXXXXXXXXXXXXXXXXXXXXXXXXXXXXXXXXXXXXXXXXXXXXXXXXXXXXXXXXXXXXXXXXXXXXXXXXXXXXXXXXXXXXXXXXXXXXXXXXXXXXXXXXXXXXXXXXXXXXXXXXXXXXXXXXXXXXXXXXXXXXXXXXXXXXXXXXXXXXXXXXXXXX

